,Codi,Literal,Any,Total,Homes,Dones,0-14 Anys,15-64 Anys,64 o més
0,250019,Abella de la Conca,2000,197,106,91,31,125,41
1,080018,Abrera,2000,8177,4203,3974,1325,6162,690
2,250024,Àger,2000,528,284,244,39,299,190
3,250030,Agramunt,2000,4902,2506,2396,694,3152,1056
4,080023,Aguilar de Segarra,2000,213,106,107,26,114,73
5,170010,Agullana,2000,655,332,323,68,387,200
6,080142,Aiguafreda,2000,2147,1054,1093,267,1470,410
7,430017,Aiguamúrcia,2000,652,339,313,76,415,161
8,170025,Aiguaviva,2000,515,261,254,79,351,85
9,250387,Aitona,2000,2186,1086,1100,253,1420,513
10,250045,"Alamús, els",2000,698,350,348,84,450,164
11,250058,Alàs i Cerc,2000,400,213,187,45,245,110
12,250061,"Albagés, l'",2000,510,265,245,61,304,145
13,170031,Albanyà,2000,128,68,60,16,82,30
14,250077,Albatàrrec,2000,1130,567,563,148,759,223
15,250083,Albesa,2000,1494,738,756,173,954,367
16,250096,"Albi, l'",2000,782,407,375,76,501,205
17,430022,Albinyana,2000,1380,718,662,143,985,252
18,430038,"Albiol, l'",2000,175,96,79,23,125,27
19,170046,Albons,2000,572,300,272,72,365,135
20,430043,Alcanar,2000,7878,3917,3961,1022,5177,1679
21,250100,Alcanó,2000,259,133,126,24,146,89
22,250117,Alcarràs,2000,4767,2393,2374,672,3210,885
23,250122,Alcoletge,2000,1770,919,851,248,1234,288
24,430056,Alcover,2000,3787,1927,1860,549,2576,662
25,439044,"Aldea, l'",2000,3546,1803,1743,491,2279,776
26,430069,Aldover,2000,792,377,415,69,489,234
27,430075,"Aleixar, l'",2000,717,367,350,88,458,171
28,080039,Alella,2000,8413,4180,4233,1289,6131,993
29,430081,Alfara de Carles,2000,365,194,171,26,220,119
30,250138,Alfarràs,2000,2905,1414,1491,363,1906,636
31,250143,Alfés,2000,328,171,157,37,206,85
32,430094,Alforja,2000,1269,648,621,146,773,350
33,250156,Algerri,2000,521,254,267,37,322,162
34,250169,Alguaire,2000,2807,1425,1382,342,1866,599
35,250175,Alins,2000,272,136,136,22,155,95
36,430108,Alió,2000,372,185,187,44,225,103
37,250194,Almacelles,2000,5564,2813,2751,718,3721,1125
38,250208,Almatret,2000,484,253,231,39,265,180
39,250215,Almenar,2000,3441,1763,1678,411,2250,780
40,430115,Almoster,2000,823,423,400,139,569,115
41,250220,Alòs de Balaguer,2000,187,109,78,11,119,57
42,170062,Alp,2000,1194,620,574,172,885,137
43,080044,Alpens,2000,264,140,124,40,163,61
44,250236,Alpicat,2000,4016,2005,2011,684,2758,574
45,250241,Alt Àneu,2000,411,227,184,54,264,93
46,430120,Altafulla,2000,3111,1589,1522,499,2265,347
47,170078,Amer,2000,2220,1092,1128,258,1443,519
48,430136,"Ametlla de Mar, l'",2000,4946,2482,2464,637,3379,930
49,080057,"Ametlla del Vallès, l'",2000,5697,2823,2874,1033,3962,702
50,439060,"Ampolla, l'",2000,1831,906,925,205,1185,441
51,430141,Amposta,2000,16372,8073,8299,2247,11059,3066
52,170084,Anglès,2000,5009,2527,2482,649,3334,1026
53,250273,Anglesola,2000,1277,652,625,134,809,334
54,250292,Arbeca,2000,2384,1220,1164,314,1436,634
55,430167,"Arboç, l'",2000,3551,1841,1710,511,2449,591
56,430154,Arbolí,2000,139,70,69,6,96,37
57,170097,Arbúcies,2000,5026,2543,2483,733,3320,973
58,080060,Arenys de Mar,2000,12610,6046,6564,1829,8424,2357
59,080076,Arenys de Munt,2000,6242,3097,3145,1014,4276,952
60,170101,Argelaguer,2000,379,206,173,65,217,97
61,080082,Argençola,2000,196,105,91,21,130,45
62,430173,"Argentera, l'",2000,148,85,63,14,107,27
63,080095,Argentona,2000,9482,4706,4776,1505,6669,1308
64,170118,"Armentera, l'",2000,756,375,381,82,470,204
65,430189,Arnes,2000,517,268,249,48,279,190
66,250313,Arres,2000,63,32,31,8,38,17
67,250328,Arsèguel,2000,108,58,50,7,76,25
68,080109,Artés,2000,4368,2173,2195,634,2885,849
69,250334,Artesa de Lleida,2000,1326,683,643,170,849,307
70,250349,Artesa de Segre,2000,3169,1624,1545,364,1993,812
71,430192,Ascó,2000,1707,864,843,218,1103,386
72,250365,Aspa,2000,267,135,132,23,154,90
73,250371,"Avellanes i Santa Linya, les",2000,483,257,226,26,284,173
74,080116,Avià,2000,1845,930,915,221,1186,438
75,080121,Avinyó,2000,1999,977,1022,295,1278,426
76,170123,Avinyonet de Puigventós,2000,618,315,303,99,427,92
77,080137,Avinyonet del Penedès,2000,1167,619,548,125,769,273
78,080155,Badalona,2000,208944,103124,105820,29240,150556,29148
79,089045,Badia del Vallès,2000,15533,7825,7708,2186,11723,1624
80,080168,Bagà,2000,2078,1004,1074,274,1323,481
81,250390,Baix Pallars,2000,363,207,156,18,226,119
82,250404,Balaguer,2000,13275,6509,6766,1907,8716,2652
83,080174,Balenyà,2000,3125,1560,1565,494,2183,448
84,080180,Balsareny,2000,3230,1590,1640,412,2119,699
85,430206,Banyeres del Penedès,2000,1694,885,809,207,1265,222
86,170157,Banyoles,2000,15084,7410,7674,2524,9743,2817
87,250411,Barbens,2000,787,403,384,80,479,228
88,430213,Barberà de la Conca,2000,409,202,207,44,248,117
89,082520,Barberà del Vallès,2000,26681,13393,13288,4383,19759,2539
90,080193,Barcelona,2000,1496266,699645,796621,170861,994656,330749
91,250426,"Baronia de Rialb, la",2000,266,139,127,32,162,72
92,170160,Bàscara,2000,822,422,400,86,562,174
93,250447,Bassella,2000,308,156,152,38,167,103
94,430228,Batea,2000,1964,987,977,218,1200,546
95,250450,Bausen,2000,62,36,26,2,30,30
96,080207,Begues,2000,4189,2108,2081,844,2943,402
97,170139,Begur,2000,3411,1729,1682,516,2386,509
98,250463,Belianes,2000,550,260,290,56,312,182
99,251706,Bellaguarda,2000,354,174,180,43,188,123
100,170182,Bellcaire d'Empordà,2000,535,274,261,66,343,126
101,250479,Bellcaire d'Urgell,2000,1307,626,681,123,805,379
102,250485,Bell-lloc d'Urgell,2000,2124,1050,1074,282,1353,489
103,250498,Bellmunt d'Urgell,2000,231,113,118,28,138,65
104,430234,Bellmunt del Priorat,2000,310,151,159,21,170,119
105,080214,Bellprat,2000,95,55,40,10,62,23
106,250501,Bellpuig,2000,4041,2009,2032,523,2697,821
107,430249,Bellvei,2000,1368,722,646,219,929,220
108,250518,Bellver de Cerdanya,2000,1614,861,753,177,1091,346
109,250523,Bellvís,2000,2173,1067,1106,236,1295,642
110,250539,Benavent de Segrià,2000,904,469,435,126,632,146
111,430252,Benifallet,2000,883,441,442,98,504,281
112,430265,Benissanet,2000,1022,523,499,121,632,269
113,080229,Berga,2000,14305,6929,7376,1663,9279,3363
114,170195,Besalú,2000,1996,971,1025,226,1294,476
115,170209,Bescanó,2000,3187,1603,1584,453,2155,579
116,170216,Beuda,2000,133,73,60,16,92,25
117,080235,Bigues i Riells del Fai,2000,5436,2848,2588,924,3968,544
118,250557,Biosca,2000,247,126,121,24,146,77
119,170221,"Bisbal d'Empordà, la",2000,8264,4070,4194,1238,5442,1584
120,430271,"Bisbal de Falset, la",2000,242,120,122,25,148,69
121,430287,"Bisbal del Penedès, la",2000,1943,1023,920,263,1309,371
122,172348,Biure,2000,217,107,110,21,142,54
123,430290,Blancafort,2000,379,196,183,47,198,134
124,170237,Blanes,2000,30441,15272,15169,4725,21428,4288
125,170293,Boadella i les Escaules,2000,219,110,109,24,142,53
126,170242,Bolvir,2000,284,144,140,29,206,49
127,430304,Bonastre,2000,319,166,153,35,191,93
128,250576,"Bòrdes, Es",2000,212,111,101,21,160,31
129,170255,Bordils,2000,1383,697,686,208,919,256
130,250582,"Borges Blanques, les",2000,5212,2601,2611,666,3365,1181
131,430311,"Borges del Camp, les",2000,1577,797,780,206,1043,328
132,170268,Borrassà,2000,533,268,265,67,329,137
133,080240,Borredà,2000,485,243,242,59,305,121
134,250595,Bossòst,2000,866,434,432,132,570,164
135,430326,Bot,2000,830,419,411,67,477,286
136,430332,Botarell,2000,624,318,306,90,428,106
137,250560,Bovera,2000,396,202,194,26,227,143
138,430347,Bràfim,2000,573,279,294,45,363,165
139,170274,Breda,2000,3345,1717,1628,476,2277,592
140,080253,"Bruc, el",2000,1029,544,485,153,680,196
141,080266,"Brull, el",2000,197,109,88,23,138,36
142,170280,Brunyola i Sant Martí Sapresa,2000,383,195,188,28,228,127
143,430350,Cabacés,2000,339,178,161,28,206,105
144,250609,Cabanabona,2000,98,49,49,7,53,38
145,170314,Cabanelles,2000,226,129,97,22,142,62
146,170307,Cabanes,2000,798,409,389,95,539,164
147,080272,"Cabanyes, les",2000,544,290,254,70,374,100
148,250616,Cabó,2000,123,71,52,10,74,39
149,430363,Cabra del Camp,2000,601,315,286,67,399,135
150,080288,Cabrera d'Anoia,2000,528,291,237,63,382,83
151,080291,Cabrera de Mar,2000,3716,1899,1817,631,2662,423
152,080305,Cabrils,2000,4693,2293,2400,884,3361,448
153,170329,Cadaqués,2000,2301,1117,1184,333,1576,392
154,080312,Calaf,2000,3016,1500,1516,385,2036,595
155,430379,Calafell,2000,12219,6160,6059,1669,8746,1804
156,080348,Calders,2000,763,395,368,135,489,139
157,080327,Caldes d'Estrac,2000,1973,951,1022,240,1314,419
158,170335,Caldes de Malavella,2000,4031,2038,1993,534,2739,758
159,080333,Caldes de Montbui,2000,12464,6149,6315,1590,8748,2126
160,080351,Calella,2000,13055,6319,6736,1839,8866,2350
161,080370,Calldetenes,2000,2006,1036,970,314,1406,286
162,080386,Callús,2000,1329,661,668,157,855,317
163,080364,Calonge de Segarra,2000,196,101,95,24,104,68
164,170340,Calonge i Sant Antoni,2000,6783,3398,3385,925,4719,1139
165,250621,Camarasa,2000,885,449,436,73,514,298
166,439039,Camarles,2000,2887,1428,1459,388,1861,638
167,430385,Cambrils,2000,19942,9911,10031,3221,14278,2443
168,170353,Camós,2000,637,327,310,72,434,131
169,170366,Campdevànol,2000,3370,1652,1718,370,2181,819
170,170372,Campelles,2000,125,67,58,6,89,30
171,080399,Campins,2000,292,150,142,51,195,46
172,170388,Campllong,2000,307,158,149,49,201,57
173,170391,Camprodon,2000,2319,1138,1181,226,1525,568
174,250637,Canejan,2000,108,52,56,9,70,29
175,170405,Canet d'Adri,2000,519,270,249,70,355,94
176,080403,Canet de Mar,2000,10138,4946,5192,1339,6881,1918
177,080410,Canovelles,2000,13016,6566,6450,1933,9420,1663
178,080425,Cànoves i Samalús,2000,1870,968,902,270,1357,243
179,170412,Cantallops,2000,267,136,131,24,161,82
180,080431,Canyelles,2000,1838,983,855,241,1355,242
181,430398,Capafonts,2000,124,65,59,3,92,29
182,430402,Capçanes,2000,401,184,217,40,249,112
183,080446,Capellades,2000,4881,2390,2491,673,3358,850
184,170427,Capmany,2000,409,203,206,34,261,114
185,080459,Capolat,2000,63,38,25,1,40,22
186,080462,Cardedeu,2000,12078,6005,6073,2093,8510,1475
187,080478,Cardona,2000,5567,2707,2860,633,3561,1373
188,080484,Carme,2000,686,350,336,61,452,173
189,430419,Caseres,2000,325,161,164,41,178,106
190,170448,Cassà de la Selva,2000,7692,3834,3858,1162,4999,1531
191,080497,Casserres,2000,1634,778,856,177,1003,454
192,080575,Castell de l'Areny,2000,48,30,18,2,33,13
193,259046,Castell de Mur,2000,149,78,71,17,82,50
194,250642,Castellar de la Ribera,2000,153,70,83,17,92,44
195,080522,Castellar de n'Hug,2000,188,97,91,19,120,49
196,080500,Castellar del Riu,2000,114,66,48,16,81,17
197,080517,Castellar del Vallès,2000,17444,8714,8730,2945,12291,2208
198,080538,Castellbell i el Vilar,2000,2753,1379,1374,332,1826,595
199,080543,Castellbisbal,2000,7887,4073,3814,1433,5666,788
200,080556,Castellcir,2000,366,204,162,53,259,54
201,250674,Castelldans,2000,959,483,476,118,552,289
202,080569,Castelldefels,2000,45091,22538,22553,7143,33536,4412
203,080581,Castellet i la Gornal,2000,1404,705,699,161,947,296
204,170464,Castellfollit de la Roca,2000,963,478,485,108,585,270
205,080608,Castellfollit de Riubregós,2000,233,117,116,28,142,63
206,080594,Castellfollit del Boix,2000,384,186,198,67,219,98
207,080615,Castellgalí,2000,928,477,451,122,615,191
208,080620,Castellnou de Bages,2000,526,276,250,73,409,44
209,250680,Castellnou de Seana,2000,701,362,339,67,451,183
210,170470,Castelló d'Empúries,2000,6266,3202,3064,1018,4239,1009
211,250693,Castelló de Farfanya,2000,587,298,289,69,343,175
212,080636,Castellolí,2000,427,219,208,62,273,92
213,170486,Castell-Platja d'Aro,2000,6688,3382,3306,994,4920,774
214,250707,Castellserà,2000,1107,541,566,119,696,292
215,080641,Castellterçol,2000,2000,983,1017,257,1288,455
216,430424,Castellvell del Camp,2000,1062,543,519,140,749,173
217,080654,Castellví de la Marca,2000,1445,730,715,187,947,311
218,080667,Castellví de Rosanes,2000,1096,563,533,162,801,133
219,430430,"Catllar, el",2000,2363,1243,1120,358,1700,305
220,250714,Cava,2000,57,34,23,6,34,17
221,171899,"Cellera de Ter, la",2000,2019,1002,1017,272,1349,398
222,170499,Celrà,2000,2635,1293,1342,447,1759,429
223,080673,Centelles,2000,5793,2851,2942,777,3889,1127
224,082687,Cercs,2000,1454,727,727,168,909,377
225,082665,Cerdanyola del Vallès,2000,52778,26403,26375,7811,39553,5414
226,080689,Cervelló,2000,6064,3033,3031,949,4481,634
227,250729,Cervera,2000,7437,3659,3778,1142,4858,1437
228,250735,Cervià de les Garrigues,2000,845,438,407,74,494,277
229,170502,Cervià de Ter,2000,607,306,301,67,366,174
230,170519,Cistella,2000,231,115,116,26,148,57
231,250740,Ciutadilla,2000,213,108,105,16,129,68
232,250753,Clariana de Cardener,2000,145,75,70,21,98,26
233,250766,"Cogul, el",2000,232,121,111,18,132,82
234,170545,Colera,2000,592,310,282,58,380,154
235,250772,Coll de Nargó,2000,606,323,283,71,361,174
236,080692,Collbató,2000,2099,1124,975,312,1527,260
237,430458,Colldejou,2000,198,108,90,24,135,39
238,080706,Collsuspina,2000,254,137,117,30,190,34
239,170558,Colomers,2000,196,100,96,12,118,66
240,251636,"Coma i la Pedra, la",2000,240,147,93,21,162,57
241,251615,Conca de Dalt,2000,419,218,201,36,237,146
242,430461,Conesa,2000,116,63,53,8,70,38
243,430477,Constantí,2000,5021,2599,2422,725,3560,736
244,080713,Copons,2000,271,128,143,18,164,89
245,430483,Corbera d'Ebre,2000,1056,543,513,131,633,292
246,080728,Corbera de Llobregat,2000,9090,4636,4454,1637,6582,871
247,250788,Corbins,2000,1055,537,518,126,678,251
248,170577,Corçà,2000,1153,574,579,135,810,208
249,080734,Cornellà de Llobregat,2000,80998,39716,41282,10051,58157,12790
250,170561,Cornellà del Terri,2000,1921,963,958,278,1257,386
251,430496,Cornudella de Montsant,2000,840,427,413,79,502,259
252,430509,Creixell,2000,1837,922,915,241,1249,347
253,170583,Crespià,2000,205,102,103,19,121,65
254,179011,"Cruïlles, Monells i Sant Sadurní de l'Heura",2000,1096,543,553,155,734,207
255,080749,Cubelles,2000,6497,3321,3176,909,4609,979
256,250791,Cubells,2000,382,194,188,41,218,123
257,430516,Cunit,2000,5943,3059,2884,779,4299,865
258,170600,Darnius,2000,517,275,242,43,327,147
259,170617,Das,2000,158,85,73,21,106,31
260,439018,Deltebre,2000,10250,5132,5118,1354,6895,2001
261,080752,Dosrius,2000,2846,1453,1393,432,2146,268
262,430537,Duesaigües,2000,199,120,79,15,126,58
263,170622,"Escala, l'",2000,6285,3155,3130,827,4423,1035
264,080765,Esparreguera,2000,17060,8643,8417,2767,12148,2145
265,170638,Espinelves,2000,179,90,89,17,103,59
266,250812,"Espluga Calba, l'",2000,424,222,202,43,258,123
267,430542,"Espluga de Francolí, l'",2000,3654,1802,1852,518,2272,864
268,080771,Esplugues de Llobregat,2000,45668,22474,23194,5826,33729,6113
269,170643,Espolla,2000,373,187,186,48,219,106
270,170656,Esponellà,2000,402,200,202,46,259,97
271,250827,Espot,2000,298,162,136,21,213,64
272,080787,"Espunyola, l'",2000,276,138,138,35,171,70
273,082541,"Esquirol, l'",2000,2088,1042,1046,271,1404,413
274,250886,Estamariu,2000,123,66,57,4,79,40
275,080790,"Estany, l'",2000,398,189,209,35,263,100
276,250851,Estaràs,2000,187,103,84,25,112,50
277,250864,Esterri d'Àneu,2000,646,319,327,50,427,169
278,250870,Esterri de Cardós,2000,75,40,35,6,46,23
279,430555,Falset,2000,2448,1234,1214,336,1554,558
280,170059,"Far d'Empordà, el",2000,387,202,185,51,265,71
281,250899,Farrera,2000,97,57,40,14,62,21
282,430568,"Fatarella, la",2000,1244,620,624,119,749,376
283,430574,"Febró, la",2000,63,39,24,5,44,14
284,081347,Figaró-Montmany,2000,825,436,389,126,549,150
285,080804,Fígols,2000,50,29,21,1,32,17
286,259084,Fígols i Alinyà,2000,296,162,134,18,162,116
287,430580,"Figuera, la",2000,121,61,60,14,71,36
288,170669,Figueres,2000,34023,16529,17494,5477,22674,5872
289,430593,Figuerola del Camp,2000,280,134,146,39,174,67
290,170675,Flaçà,2000,845,417,428,94,549,202
291,430607,Flix,2000,4208,2099,2109,535,2754,919
292,250925,"Floresta, la",2000,177,96,81,22,89,66
293,080826,Fogars de la Selva,2000,692,359,333,103,469,120
294,080811,Fogars de Montclús,2000,350,182,168,39,248,63
295,170681,Foixà,2000,322,155,167,39,194,89
296,080832,Folgueroles,2000,1598,797,801,252,1085,261
297,250931,Fondarella,2000,680,343,337,95,466,119
298,080847,Fonollosa,2000,941,476,465,138,634,169
299,170694,Fontanals de Cerdanya,2000,399,197,202,51,275,73
300,170708,Fontanilles,2000,153,83,70,8,114,31
301,170715,Fontcoberta,2000,1110,553,557,166,778,166
302,080850,Font-rubí,2000,1200,622,578,152,728,320
303,250946,Foradada,2000,215,125,90,25,135,55
304,179026,Forallac,2000,1650,809,841,202,1145,303
305,430614,Forès,2000,68,33,35,0,45,23
306,170736,Fornells de la Selva,2000,1489,723,766,236,1041,212
307,170741,Fortià,2000,525,259,266,57,338,130
308,080863,"Franqueses del Vallès, les",2000,12300,6139,6161,1963,8864,1473
309,430629,Freginals,2000,362,180,182,40,207,115
310,250962,"Fuliola, la",2000,1251,630,621,155,758,338
311,250978,Fulleda,2000,116,61,55,11,70,35
312,080902,Gaià,2000,168,88,80,28,109,31
313,430635,"Galera, la",2000,746,367,379,71,428,247
314,080879,Gallifa,2000,156,82,74,30,108,18
315,430640,Gandesa,2000,2564,1284,1280,322,1615,627
316,430653,Garcia,2000,512,262,250,38,304,170
317,430666,"Garidells, els",2000,162,80,82,22,100,40
318,080885,"Garriga, la",2000,11547,5593,5954,1863,7898,1786
319,170754,Garrigàs,2000,339,182,157,40,210,89
320,170767,Garrigoles,2000,150,81,69,18,94,38
321,170773,Garriguella,2000,726,369,357,84,475,167
322,080898,Gavà,2000,39220,19524,19696,5783,28427,5010
323,250984,Gavet de la Conca,2000,322,159,163,29,170,123
324,080919,Gelida,2000,4354,2174,2180,601,3020,733
325,170789,Ger,2000,375,200,175,43,257,75
326,259123,Gimenells i el Pla de la Font,2000,1124,587,537,126,745,253
327,430672,Ginestar,2000,837,423,414,81,491,265
328,170792,Girona,2000,73637,35415,38222,11760,50503,11374
329,080924,Gironella,2000,4867,2349,2518,514,3054,1299
330,080930,Gisclareny,2000,26,14,12,1,18,7
331,430688,Godall,2000,721,366,355,64,405,252
332,250997,Golmés,2000,1336,644,692,175,871,290
333,170806,Gombrèn,2000,235,113,122,14,161,60
334,251001,Gósol,2000,225,125,100,19,150,56
335,080945,"Granada, la",2000,1329,645,684,199,871,259
336,251018,"Granadella, la",2000,810,420,390,86,457,267
337,080958,Granera,2000,59,40,19,0,43,16
338,251023,"Granja d'Escarp, la",2000,1100,586,514,132,728,240
339,080961,Granollers,2000,52423,25564,26859,7799,37248,7376
340,251039,Granyanella,2000,150,77,73,11,97,42
341,251057,Granyena de les Garrigues,2000,170,86,84,8,104,58
342,251044,Granyena de Segarra,2000,158,82,76,6,91,61
343,430691,Gratallops,2000,232,123,109,25,154,53
344,080977,Gualba,2000,783,409,374,98,552,133
345,170813,Gualta,2000,293,150,143,46,186,61
346,080996,Guardiola de Berguedà,2000,1013,508,505,130,607,276
347,430705,"Guiamets, els",2000,304,152,152,38,178,88
348,170828,Guils de Cerdanya,2000,334,164,170,44,237,53
349,251095,Guimerà,2000,399,202,197,23,221,155
350,259031,"Guingueta d'Àneu, la",2000,313,161,152,40,186,87
351,251109,Guissona,2000,3339,1700,1639,581,2245,513
352,251116,Guixers,2000,151,91,60,9,100,42
353,081000,Gurb,2000,1898,967,931,310,1311,277
354,430712,Horta de Sant Joan,2000,1233,653,580,135,744,354
355,081017,"Hospitalet de Llobregat, l'",2000,241782,118140,123642,27165,173503,41114
356,081629,"Hostalets de Pierola, els",2000,1239,642,597,128,860,251
357,170834,Hostalric,2000,2901,1420,1481,408,2043,450
358,081022,Igualada,2000,32516,15815,16701,4469,21966,6081
359,251155,Isona i Conca Dellà,2000,1222,650,572,106,719,397
360,170849,Isòvol,2000,204,113,91,21,134,49
361,251137,Ivars d'Urgell,2000,1764,907,857,206,1089,469
362,251121,Ivars de Noguera,2000,338,171,167,31,218,89
363,251142,Ivorra,2000,153,72,81,14,95,44
364,170852,Jafre,2000,317,163,154,25,185,107
365,170865,"Jonquera, la",2000,2565,1288,1277,399,1808,358
366,081038,Jorba,2000,572,273,299,98,347,127
367,259101,Josa i Tuixén,2000,169,90,79,14,105,50
368,170871,Juià,2000,266,123,143,28,174,64
369,251180,Juncosa,2000,629,360,269,74,387,168
370,251193,Juneda,2000,2988,1503,1485,384,1881,723
371,251214,Les,2000,697,351,346,106,468,123
372,251229,Linyola,2000,2401,1192,1209,311,1548,542
373,081043,"Llacuna, la",2000,849,441,408,109,536,204
374,170887,Lladó,2000,502,257,245,53,310,139
375,251235,Lladorre,2000,234,119,115,22,155,57
376,251240,Lladurs,2000,244,128,116,28,161,55
377,081056,"Llagosta, la",2000,11933,5968,5965,1613,8891,1429
378,170890,Llagostera,2000,5769,2927,2842,822,3848,1099
379,170904,Llambilles,2000,472,242,230,55,321,96
380,170911,Llanars,2000,489,249,240,49,331,109
381,170926,Llançà,2000,4063,2007,2056,511,2692,860
382,251253,Llardecans,2000,625,322,303,66,372,187
383,251266,Llavorsí,2000,285,141,144,37,174,74
384,251207,Lleida,2000,112194,54537,57657,15885,77144,19165
385,170932,Llers,2000,954,484,470,108,669,177
386,251272,Lles de Cerdanya,2000,288,161,127,32,186,70
387,081075,Lliçà d'Amunt,2000,9595,4954,4641,1567,7059,969
388,081081,Lliçà de Vall,2000,5070,2610,2460,799,3783,488
389,251288,Llimiana,2000,147,81,66,10,93,44
390,081069,Llinars del Vallès,2000,6877,3469,3408,1075,4891,911
391,170947,Llívia,2000,1013,535,478,120,724,169
392,430727,"Lloar, el",2000,123,61,62,3,70,50
393,251291,Llobera,2000,237,122,115,22,142,73
394,430733,Llorac,2000,120,58,62,12,73,35
395,430748,Llorenç del Penedès,2000,1575,755,820,254,1020,301
396,170950,Lloret de Mar,2000,20045,10081,9964,3411,14397,2237
397,170963,"Llosses, les",2000,275,147,128,29,187,59
398,081094,Lluçà,2000,288,158,130,47,185,56
399,171024,Maçanet de Cabrenys,2000,664,342,322,55,406,203
400,171030,Maçanet de la Selva,2000,3814,1953,1861,587,2658,569
401,170979,Madremanya,2000,185,83,102,18,126,41
402,170985,Maià de Montcal,2000,321,160,161,33,213,75
403,251333,Maials,2000,985,493,492,95,573,317
404,251305,Maldà,2000,292,153,139,31,165,96
405,081108,Malgrat de Mar,2000,13686,6827,6859,1876,9474,2336
406,081115,Malla,2000,255,115,140,32,173,50
407,081120,Manlleu,2000,17520,8722,8798,2707,11832,2981
408,081136,Manresa,2000,63742,30608,33134,7890,41930,13922
409,430764,Marçà,2000,600,295,305,57,358,185
410,430751,Margalef,2000,129,66,63,8,72,49
411,082423,Marganell,2000,243,108,135,29,158,56
412,081141,Martorell,2000,21314,10727,10587,3206,15137,2971
413,081154,Martorelles,2000,4895,2450,2445,700,3510,685
414,430770,Mas de Barberans,2000,699,360,339,75,428,196
415,171002,Masarac,2000,245,119,126,27,134,84
416,430786,Masdenverge,2000,956,488,468,141,589,226
417,081167,"Masies de Roda, les",2000,655,327,328,99,426,130
418,081173,"Masies de Voltregà, les",2000,2703,1309,1394,374,1897,432
419,430799,Masllorenç,2000,409,206,203,41,256,112
420,081189,"Masnou, el",2000,21076,10207,10869,3229,14978,2869
421,430803,"Masó, la",2000,275,134,141,25,186,64
422,430810,Maspujols,2000,464,243,221,61,279,124
423,081192,Masquefa,2000,4582,2331,2251,681,3269,632
424,430825,"Masroig, el",2000,506,246,260,39,287,180
425,251312,Massalcoreig,2000,638,305,333,70,370,198
426,171019,Massanes,2000,542,288,254,60,367,115
427,251327,Massoteres,2000,183,95,88,20,102,61
428,081206,Matadepera,2000,6924,3474,3450,1331,4810,783
429,081213,Mataró,2000,104659,51324,53335,15617,73401,15641
430,081228,Mediona,2000,1446,745,701,165,943,338
431,251348,Menàrguens,2000,806,412,394,79,488,239
432,170998,Meranges,2000,83,49,34,0,58,25
433,171058,Mieres,2000,336,163,173,47,199,90
434,430831,"Milà, el",2000,162,79,83,13,119,30
435,251351,Miralcamp,2000,1250,598,652,175,806,269
436,430846,Miravet,2000,788,415,373,91,484,213
437,081385,Moià,2000,3988,1961,2027,590,2641,757
438,430859,"Molar, el",2000,289,152,137,27,163,99
439,081234,Molins de Rei,2000,19723,9664,10059,2734,13934,3055
440,251370,Mollerussa,2000,9581,4749,4832,1451,6602,1528
441,171061,Mollet de Peralada,2000,189,104,85,13,111,65
442,081249,Mollet del Vallès,2000,46204,23079,23125,7284,33961,4959
443,171077,Molló,2000,339,174,165,28,212,99
444,251364,"Molsosa, la",2000,133,68,65,16,85,32
445,081287,Monistrol de Calders,2000,597,296,301,76,393,128
446,081271,Monistrol de Montserrat,2000,2490,1261,1229,280,1671,539
447,171096,Montagut i Oix,2000,792,409,383,94,484,214
448,430862,Montblanc,2000,6029,2984,3045,820,4005,1204
449,430884,Montbrió del Camp,2000,1459,732,727,186,918,355
450,081252,Montcada i Reixac,2000,27952,13793,14159,4180,19772,4000
451,081304,Montclar,2000,117,61,56,17,69,31
452,251399,Montellà i Martinet,2000,507,265,242,52,313,142
453,081311,Montesquiu,2000,844,412,432,91,533,220
454,251403,Montferrer i Castellbò,2000,738,405,333,70,507,161
455,430897,Montferri,2000,157,80,77,14,83,60
456,251386,Montgai,2000,789,402,387,85,454,250
457,081265,Montgat,2000,8305,4092,4213,1135,6014,1156
458,081326,Montmajor,2000,473,244,229,49,307,117
459,081332,Montmaneu,2000,194,102,92,16,123,55
460,430901,"Montmell, el",2000,408,226,182,39,278,91
461,081350,Montmeló,2000,8437,4207,4230,1227,6175,1035
462,251425,Montoliu de Lleida,2000,479,235,244,47,315,117
463,251410,Montoliu de Segarra,2000,192,109,83,16,104,72
464,251431,Montornès de Segarra,2000,104,48,56,6,57,41
465,081363,Montornès del Vallès,2000,12426,6254,6172,1938,9083,1405
466,430918,Mont-ral,2000,160,89,71,16,125,19
467,171100,Mont-ras,2000,1644,871,773,257,1171,216
468,430923,Mont-roig del Camp,2000,6683,3402,3281,883,4752,1048
469,081379,Montseny,2000,301,155,146,38,206,57
470,430939,Móra d'Ebre,2000,4816,2376,2440,732,3127,957
471,430944,Móra la Nova,2000,2661,1324,1337,381,1698,582
472,430957,"Morell, el",2000,2308,1168,1140,372,1582,354
473,430960,"Morera de Montsant, la",2000,176,101,75,12,117,47
474,081290,Muntanyola,2000,311,168,143,58,212,41
475,081398,Mura,2000,217,118,99,17,149,51
476,251459,Nalec,2000,105,50,55,8,59,38
477,250254,Naut Aran,2000,1480,777,703,224,1066,190
478,081402,Navarcles,2000,5318,2641,2677,702,3635,981
479,081419,Navàs,2000,5722,2830,2892,735,3737,1250
480,171117,Navata,2000,708,349,359,112,449,147
481,251462,Navès,2000,272,131,141,30,160,82
482,081424,"Nou de Berguedà, la",2000,153,83,70,21,91,41
483,430976,"Nou de Gaià, la",2000,376,189,187,37,249,90
484,430982,Nulles,2000,347,160,187,30,202,115
485,251484,Odèn,2000,279,159,120,30,159,90
486,081430,Òdena,2000,2681,1337,1344,399,1832,450
487,171122,Ogassa,2000,242,142,100,23,168,51
488,081458,Olèrdola,2000,2232,1141,1091,321,1539,372
489,081461,Olesa de Bonesvalls,2000,942,512,430,116,675,151
490,081477,Olesa de Montserrat,2000,17151,8640,8511,2609,11946,2596
491,251497,Oliana,2000,1864,943,921,186,1204,474
492,251500,Oliola,2000,227,125,102,26,152,49
493,251517,Olius,2000,555,282,273,99,363,93
494,081483,Olivella,2000,1319,702,617,186,1004,129
495,081496,Olost,2000,1160,568,592,145,707,308
496,171143,Olot,2000,27967,13521,14446,3756,17873,6338
497,251522,"Oluges, les",2000,187,95,92,10,122,55
498,081445,Olvan,2000,899,433,466,82,563,254
499,251538,"Omellons, els",2000,264,135,129,23,167,74
500,251543,"Omells de na Gaia, els",2000,152,82,70,19,85,48
501,171156,Ordis,2000,285,151,134,29,197,59
502,251556,Organyà,2000,992,507,485,95,624,273
503,081509,Orís,2000,226,114,112,33,136,57
504,081516,Oristà,2000,645,314,331,76,400,169
505,081521,Orpí,2000,147,78,69,17,99,31
506,081537,Òrrius,2000,420,220,200,55,303,62
507,251569,Os de Balaguer,2000,768,401,367,92,441,235
508,171169,Osor,2000,464,250,214,45,297,122
509,251575,Ossó de Sió,2000,233,119,114,25,149,59
510,081542,Pacs del Penedès,2000,653,325,328,100,470,83
511,081555,Palafolls,2000,5235,2627,2608,878,3790,567
512,171175,Palafrugell,2000,18154,9126,9028,2775,12295,3084
513,171181,Palamós,2000,14959,7386,7573,2268,10219,2472
514,251581,"Palau d'Anglesola, el",2000,1682,831,851,243,1077,362
515,171194,Palau de Santa Eulàlia,2000,90,54,36,9,66,15
516,171215,Palau-sator,2000,293,152,141,24,201,68
517,171208,Palau-saverdera,2000,931,467,464,96,604,231
518,081568,Palau-solità i Plegamans,2000,11089,5653,5436,1963,8078,1048
519,431009,"Pallaresos, els",2000,2537,1308,1229,501,1890,146
520,081574,Pallejà,2000,7258,3661,3597,1056,5324,878
521,430995,"Palma d'Ebre, la",2000,419,200,219,40,239,140
522,089058,"Palma de Cervelló, la",2000,2607,1319,1288,488,1830,289
523,171236,Palol de Revardit,2000,386,201,185,50,251,85
524,171241,Pals,2000,1912,975,937,208,1253,451
525,081580,"Papiol, el",2000,3464,1721,1743,541,2398,525
526,171254,Pardines,2000,143,72,71,14,90,39
527,081593,Parets del Vallès,2000,14478,7335,7143,2385,10511,1582
528,171267,Parlavà,2000,330,171,159,40,215,75
529,431016,Passanant i Belltall,2000,183,109,74,8,91,84
530,171289,Pau,2000,417,210,207,51,271,95
531,431021,Paüls,2000,640,324,316,68,405,167
532,171292,Pedret i Marzà,2000,127,65,62,18,76,33
533,251641,Penelles,2000,536,293,243,54,326,156
534,171306,"Pera, la",2000,367,187,180,44,229,94
535,081607,Perafita,2000,368,181,187,48,229,91
536,431037,Perafort,2000,610,312,298,73,433,104
537,171328,Peralada,2000,1277,651,626,153,835,289
538,251654,Peramola,2000,394,212,182,47,228,119
539,431042,"Perelló, el",2000,2145,1101,1044,231,1344,570
540,081614,Piera,2000,8540,4361,4179,1314,5775,1451
541,431055,"Piles, les",2000,178,98,80,28,116,34
542,081635,Pineda de Mar,2000,20057,10014,10043,3187,14149,2721
543,431068,"Pinell de Brai, el",2000,1074,546,528,110,692,272
544,251667,Pinell de Solsonès,2000,225,120,105,22,147,56
545,251673,Pinós,2000,320,174,146,31,193,96
546,431074,Pira,2000,402,197,205,46,261,95
547,431080,"Pla de Santa Maria, el",2000,1651,849,802,257,1058,336
548,081640,"Pla del Penedès, el",2000,923,461,462,93,614,216
549,171334,"Planes d'Hostoles, les",2000,1724,855,869,168,1102,454
550,171349,Planoles,2000,273,142,131,14,176,83
551,259118,"Plans de Sió, els",2000,595,308,287,52,349,194
552,251689,"Poal, el",2000,613,330,283,85,339,189
553,251692,"Pobla de Cérvoles, la",2000,212,119,93,26,123,63
554,081653,"Pobla de Claramunt, la",2000,1656,846,810,211,1110,335
555,081666,"Pobla de Lillet, la",2000,1455,715,740,111,890,454
556,431093,"Pobla de Mafumet, la",2000,1115,558,557,192,752,171
557,431107,"Pobla de Massaluca, la",2000,442,227,215,27,251,164
558,431114,"Pobla de Montornès, la",2000,1336,721,615,134,956,246
559,251713,"Pobla de Segur, la",2000,2852,1385,1467,282,1726,844
560,431129,Poboleda,2000,335,169,166,26,203,106
561,081672,Polinyà,2000,4657,2396,2261,874,3409,374
562,431135,"Pont d'Armentera, el",2000,576,297,279,49,356,171
563,250306,"Pont de Bar, el",2000,160,88,72,16,91,53
564,171352,Pont de Molins,2000,430,230,200,59,283,88
565,251734,"Pont de Suert, el",2000,2164,1094,1070,246,1408,510
566,081825,"Pont de Vilomara i Rocafort, el",2000,2614,1345,1269,393,1815,406
567,431418,Pontils,2000,148,75,73,13,103,32
568,081688,Pontons,2000,363,193,170,37,241,85
569,171365,Pontós,2000,217,121,96,16,146,55
570,251728,Ponts,2000,2382,1204,1178,323,1533,526
571,171371,Porqueres,2000,3622,1780,1842,591,2501,530
572,431140,Porrera,2000,472,254,218,63,286,123
573,171404,"Port de la Selva, el",2000,877,440,437,93,598,186
574,171387,Portbou,2000,1511,761,750,136,912,463
575,251749,"Portella, la",2000,576,311,265,54,373,149
576,431153,Pradell de la Teixeta,2000,198,101,97,12,128,58
577,431166,Prades,2000,528,267,261,58,316,154
578,431172,Prat de Comte,2000,178,85,93,14,97,67
579,081691,"Prat de Llobregat, el",2000,62956,31518,31438,9266,46198,7492
580,431188,Pratdip,2000,563,282,281,59,343,161
581,081712,Prats de Lluçanès,2000,2750,1342,1408,417,1751,582
582,081705,"Prats de Rei, els",2000,537,267,270,55,335,147
583,251752,Prats i Sansor,2000,212,115,97,34,151,27
584,251765,Preixana,2000,440,216,224,38,241,161
585,251771,Preixens,2000,523,250,273,45,299,179
586,082303,Premià de Dalt,2000,8869,4443,4426,1393,6518,958
587,081727,Premià de Mar,2000,26130,13005,13125,4013,18836,3281
588,171390,"Preses, les",2000,1373,668,705,165,935,273
589,251790,Prullans,2000,219,116,103,25,139,55
590,171411,Puigcerdà,2000,6902,3529,3373,1032,4729,1141
591,081748,Puigdàlber,2000,333,150,183,52,223,58
592,251804,Puiggròs,2000,261,137,124,25,156,80
593,431191,Puigpelat,2000,597,300,297,88,407,102
594,081751,Puig-reig,2000,4319,2087,2232,474,2663,1182
595,251811,Puigverd d'Agramunt,2000,243,136,107,25,152,66
596,251826,Puigverd de Lleida,2000,1043,511,532,123,659,261
597,081764,Pujalt,2000,178,92,86,20,111,47
598,081770,"Quar, la",2000,79,41,38,13,55,11
599,171426,Quart,2000,2402,1231,1171,389,1741,272
600,170433,Queralbs,2000,201,115,86,21,116,64
601,431205,Querol,2000,305,170,135,28,221,56
602,171432,Rabós,2000,145,69,76,8,96,41
603,081786,Rajadell,2000,456,234,222,40,340,76
604,431212,Rasquera,2000,792,402,390,80,459,253
605,171447,Regencós,2000,287,166,121,35,184,68
606,081799,Rellinars,2000,378,194,184,53,254,71
607,431227,Renau,2000,61,29,32,10,39,12
608,431233,Reus,2000,89179,43499,45680,13799,61493,13887
609,251832,Rialp,2000,517,272,245,70,344,103
610,431248,"Riba, la",2000,732,380,352,78,483,171
611,431251,Riba-roja d'Ebre,2000,1350,696,654,143,827,380
612,259059,Ribera d'Ondara,2000,516,269,247,64,305,147
613,251850,Ribera d'Urgellet,2000,811,423,388,83,501,227
614,171450,Ribes de Freser,2000,2096,1017,1079,213,1293,590
615,171463,Riells i Viabrea,2000,2043,1073,970,338,1491,214
616,431264,"Riera de Gaià, la",2000,970,486,484,113,641,216
617,251863,Riner,2000,286,150,136,33,188,65
618,171479,Ripoll,2000,10733,5180,5553,1289,7018,2426
619,081803,Ripollet,2000,29877,14935,14942,4597,21852,3428
620,259139,Riu de Cerdanya,2000,81,39,42,8,59,14
621,171485,Riudarenes,2000,1302,678,624,161,867,274
622,171498,Riudaura,2000,417,210,207,52,283,82
623,431270,Riudecanyes,2000,694,349,345,77,431,186
624,431286,Riudecols,2000,997,511,486,148,646,203
625,171501,Riudellots de la Selva,2000,1548,796,752,225,1058,265
626,431299,Riudoms,2000,5201,2613,2588,759,3524,918
627,171518,Riumors,2000,192,95,97,22,109,61
628,081810,"Roca del Vallès, la",2000,7380,3714,3666,1080,5476,824
629,431303,Rocafort de Queralt,2000,279,148,131,26,151,102
630,431310,Roda de Berà,2000,3361,1829,1532,438,2494,429
631,081831,Roda de Ter,2000,5148,2483,2665,796,3375,977
632,431325,Rodonyà,2000,420,218,202,53,246,121
633,431331,Roquetes,2000,6366,3203,3163,889,4241,1236
634,171523,Roses,2000,12857,6502,6355,2185,8916,1756
635,251898,Rosselló,2000,1852,903,949,293,1210,349
636,431346,"Rourell, el",2000,262,139,123,25,151,86
637,081846,Rubí,2000,58646,29391,29255,9359,42417,6870
638,081859,Rubió,2000,120,68,52,21,67,32
639,171539,Rupià,2000,190,101,89,14,129,47
640,089019,Rupit i Pruit,2000,354,178,176,40,238,76
641,081878,Sabadell,2000,183727,89079,94648,26287,126771,30669
642,081884,Sagàs,2000,155,80,75,19,99,37
643,251902,Salàs de Pallars,2000,330,163,167,23,183,124
644,081901,Saldes,2000,328,183,145,45,219,64
645,171544,Sales de Llierca,2000,89,49,40,18,60,11
646,081918,Sallent,2000,7159,3449,3710,817,4607,1735
647,431359,Salomó,2000,382,194,188,35,224,123
648,439057,Salou,2000,13059,6629,6430,2078,9650,1331
649,171557,Salt,2000,22017,10935,11082,3477,15243,3297
650,251919,Sanaüja,2000,464,225,239,49,276,139
651,081944,Sant Adrià de Besòs,2000,32452,15946,16506,4981,22721,4750
652,081957,Sant Agustí de Lluçanès,2000,121,65,56,19,84,18
653,081960,Sant Andreu de la Barca,2000,20140,10277,9863,3023,15403,1714
654,081976,Sant Andreu de Llavaneres,2000,7161,3579,3582,1237,5101,823
655,171576,Sant Andreu Salou,2000,138,65,73,24,84,30
656,171833,Sant Aniol de Finestres,2000,270,148,122,23,184,63
657,081982,Sant Antoni de Vilamajor,2000,3293,1655,1638,524,2291,478
658,081995,Sant Bartomeu del Grau,2000,1150,603,547,232,773,145
659,082009,Sant Boi de Llobregat,2000,79337,39419,39918,11610,57865,9862
660,082016,Sant Boi de Lluçanès,2000,540,273,267,52,357,131
661,431362,Sant Carles de la Ràpita,2000,11194,5552,5642,1558,7453,2183
662,082037,Sant Cebrià de Vallalta,2000,1757,945,812,276,1282,199
663,082021,Sant Celoni,2000,12734,6302,6432,1941,8637,2156
664,082042,Sant Climent de Llobregat,2000,2950,1473,1477,456,2160,334
665,171582,Sant Climent Sescebes,2000,404,204,200,29,249,126
666,082055,Sant Cugat del Vallès,2000,52654,25939,26715,9038,37899,5717
667,082068,Sant Cugat Sesgarrigues,2000,731,375,356,85,497,149
668,251961,Sant Esteve de la Sarga,2000,117,72,45,4,80,33
669,082074,Sant Esteve de Palautordera,2000,1461,737,724,269,988,204
670,082080,Sant Esteve Sesrovires,2000,5161,2702,2459,839,3765,557
671,171595,Sant Feliu de Buixalleu,2000,727,387,340,109,469,149
672,082107,Sant Feliu de Codines,2000,4290,2135,2155,638,2877,775
673,171609,Sant Feliu de Guíxols,2000,18403,9031,9372,2827,12365,3211
674,082114,Sant Feliu de Llobregat,2000,38435,18972,19463,5282,28619,4534
675,171616,Sant Feliu de Pallerols,2000,1155,564,591,146,710,299
676,082129,Sant Feliu Sasserra,2000,657,321,336,89,415,153
677,171621,Sant Ferriol,2000,196,110,86,26,129,41
678,082093,Sant Fost de Campsentelles,2000,6312,3206,3106,875,4695,742
679,082135,Sant Fruitós de Bages,2000,5542,2772,2770,794,3951,797
680,171637,Sant Gregori,2000,2335,1213,1122,343,1613,379
681,251924,Sant Guim de Freixenet,2000,1046,506,540,119,661,266
682,251977,Sant Guim de la Plana,2000,189,100,89,19,115,55
683,171642,Sant Hilari Sacalm,2000,4985,2543,2442,720,3347,918
684,082153,Sant Hipòlit de Voltregà,2000,3005,1485,1520,413,1911,681
685,081939,Sant Iscle de Vallalta,2000,839,435,404,123,588,128
686,439023,Sant Jaume d'Enveja,2000,3305,1668,1637,416,2217,672
687,082166,Sant Jaume de Frontanyà,2000,28,15,13,2,23,3
688,171655,Sant Jaume de Llierca,2000,714,352,362,90,406,218
689,431378,Sant Jaume dels Domenys,2000,1390,724,666,173,916,301
690,171674,Sant Joan de les Abadesses,2000,3672,1810,1862,384,2383,905
691,171680,Sant Joan de Mollet,2000,354,171,183,57,224,73
692,082188,Sant Joan de Vilatorrada,2000,9145,4570,4575,1293,6503,1349
693,082172,Sant Joan Despí,2000,27627,13638,13989,4238,20303,3086
694,171851,Sant Joan les Fonts,2000,2756,1364,1392,277,1869,610
695,171668,Sant Jordi Desvalls,2000,587,302,285,66,368,153
696,089030,Sant Julià de Cerdanyola,2000,227,122,105,20,149,58
697,171693,Sant Julià de Ramis,2000,2018,1016,1002,295,1411,312
698,082205,Sant Julià de Vilatorta,2000,2269,1106,1163,370,1570,329
699,179032,Sant Julià del Llor i Bonmatí,2000,921,467,454,115,598,208
700,082212,Sant Just Desvern,2000,14030,6763,7267,2136,9898,1996
701,082227,Sant Llorenç d'Hortons,2000,1547,775,772,225,1021,301
702,171714,Sant Llorenç de la Muga,2000,182,86,96,14,107,61
703,251930,Sant Llorenç de Morunys,2000,900,457,443,95,577,228
704,082233,Sant Llorenç Savall,2000,1983,988,995,260,1246,477
705,082251,Sant Martí d'Albars,2000,132,64,68,12,87,33
706,082248,Sant Martí de Centelles,2000,729,378,351,113,488,128
707,171729,Sant Martí de Llémena,2000,478,245,233,79,315,84
708,259025,Sant Martí de Riucorb,2000,696,356,340,53,426,217
709,082264,Sant Martí de Tous,2000,982,494,488,130,632,220
710,082270,Sant Martí Sarroca,2000,2478,1229,1249,325,1604,549
711,082286,Sant Martí Sesgueioles,2000,342,170,172,34,217,91
712,171735,Sant Martí Vell,2000,161,82,79,24,99,38
713,082299,Sant Mateu de Bages,2000,491,252,239,49,307,135
714,171740,Sant Miquel de Campmajor,2000,206,116,90,29,134,43
715,171753,Sant Miquel de Fluvià,2000,625,318,307,101,413,111
716,171766,Sant Mori,2000,158,75,83,25,94,39
717,171772,Sant Pau de Segúries,2000,655,333,322,75,404,176
718,082310,Sant Pere de Ribes,2000,21976,11111,10865,3747,15895,2334
719,082325,Sant Pere de Riudebitlles,2000,2076,1023,1053,258,1396,422
720,082331,Sant Pere de Torelló,2000,2160,1054,1106,243,1465,452
721,082346,Sant Pere de Vilamajor,2000,2547,1329,1218,401,1831,315
722,171788,Sant Pere Pescador,2000,1428,788,640,184,949,295
723,081897,Sant Pere Sallavinera,2000,155,78,77,11,89,55
724,082359,Sant Pol de Mar,2000,3594,1863,1731,472,2610,512
725,082362,Sant Quintí de Mediona,2000,1679,826,853,188,1121,370
726,082378,Sant Quirze de Besora,2000,1978,970,1008,212,1239,527
727,082384,Sant Quirze del Vallès,2000,12706,6358,6348,2359,9143,1204
728,082397,Sant Quirze Safaja,2000,369,197,172,46,276,47
729,251945,Sant Ramon,2000,556,277,279,50,352,154
730,082401,Sant Sadurní d'Anoia,2000,9539,4734,4805,1382,6533,1624
731,082418,Sant Sadurní d'Osormort,2000,76,41,35,9,51,16
732,080983,Sant Salvador de Guardiola,2000,1994,1015,979,287,1420,287
733,082628,Sant Vicenç de Castellet,2000,7212,3457,3755,884,4817,1511
734,082649,Sant Vicenç de Montalt,2000,3334,1701,1633,566,2424,344
735,082652,Sant Vicenç de Torelló,2000,1786,863,923,254,1103,429
736,082634,Sant Vicenç dels Horts,2000,24438,12273,12165,3970,17648,2820
737,431384,Santa Bàrbara,2000,3257,1628,1629,401,2031,825
738,082439,Santa Cecília de Voltregà,2000,202,112,90,36,127,39
739,082444,Santa Coloma de Cervelló,2000,4691,2351,2340,776,3355,560
740,171805,Santa Coloma de Farners,2000,8867,4510,4357,1332,5991,1544
741,082457,Santa Coloma de Gramenet,2000,117127,58139,58988,14233,86773,16121
742,431397,Santa Coloma de Queralt,2000,2615,1263,1352,355,1661,599
743,171812,Santa Cristina d'Aro,2000,2902,1518,1384,472,1978,452
744,082460,Santa Eugènia de Berga,2000,1946,987,959,311,1347,288
745,082476,Santa Eulàlia de Riuprimer,2000,864,449,415,123,565,176
746,082482,Santa Eulàlia de Ronçana,2000,4536,2291,2245,637,3240,659
747,082495,Santa Fe del Penedès,2000,293,145,148,52,191,50
748,171827,Santa Llogaia d'Àlguema,2000,300,157,143,44,210,46
749,082508,Santa Margarida de Montbui,2000,9123,4541,4582,1368,6607,1148
750,082515,Santa Margarida i els Monjos,2000,4661,2370,2291,695,3339,627
751,082589,Santa Maria d'Oló,2000,1006,519,487,104,674,228
752,082536,Santa Maria de Besora,2000,183,93,90,24,110,49
753,082567,Santa Maria de Martorelles,2000,700,340,360,104,486,110
754,082554,Santa Maria de Merlès,2000,168,88,80,19,110,39
755,082573,Santa Maria de Miralles,2000,88,44,44,6,56,26
756,082592,Santa Maria de Palautordera,2000,6306,3193,3113,942,4432,932
757,431401,Santa Oliva,2000,2101,1066,1035,327,1425,349
758,171848,Santa Pau,2000,1484,755,729,172,1001,311
759,082606,Santa Perpètua de Mogoda,2000,19084,9630,9454,2697,14473,1914
760,082613,Santa Susanna,2000,1908,987,921,306,1352,250
761,081923,Santpedor,2000,5352,2611,2741,791,3727,834
762,431423,Sarral,2000,1430,745,685,181,910,339
763,171864,Sarrià de Ter,2000,3457,1711,1746,445,2362,650
764,252017,Sarroca de Bellera,2000,155,87,68,13,91,51
765,252000,Sarroca de Lleida,2000,481,242,239,57,291,133
766,171870,"Saus, Camallera i Llampaies",2000,688,340,348,80,460,148
767,431439,Savallà del Comtat,2000,75,36,39,9,39,27
768,431444,"Secuita, la",2000,1131,572,559,180,766,185
769,171886,"Selva de Mar, la",2000,190,96,94,27,113,50
770,431457,"Selva del Camp, la",2000,4103,2064,2039,718,2667,718
771,431460,Senan,2000,31,20,11,7,18,6
772,430445,"Sénia, la",2000,5034,2562,2472,731,3296,1007
773,252022,Senterada,2000,112,59,53,7,68,37
774,250352,"Sentiu de Sió, la",2000,474,230,244,46,299,129
775,082671,Sentmenat,2000,5675,2823,2852,854,4013,808
776,171903,Serinyà,2000,837,436,401,105,567,165
777,252043,Seròs,2000,1737,927,810,191,1081,465
778,171910,Serra de Daró,2000,186,95,91,20,104,62
779,171925,Setcases,2000,163,87,76,18,113,32
780,252038,"Seu d'Urgell, la",2000,10943,5305,5638,1543,7318,2082
781,082690,Seva,2000,2510,1284,1226,381,1749,380
782,252056,Sidamon,2000,527,264,263,60,362,105
783,171931,Sils,2000,3078,1558,1520,481,2084,513
784,082704,Sitges,2000,19448,5458,13990,2693,13793,2962
785,170524,Siurana,2000,159,80,79,24,87,48
786,082711,Sobremunt,2000,87,41,46,20,57,10
787,252069,"Soleràs, el",2000,418,215,203,27,260,131
788,431476,Solivella,2000,622,304,318,58,355,209
789,252075,Solsona,2000,7343,3649,3694,1027,4917,1399
790,082726,Sora,2000,189,103,86,24,118,47
791,252081,Soriguera,2000,308,158,150,36,190,82
792,252094,Sort,2000,1791,897,894,230,1156,405
793,252108,Soses,2000,1537,801,736,179,1034,324
794,082732,Subirats,2000,2529,1273,1256,343,1565,621
795,252115,Sudanell,2000,712,385,327,67,466,179
796,252120,Sunyer,2000,300,148,152,32,188,80
797,082747,Súria,2000,6157,3026,3131,822,3956,1379
798,171946,Susqueda,2000,87,49,38,10,63,14
799,082763,Tagamanent,2000,195,107,88,26,137,32
800,082779,Talamanca,2000,107,61,46,10,79,18
801,252154,Talarn,2000,364,184,180,47,233,84
802,252167,Talavera,2000,296,155,141,20,189,87
803,171959,"Tallada d'Empordà, la",2000,332,173,159,28,215,89
804,082785,Taradell,2000,5000,2484,2516,760,3443,797
805,431482,Tarragona,2000,114097,55698,58399,16712,79750,17635
806,252173,Tàrrega,2000,12548,6063,6485,1889,8324,2335
807,252189,Tarrés,2000,105,58,47,15,59,31
808,252192,Tarroja de Segarra,2000,178,88,90,16,99,63
809,082750,Tavèrnoles,2000,272,132,140,41,195,36
810,082802,Tavertet,2000,140,75,65,15,96,29
811,082819,Teià,2000,5280,2657,2623,909,3802,569
812,252206,Térmens,2000,1404,706,698,158,925,321
813,171962,Terrades,2000,200,95,105,18,112,70
814,082798,Terrassa,2000,171794,83957,87837,25613,118700,27481
815,082824,Tiana,2000,5663,2804,2859,905,4088,670
816,252213,Tírvia,2000,122,67,55,16,74,32
817,252228,Tiurana,2000,23,16,7,4,12,7
818,431495,Tivenys,2000,917,458,459,73,585,259
819,431508,Tivissa,2000,1764,876,888,211,1064,489
820,082830,Tona,2000,5868,2914,2954,831,4073,964
821,252234,Torà,2000,1191,599,592,156,756,279
822,082845,Tordera,2000,9798,4961,4837,1392,6809,1597
823,082858,Torelló,2000,12150,5913,6237,1690,8291,2169
824,252249,"Torms, els",2000,197,106,91,17,112,68
825,252252,Tornabous,2000,820,415,405,78,489,253
826,252271,"Torre de Cabdella, la",2000,679,339,340,40,403,236
827,082861,"Torre de Claramunt, la",2000,2371,1228,1143,391,1731,249
828,431515,"Torre de Fontaubella, la",2000,128,63,65,6,82,40
829,431520,"Torre de l'Espanyol, la",2000,674,349,325,66,408,200
830,252265,Torrebesses,2000,323,159,164,37,171,115
831,431536,Torredembarra,2000,10581,5254,5327,1687,7385,1509
832,252287,Torrefarrera,2000,1734,884,850,187,1187,360
833,259078,Torrefeta i Florejacs,2000,658,332,326,62,389,207
834,252304,Torregrossa,2000,2242,1107,1135,260,1347,635
835,252311,Torrelameu,2000,578,317,261,49,375,154
836,082877,Torrelavit,2000,1172,597,575,127,770,275
837,082883,Torrelles de Foix,2000,1684,896,788,240,1091,353
838,082896,Torrelles de Llobregat,2000,3574,1820,1754,658,2566,350
839,171978,Torrent,2000,172,84,88,24,114,34
840,252326,Torres de Segre,2000,1815,932,883,215,1205,395
841,252332,Torre-serona,2000,326,162,164,36,217,73
842,171984,Torroella de Fluvià,2000,319,180,139,29,207,83
843,171997,Torroella de Montgrí,2000,8454,4281,4173,1381,5740,1333
844,431541,Torroja del Priorat,2000,139,80,59,8,88,43
845,172001,Tortellà,2000,717,363,354,88,433,196
846,431554,Tortosa,2000,29481,14288,15193,3974,19244,6263
847,172018,Toses,2000,151,87,64,23,87,41
848,172023,Tossa de Mar,2000,4195,2083,2112,575,2998,622
849,252347,Tremp,2000,5377,2650,2727,688,3227,1462
850,172044,Ullà,2000,814,425,389,130,545,139
851,082900,Ullastrell,2000,1114,571,543,156,786,172
852,172057,Ullastret,2000,234,122,112,20,169,45
853,431567,Ulldecona,2000,5304,2627,2677,685,3381,1238
854,431573,Ulldemolins,2000,495,259,236,39,290,166
855,172039,Ultramort,2000,203,114,89,21,121,61
856,172060,Urús,2000,188,101,87,25,129,34
857,082917,Vacarisses,2000,2687,1419,1268,387,1943,357
858,170144,"Vajol, la",2000,96,50,46,10,65,21
859,172076,"Vall d'en Bas, la",2000,2552,1311,1241,321,1574,657
860,172082,"Vall de Bianya, la",2000,1130,569,561,151,749,230
861,250432,"Vall de Boí, la",2000,870,481,389,107,600,163
862,259010,Vall de Cardós,2000,318,166,152,40,191,87
863,082922,Vallbona d'Anoia,2000,1089,558,531,145,736,208
864,252385,Vallbona de les Monges,2000,266,128,138,17,149,100
865,082938,Vallcebre,2000,269,142,127,28,169,72
866,431589,Vallclara,2000,117,62,55,11,69,37
867,252402,Vallfogona de Balaguer,2000,1505,756,749,179,1009,317
868,171707,Vallfogona de Ripollès,2000,219,114,105,20,144,55
869,431592,Vallfogona de Riucorb,2000,164,85,79,5,67,92
870,082943,Vallgorguina,2000,1325,698,627,196,947,182
871,082956,Vallirana,2000,9004,4564,4440,1376,6479,1149
872,172095,Vall-llobrega,2000,377,141,236,52,285,40
873,431606,Vallmoll,2000,1168,609,559,154,823,191
874,082969,Vallromanes,2000,1374,711,663,229,1000,145
875,431613,Valls,2000,20382,9994,10388,3070,13662,3650
876,259062,"Valls d'Aguilar, les",2000,296,161,135,25,175,96
877,252398,"Valls de Valira, les",2000,757,413,344,66,496,195
878,431628,Vandellòs i l'Hospitalet de l'Infant,2000,4343,2176,2167,647,3013,683
879,259097,"Vansa i Fórnols, la",2000,170,87,83,18,110,42
880,082975,Veciana,2000,154,83,71,14,99,41
881,431634,"Vendrell, el",2000,22543,11310,11233,3805,15862,2876
882,172109,Ventalló,2000,608,317,291,60,393,155
883,252424,Verdú,2000,1041,498,543,99,599,343
884,172116,Verges,2000,1134,566,568,143,694,297
885,431649,Vespella de Gaià,2000,205,116,89,20,146,39
886,082981,Vic,2000,31533,15191,16342,4643,21043,5847
887,172121,Vidrà,2000,158,78,80,23,100,35
888,172137,Vidreres,2000,4740,2405,2335,691,3295,754
889,252430,Vielha e Mijaran,2000,4139,2079,2060,719,2981,439
890,431652,Vilabella,2000,788,397,391,101,516,171
891,172142,Vilabertran,2000,784,397,387,88,514,182
892,172155,Vilablareix,2000,1842,916,926,304,1363,175
893,082994,Vilada,2000,522,266,256,49,311,162
894,172174,Viladamat,2000,417,221,196,43,258,116
895,172168,Viladasens,2000,185,96,89,24,107,54
896,083015,Viladecans,2000,56112,28262,27850,8932,41772,5408
897,083008,Viladecavalls,2000,5755,2904,2851,1114,4148,493
898,172180,Vilademuls,2000,720,365,355,63,480,177
899,172207,Viladrau,2000,856,426,430,106,556,194
900,172214,Vilafant,2000,4100,2047,2053,696,2982,422
901,083054,Vilafranca del Penedès,2000,30024,14744,15280,4422,20830,4772
902,252445,Vilagrassa,2000,453,243,210,48,295,110
903,172235,Vilajuïga,2000,953,474,479,158,635,160
904,431750,Vilalba dels Arcs,2000,762,399,363,78,445,239
905,083067,Vilalba Sasserra,2000,454,245,209,73,330,51
906,252458,Vilaller,2000,578,303,275,69,376,133
907,172240,Vilallonga de Ter,2000,421,232,189,33,261,127
908,431665,Vilallonga del Camp,2000,1237,614,623,173,844,220
909,172253,Vilamacolum,2000,261,138,123,26,160,75
910,172266,Vilamalla,2000,761,408,353,111,565,85
911,172272,Vilamaniscle,2000,120,65,55,12,71,37
912,252477,Vilamòs,2000,152,78,74,30,97,25
913,172288,Vilanant,2000,308,155,153,34,193,81
914,431671,Vilanova d'Escornalbou,2000,449,234,215,49,321,79
915,252483,Vilanova de Bellpuig,2000,1139,567,572,113,693,333
916,252496,Vilanova de l'Aguda,2000,273,140,133,30,159,84
917,252542,Vilanova de la Barca,2000,921,459,462,112,555,254
918,252509,Vilanova de Meià,2000,473,244,229,49,283,141
919,431687,Vilanova de Prades,2000,157,80,77,12,89,56
920,083036,Vilanova de Sau,2000,320,150,170,37,224,59
921,252516,Vilanova de Segrià,2000,789,405,384,94,536,159
922,083020,Vilanova del Camí,2000,10203,5127,5076,1710,7338,1155
923,089024,Vilanova del Vallès,2000,2314,1174,1140,372,1620,322
924,083073,Vilanova i la Geltrú,2000,52389,25734,26655,7476,36223,8690
925,431690,Vilaplana,2000,526,264,262,58,311,157
926,431704,Vila-rodona,2000,1034,562,472,107,645,282
927,172305,Vila-sacra,2000,383,190,193,33,273,77
928,252521,Vila-sana,2000,514,252,262,66,313,135
929,431711,Vila-seca,2000,13133,6612,6521,2146,9455,1532
930,082140,Vilassar de Dalt,2000,7484,3717,3767,904,5347,1233
931,082191,Vilassar de Mar,2000,17000,8327,8673,2631,12161,2208
932,172229,Vilaür,2000,125,72,53,8,94,23
933,431726,Vilaverd,2000,354,177,177,25,216,113
934,431732,"Vilella Alta, la",2000,128,66,62,7,79,42
935,431747,"Vilella Baixa, la",2000,174,94,80,14,105,55
936,172333,Vilobí d'Onyar,2000,2223,1170,1053,280,1570,373
937,083041,Vilobí del Penedès,2000,874,450,424,108,574,192
938,172327,Vilopriu,2000,161,83,78,12,96,53
939,252537,"Vilosell, el",2000,197,88,109,12,119,66
940,431763,Vimbodí i Poblet,2000,1011,539,472,80,630,301
941,252555,Vinaixa,2000,627,302,325,68,381,178
942,431779,Vinebre,2000,443,221,222,39,279,125
943,431785,Vinyols i els Arcs,2000,1213,632,581,166,818,229
944,083089,Viver i Serrateix,2000,188,96,92,21,117,50
945,430521,Xerta,2000,1225,608,617,151,755,319
946,000000,Catalunya,2000,6261999,3058628,3203371,852691,4323549,1085759
0,250019,Abella de la Conca,2001,199,103,96,33,125,41
1,080018,Abrera,2001,8454,4363,4091,1333,6394,727
2,250024,Àger,2001,523,285,238,38,288,197
3,250030,Agramunt,2001,4960,2546,2414,692,3202,1066
4,080023,Aguilar de Segarra,2001,208,104,104,22,112,74
5,170010,Agullana,2001,666,336,330,66,396,204
6,080142,Aiguafreda,2001,2131,1053,1078,269,1455,407
7,430017,Aiguamúrcia,2001,651,337,314,63,430,158
8,170025,Aiguaviva,2001,537,270,267,80,373,84
9,250387,Aitona,2001,2183,1099,1084,243,1410,530
10,250045,"Alamús, els",2001,696,348,348,82,451,163
11,250058,Alàs i Cerc,2001,391,209,182,42,243,106
12,250061,"Albagés, l'",2001,502,266,236,63,294,145
13,170031,Albanyà,2001,125,66,59,13,81,31
14,250077,Albatàrrec,2001,1189,601,588,161,794,234
15,250083,Albesa,2001,1512,746,766,177,960,375
16,250096,"Albi, l'",2001,789,409,380,80,503,206
17,430022,Albinyana,2001,1570,822,748,193,1101,276
18,430038,"Albiol, l'",2001,177,98,79,26,127,24
19,170046,Albons,2001,596,316,280,73,386,137
20,430043,Alcanar,2001,8175,4123,4052,1011,5459,1705
21,250100,Alcanó,2001,261,133,128,27,145,89
22,250117,Alcarràs,2001,4804,2410,2394,671,3220,913
23,250122,Alcoletge,2001,1846,972,874,243,1295,308
24,430056,Alcover,2001,3841,1950,1891,543,2623,675
25,439044,"Aldea, l'",2001,3539,1818,1721,465,2300,774
26,430069,Aldover,2001,782,379,403,63,490,229
27,430075,"Aleixar, l'",2001,725,373,352,95,458,172
28,080039,Alella,2001,8614,4295,4319,1308,6288,1018
29,430081,Alfara de Carles,2001,362,191,171,27,218,117
30,250138,Alfarràs,2001,2941,1436,1505,371,1917,653
31,250143,Alfés,2001,332,176,156,34,210,88
32,430094,Alforja,2001,1309,678,631,145,810,354
33,250156,Algerri,2001,508,249,259,35,304,169
34,250169,Alguaire,2001,2823,1429,1394,334,1865,624
35,250175,Alins,2001,273,138,135,22,154,97
36,430108,Alió,2001,372,187,185,39,226,107
37,250194,Almacelles,2001,5659,2890,2769,720,3800,1139
38,250208,Almatret,2001,473,246,227,36,259,178
39,250215,Almenar,2001,3480,1784,1696,417,2272,791
40,430115,Almoster,2001,851,438,413,148,581,122
41,250220,Alòs de Balaguer,2001,178,104,74,9,114,55
42,170062,Alp,2001,1231,651,580,161,920,150
43,080044,Alpens,2001,274,144,130,45,167,62
44,250236,Alpicat,2001,4237,2110,2127,735,2920,582
45,250241,Alt Àneu,2001,418,231,187,51,273,94
46,430120,Altafulla,2001,3329,1715,1614,521,2428,380
47,170078,Amer,2001,2205,1089,1116,266,1408,531
48,430136,"Ametlla de Mar, l'",2001,5047,2550,2497,640,3437,970
49,080057,"Ametlla del Vallès, l'",2001,5910,2910,3000,1034,4131,745
50,439060,"Ampolla, l'",2001,1893,942,951,213,1226,454
51,430141,Amposta,2001,16760,8290,8470,2288,11351,3121
52,170084,Anglès,2001,4973,2529,2444,635,3299,1039
53,250273,Anglesola,2001,1272,640,632,129,810,333
54,250292,Arbeca,2001,2427,1243,1184,288,1500,639
55,430167,"Arboç, l'",2001,3663,1895,1768,510,2531,622
56,430154,Arbolí,2001,133,71,62,5,94,34
57,170097,Arbúcies,2001,5208,2665,2543,774,3440,994
58,080060,Arenys de Mar,2001,12819,6184,6635,1852,8586,2381
59,080076,Arenys de Munt,2001,6512,3231,3281,1060,4474,978
60,170101,Argelaguer,2001,401,213,188,73,230,98
61,080082,Argençola,2001,188,101,87,21,124,43
62,430173,"Argentera, l'",2001,147,83,64,13,107,27
63,080095,Argentona,2001,9791,4856,4935,1547,6892,1352
64,170118,"Armentera, l'",2001,755,377,378,74,481,200
65,430189,Arnes,2001,506,260,246,44,274,188
66,250313,Arres,2001,58,31,27,6,36,16
67,250328,Arsèguel,2001,101,56,45,7,68,26
68,080109,Artés,2001,4443,2214,2229,640,2942,861
69,250334,Artesa de Lleida,2001,1324,683,641,168,847,309
70,250349,Artesa de Segre,2001,3225,1661,1564,384,2021,820
71,430192,Ascó,2001,1693,857,836,214,1092,387
72,250365,Aspa,2001,268,132,136,27,149,92
73,250371,"Avellanes i Santa Linya, les",2001,480,255,225,26,281,173
74,080116,Avià,2001,1892,959,933,232,1206,454
75,080121,Avinyó,2001,2019,997,1022,305,1274,440
76,170123,Avinyonet de Puigventós,2001,725,367,358,115,511,99
77,080137,Avinyonet del Penedès,2001,1254,667,587,145,828,281
78,080155,Badalona,2001,208994,103377,105617,28860,150269,29865
79,089045,Badia del Vallès,2001,15032,7552,7480,2102,11237,1693
80,080168,Bagà,2001,2091,1006,1085,274,1318,499
81,250390,Baix Pallars,2001,353,199,154,24,213,116
82,250404,Balaguer,2001,13455,6610,6845,1922,8834,2699
83,080174,Balenyà,2001,3171,1594,1577,495,2217,459
84,080180,Balsareny,2001,3246,1609,1637,411,2131,704
85,430206,Banyeres del Penedès,2001,1747,939,808,213,1309,225
86,170157,Banyoles,2001,15436,7583,7853,2593,9965,2878
87,250411,Barbens,2001,766,389,377,75,473,218
88,430213,Barberà de la Conca,2001,414,204,210,41,248,125
89,082520,Barberà del Vallès,2001,26741,13423,13318,4306,19785,2650
90,080193,Barcelona,2001,1505325,704105,801220,173468,1000223,331634
91,250426,"Baronia de Rialb, la",2001,272,140,132,35,162,75
92,170160,Bàscara,2001,832,435,397,84,571,177
93,250447,Bassella,2001,306,157,149,38,164,104
94,430228,Batea,2001,2000,1019,981,201,1234,565
95,250450,Bausen,2001,58,34,24,2,24,32
96,080207,Begues,2001,4553,2294,2259,955,3164,434
97,170139,Begur,2001,3545,1793,1752,535,2479,531
98,250463,Belianes,2001,576,273,303,70,323,183
99,251706,Bellaguarda,2001,351,171,180,39,187,125
100,170182,Bellcaire d'Empordà,2001,559,285,274,76,357,126
101,250479,Bellcaire d'Urgell,2001,1294,625,669,123,775,396
102,250485,Bell-lloc d'Urgell,2001,2125,1050,1075,267,1375,483
103,250498,Bellmunt d'Urgell,2001,231,112,119,30,136,65
104,430234,Bellmunt del Priorat,2001,308,151,157,22,172,114
105,080214,Bellprat,2001,94,54,40,11,60,23
106,250501,Bellpuig,2001,4110,2060,2050,549,2724,837
107,430249,Bellvei,2001,1389,741,648,206,953,230
108,250518,Bellver de Cerdanya,2001,1627,868,759,177,1098,352
109,250523,Bellvís,2001,2146,1067,1079,240,1268,638
110,250539,Benavent de Segrià,2001,943,489,454,141,650,152
111,430252,Benifallet,2001,883,441,442,99,495,289
112,430265,Benissanet,2001,1048,543,505,119,659,270
113,080229,Berga,2001,14509,7037,7472,1719,9382,3408
114,170195,Besalú,2001,1988,971,1017,213,1283,492
115,170209,Bescanó,2001,3259,1639,1620,489,2183,587
116,170216,Beuda,2001,140,76,64,19,97,24
117,080235,Bigues i Riells del Fai,2001,5703,2996,2707,949,4175,579
118,250557,Biosca,2001,247,124,123,30,142,75
119,170221,"Bisbal d'Empordà, la",2001,8318,4103,4215,1199,5521,1598
120,430271,"Bisbal de Falset, la",2001,252,123,129,30,150,72
121,430287,"Bisbal del Penedès, la",2001,2078,1106,972,285,1395,398
122,172348,Biure,2001,216,107,109,18,142,56
123,430290,Blancafort,2001,385,198,187,45,204,136
124,170237,Blanes,2001,31532,15868,15664,4829,22239,4464
125,170293,Boadella i les Escaules,2001,234,115,119,26,152,56
126,170242,Bolvir,2001,279,140,139,27,204,48
127,430304,Bonastre,2001,330,173,157,39,202,89
128,250576,"Bòrdes, Es",2001,209,110,99,20,156,33
129,170255,Bordils,2001,1398,704,694,218,924,256
130,250582,"Borges Blanques, les",2001,5284,2644,2640,661,3418,1205
131,430311,"Borges del Camp, les",2001,1593,802,791,197,1072,324
132,170268,Borrassà,2001,549,275,274,63,347,139
133,080240,Borredà,2001,482,244,238,60,308,114
134,250595,Bossòst,2001,924,475,449,144,614,166
135,430326,Bot,2001,808,411,397,62,476,270
136,430332,Botarell,2001,695,359,336,101,493,101
137,250560,Bovera,2001,393,198,195,24,224,145
138,430347,Bràfim,2001,567,280,287,41,370,156
139,170274,Breda,2001,3408,1743,1665,482,2306,620
140,080253,"Bruc, el",2001,1119,587,532,161,740,218
141,080266,"Brull, el",2001,195,105,90,19,139,37
142,170280,Brunyola i Sant Martí Sapresa,2001,376,190,186,26,218,132
143,430350,Cabacés,2001,344,182,162,28,209,107
144,250609,Cabanabona,2001,93,44,49,8,49,36
145,170314,Cabanelles,2001,217,127,90,17,138,62
146,170307,Cabanes,2001,769,399,370,81,523,165
147,080272,"Cabanyes, les",2001,569,298,271,80,388,101
148,250616,Cabó,2001,119,67,52,9,70,40
149,430363,Cabra del Camp,2001,638,331,307,82,413,143
150,080288,Cabrera d'Anoia,2001,609,333,276,80,438,91
151,080291,Cabrera de Mar,2001,3795,1930,1865,626,2730,439
152,080305,Cabrils,2001,4985,2441,2544,964,3562,459
153,170329,Cadaqués,2001,2390,1163,1227,342,1644,404
154,080312,Calaf,2001,3039,1524,1515,385,2043,611
155,430379,Calafell,2001,13327,6717,6610,1823,9540,1964
156,080348,Calders,2001,778,409,369,135,505,138
157,080327,Caldes d'Estrac,2001,2028,999,1029,270,1350,408
158,170335,Caldes de Malavella,2001,4173,2113,2060,562,2840,771
159,080333,Caldes de Montbui,2001,12789,6347,6442,1622,8972,2195
160,080351,Calella,2001,13814,6738,7076,1944,9449,2421
161,080370,Calldetenes,2001,2056,1062,994,331,1437,288
162,080386,Callús,2001,1327,652,675,154,848,325
163,080364,Calonge de Segarra,2001,199,102,97,24,110,65
164,170340,Calonge i Sant Antoni,2001,7190,3611,3579,1064,4933,1193
165,250621,Camarasa,2001,906,461,445,71,524,311
166,439039,Camarles,2001,2937,1468,1469,378,1908,651
167,430385,Cambrils,2001,20976,10475,10501,3365,15038,2573
168,170353,Camós,2001,626,322,304,70,421,135
169,170366,Campdevànol,2001,3433,1676,1757,375,2219,839
170,170372,Campelles,2001,127,67,60,5,88,34
171,080399,Campins,2001,293,154,139,50,198,45
172,170388,Campllong,2001,310,166,144,47,203,60
173,170391,Camprodon,2001,2289,1133,1156,209,1504,576
174,250637,Canejan,2001,107,52,55,9,67,31
175,170405,Canet d'Adri,2001,519,273,246,60,362,97
176,080403,Canet de Mar,2001,10585,5222,5363,1346,7301,1938
177,080410,Canovelles,2001,13118,6652,6466,1962,9473,1683
178,080425,Cànoves i Samalús,2001,1945,1014,931,287,1401,257
179,170412,Cantallops,2001,264,135,129,24,158,82
180,080431,Canyelles,2001,2008,1068,940,279,1483,246
181,430398,Capafonts,2001,122,62,60,4,88,30
182,430402,Capçanes,2001,409,188,221,39,258,112
183,080446,Capellades,2001,4950,2420,2530,674,3392,884
184,170427,Capmany,2001,460,236,224,57,284,119
185,080459,Capolat,2001,60,35,25,1,34,25
186,080462,Cardedeu,2001,12635,6288,6347,2173,8912,1550
187,080478,Cardona,2001,5515,2690,2825,605,3520,1390
188,080484,Carme,2001,684,350,334,68,445,171
189,430419,Caseres,2001,326,157,169,41,177,108
190,170448,Cassà de la Selva,2001,7874,3947,3927,1193,5122,1559
191,080497,Casserres,2001,1595,761,834,162,987,446
192,080575,Castell de l'Areny,2001,48,30,18,2,33,13
193,259046,Castell de Mur,2001,149,78,71,16,85,48
194,250642,Castellar de la Ribera,2001,152,70,82,17,88,47
195,080522,Castellar de n'Hug,2001,186,97,89,17,120,49
196,080500,Castellar del Riu,2001,120,69,51,20,83,17
197,080517,Castellar del Vallès,2001,18136,9092,9044,3089,12781,2266
198,080538,Castellbell i el Vilar,2001,2904,1465,1439,358,1938,608
199,080543,Castellbisbal,2001,8696,4461,4235,1661,6183,852
200,080556,Castellcir,2001,371,211,160,58,262,51
201,250674,Castelldans,2001,973,499,474,114,567,292
202,080569,Castelldefels,2001,46786,23396,23390,7419,34723,4644
203,080581,Castellet i la Gornal,2001,1462,740,722,181,989,292
204,170464,Castellfollit de la Roca,2001,982,498,484,107,608,267
205,080608,Castellfollit de Riubregós,2001,228,113,115,30,141,57
206,080594,Castellfollit del Boix,2001,384,186,198,64,222,98
207,080615,Castellgalí,2001,984,513,471,123,663,198
208,080620,Castellnou de Bages,2001,542,286,256,74,421,47
209,250680,Castellnou de Seana,2001,713,375,338,75,452,186
210,170470,Castelló d'Empúries,2001,6883,3540,3343,1090,4647,1146
211,250693,Castelló de Farfanya,2001,584,292,292,69,337,178
212,080636,Castellolí,2001,421,217,204,62,275,84
213,170486,Castell-Platja d'Aro,2001,7112,3588,3524,1030,5239,843
214,250707,Castellserà,2001,1113,545,568,120,687,306
215,080641,Castellterçol,2001,2018,988,1030,249,1309,460
216,430424,Castellvell del Camp,2001,1201,607,594,178,850,173
217,080654,Castellví de la Marca,2001,1434,730,704,185,932,317
218,080667,Castellví de Rosanes,2001,1158,597,561,185,830,143
219,430430,"Catllar, el",2001,2544,1327,1217,392,1833,319
220,250714,Cava,2001,59,34,25,6,35,18
221,171899,"Cellera de Ter, la",2001,2055,1035,1020,277,1365,413
222,170499,Celrà,2001,2762,1353,1409,469,1856,437
223,080673,Centelles,2001,5826,2877,2949,786,3880,1160
224,082687,Cercs,2001,1439,727,712,164,891,384
225,082665,Cerdanyola del Vallès,2001,53481,26787,26694,7815,40020,5646
226,080689,Cervelló,2001,6295,3175,3120,974,4623,698
227,250729,Cervera,2001,7707,3823,3884,1206,5046,1455
228,250735,Cervià de les Garrigues,2001,857,441,416,74,506,277
229,170502,Cervià de Ter,2001,601,303,298,62,361,178
230,170519,Cistella,2001,220,110,110,21,140,59
231,250740,Ciutadilla,2001,215,110,105,17,131,67
232,250753,Clariana de Cardener,2001,144,74,70,19,100,25
233,250766,"Cogul, el",2001,225,122,103,15,128,82
234,170545,Colera,2001,569,291,278,59,365,145
235,250772,Coll de Nargó,2001,601,319,282,65,361,175
236,080692,Collbató,2001,2286,1225,1061,357,1658,271
237,430458,Colldejou,2001,194,108,86,19,137,38
238,080706,Collsuspina,2001,250,134,116,27,187,36
239,170558,Colomers,2001,200,102,98,12,116,72
240,251636,"Coma i la Pedra, la",2001,246,148,98,21,167,58
241,251615,Conca de Dalt,2001,424,216,208,35,242,147
242,430461,Conesa,2001,116,63,53,11,69,36
243,430477,Constantí,2001,5007,2602,2405,729,3531,747
244,080713,Copons,2001,288,138,150,20,180,88
245,430483,Corbera d'Ebre,2001,1057,552,505,130,635,292
246,080728,Corbera de Llobregat,2001,9573,4904,4669,1692,6928,953
247,250788,Corbins,2001,1082,556,526,134,692,256
248,170577,Corçà,2001,1173,590,583,133,825,215
249,080734,Cornellà de Llobregat,2001,81145,39926,41219,10230,57753,13162
250,170561,Cornellà del Terri,2001,1882,939,943,251,1244,387
251,430496,Cornudella de Montsant,2001,860,437,423,83,521,256
252,430509,Creixell,2001,1785,885,900,229,1199,357
253,170583,Crespià,2001,224,105,119,24,127,73
254,179011,"Cruïlles, Monells i Sant Sadurní de l'Heura",2001,1110,556,554,144,759,207
255,080749,Cubelles,2001,7028,3580,3448,967,5007,1054
256,250791,Cubells,2001,373,187,186,42,202,129
257,430516,Cunit,2001,6360,3279,3081,846,4580,934
258,170600,Darnius,2001,522,278,244,43,330,149
259,170617,Das,2001,162,87,75,22,110,30
260,439018,Deltebre,2001,10381,5228,5153,1362,6964,2055
261,080752,Dosrius,2001,3050,1539,1511,489,2271,290
262,430537,Duesaigües,2001,200,119,81,11,126,63
263,170622,"Escala, l'",2001,6240,3140,3100,759,4382,1099
264,080765,Esparreguera,2001,17824,9032,8792,2912,12662,2250
265,170638,Espinelves,2001,185,94,91,17,109,59
266,250812,"Espluga Calba, l'",2001,419,222,197,35,258,126
267,430542,"Espluga de Francolí, l'",2001,3636,1798,1838,499,2266,871
268,080771,Esplugues de Llobregat,2001,45731,22488,23243,5660,33750,6321
269,170643,Espolla,2001,375,189,186,45,224,106
270,170656,Esponellà,2001,392,192,200,44,256,92
271,250827,Espot,2001,308,167,141,25,218,65
272,080787,"Espunyola, l'",2001,260,132,128,31,161,68
273,082541,"Esquirol, l'",2001,2126,1056,1070,287,1399,440
274,250886,Estamariu,2001,124,66,58,5,81,38
275,080790,"Estany, l'",2001,391,187,204,36,251,104
276,250851,Estaràs,2001,190,102,88,25,113,52
277,250864,Esterri d'Àneu,2001,658,321,337,68,419,171
278,250870,Esterri de Cardós,2001,77,40,37,7,47,23
279,430555,Falset,2001,2518,1280,1238,349,1611,558
280,170059,"Far d'Empordà, el",2001,387,200,187,49,260,78
281,250899,Farrera,2001,97,58,39,10,65,22
282,430568,"Fatarella, la",2001,1228,615,613,113,739,376
283,430574,"Febró, la",2001,65,42,23,5,46,14
284,081347,Figaró-Montmany,2001,877,470,407,119,581,177
285,080804,Fígols,2001,49,28,21,2,30,17
286,259084,Fígols i Alinyà,2001,289,158,131,16,153,120
287,430580,"Figuera, la",2001,120,61,59,14,71,35
288,170669,Figueres,2001,34493,16757,17736,5485,23026,5982
289,430593,Figuerola del Camp,2001,288,136,152,41,182,65
290,170675,Flaçà,2001,862,431,431,96,562,204
291,430607,Flix,2001,4122,2063,2059,512,2689,921
292,250925,"Floresta, la",2001,188,101,87,24,92,72
293,080826,Fogars de la Selva,2001,706,368,338,96,484,126
294,080811,Fogars de Montclús,2001,344,185,159,45,232,67
295,170681,Foixà,2001,317,156,161,39,192,86
296,080832,Folgueroles,2001,1640,819,821,261,1119,260
297,250931,Fondarella,2001,682,341,341,96,466,120
298,080847,Fonollosa,2001,1018,521,497,148,692,178
299,170694,Fontanals de Cerdanya,2001,406,197,209,47,283,76
300,170708,Fontanilles,2001,141,79,62,7,102,32
301,170715,Fontcoberta,2001,1126,550,576,174,787,165
302,080850,Font-rubí,2001,1249,650,599,170,757,322
303,250946,Foradada,2001,199,117,82,14,125,60
304,179026,Forallac,2001,1666,822,844,203,1152,311
305,430614,Forès,2001,66,33,33,0,43,23
306,170736,Fornells de la Selva,2001,1555,751,804,258,1079,218
307,170741,Fortià,2001,529,255,274,56,341,132
308,080863,"Franqueses del Vallès, les",2001,12941,6483,6458,2060,9361,1520
309,430629,Freginals,2001,380,192,188,39,227,114
310,250962,"Fuliola, la",2001,1251,635,616,148,770,333
311,250978,Fulleda,2001,116,62,54,12,68,36
312,080902,Gaià,2001,166,89,77,23,116,27
313,430635,"Galera, la",2001,729,357,372,71,416,242
314,080879,Gallifa,2001,162,87,75,31,111,20
315,430640,Gandesa,2001,2629,1319,1310,333,1673,623
316,430653,Garcia,2001,515,266,249,39,311,165
317,430666,"Garidells, els",2001,160,82,78,23,97,40
318,080885,"Garriga, la",2001,11953,5782,6171,1949,8146,1858
319,170754,Garrigàs,2001,332,181,151,37,202,93
320,170767,Garrigoles,2001,147,80,67,14,93,40
321,170773,Garriguella,2001,718,368,350,81,471,166
322,080898,Gavà,2001,39619,19751,19868,5856,28519,5244
323,250984,Gavet de la Conca,2001,322,158,164,27,172,123
324,080919,Gelida,2001,4457,2254,2203,614,3078,765
325,170789,Ger,2001,395,208,187,48,270,77
326,259123,Gimenells i el Pla de la Font,2001,1103,573,530,126,723,254
327,430672,Ginestar,2001,845,423,422,77,492,276
328,170792,Girona,2001,75256,36230,39026,12017,51718,11521
329,080924,Gironella,2001,4875,2358,2517,506,3068,1301
330,080930,Gisclareny,2001,25,13,12,1,18,6
331,430688,Godall,2001,725,369,356,65,414,246
332,250997,Golmés,2001,1369,678,691,169,912,288
333,170806,Gombrèn,2001,222,103,119,13,150,59
334,251001,Gósol,2001,228,124,104,20,150,58
335,080945,"Granada, la",2001,1359,665,694,200,900,259
336,251018,"Granadella, la",2001,806,419,387,79,453,274
337,080958,Granera,2001,61,40,21,0,44,17
338,251023,"Granja d'Escarp, la",2001,1109,586,523,127,734,248
339,080961,Granollers,2001,53681,26262,27419,8117,37936,7628
340,251039,Granyanella,2001,143,73,70,8,92,43
341,251057,Granyena de les Garrigues,2001,165,83,82,9,95,61
342,251044,Granyena de Segarra,2001,155,80,75,7,89,59
343,430691,Gratallops,2001,233,124,109,24,155,54
344,080977,Gualba,2001,799,411,388,94,573,132
345,170813,Gualta,2001,311,165,146,49,196,66
346,080996,Guardiola de Berguedà,2001,968,493,475,115,578,275
347,430705,"Guiamets, els",2001,301,152,149,36,175,90
348,170828,Guils de Cerdanya,2001,326,164,162,35,236,55
349,251095,Guimerà,2001,391,198,193,24,206,161
350,259031,"Guingueta d'Àneu, la",2001,324,172,152,39,199,86
351,251109,Guissona,2001,3455,1752,1703,603,2339,513
352,251116,Guixers,2001,155,96,59,10,100,45
353,081000,Gurb,2001,1937,989,948,319,1322,296
354,430712,Horta de Sant Joan,2001,1236,652,584,132,744,360
355,081017,"Hospitalet de Llobregat, l'",2001,242480,118476,124004,27296,172837,42347
356,081629,"Hostalets de Pierola, els",2001,1337,696,641,160,920,257
357,170834,Hostalric,2001,2915,1425,1490,394,2061,460
358,081022,Igualada,2001,32935,16014,16921,4517,22223,6195
359,251155,Isona i Conca Dellà,2001,1206,644,562,104,704,398
360,170849,Isòvol,2001,196,106,90,13,131,52
361,251137,Ivars d'Urgell,2001,1779,929,850,197,1103,479
362,251121,Ivars de Noguera,2001,339,174,165,32,218,89
363,251142,Ivorra,2001,152,73,79,13,90,49
364,170852,Jafre,2001,312,158,154,21,184,107
365,170865,"Jonquera, la",2001,2626,1332,1294,386,1882,358
366,081038,Jorba,2001,593,284,309,104,355,134
367,259101,Josa i Tuixén,2001,157,85,72,12,95,50
368,170871,Juià,2001,260,124,136,22,172,66
369,251180,Juncosa,2001,637,365,272,81,377,179
370,251193,Juneda,2001,2935,1484,1451,348,1865,722
371,251214,Les,2001,700,353,347,105,461,134
372,251229,Linyola,2001,2396,1191,1205,297,1558,541
373,081043,"Llacuna, la",2001,852,447,405,101,550,201
374,170887,Lladó,2001,521,264,257,61,316,144
375,251235,Lladorre,2001,230,118,112,20,151,59
376,251240,Lladurs,2001,238,124,114,32,152,54
377,081056,"Llagosta, la",2001,12124,6108,6016,1654,8991,1479
378,170890,Llagostera,2001,5910,3015,2895,855,3934,1121
379,170904,Llambilles,2001,435,222,213,39,299,97
380,170911,Llanars,2001,494,255,239,43,337,114
381,170926,Llançà,2001,4078,2029,2049,499,2683,896
382,251253,Llardecans,2001,620,318,302,63,369,188
383,251266,Llavorsí,2001,281,139,142,35,173,73
384,251207,Lleida,2001,113040,55045,57995,16310,77327,19403
385,170932,Llers,2001,1009,509,500,116,707,186
386,251272,Lles de Cerdanya,2001,277,156,121,29,178,70
387,081075,Lliçà d'Amunt,2001,10209,5279,4930,1707,7450,1052
388,081081,Lliçà de Vall,2001,5236,2681,2555,817,3892,527
389,251288,Llimiana,2001,142,77,65,10,87,45
390,081069,Llinars del Vallès,2001,7135,3600,3535,1154,5049,932
391,170947,Llívia,2001,1066,568,498,114,771,181
392,430727,"Lloar, el",2001,116,59,57,3,68,45
393,251291,Llobera,2001,235,123,112,21,144,70
394,430733,Llorac,2001,129,63,66,11,82,36
395,430748,Llorenç del Penedès,2001,1647,791,856,253,1079,315
396,170950,Lloret de Mar,2001,21589,10924,10665,3559,15587,2443
397,170963,"Llosses, les",2001,271,147,124,31,186,54
398,081094,Lluçà,2001,283,158,125,48,178,57
399,171024,Maçanet de Cabrenys,2001,672,344,328,48,413,211
400,171030,Maçanet de la Selva,2001,3973,2034,1939,584,2791,598
401,170979,Madremanya,2001,194,88,106,18,132,44
402,170985,Maià de Montcal,2001,324,164,160,40,212,72
403,251333,Maials,2001,978,489,489,90,560,328
404,251305,Maldà,2001,276,145,131,25,154,97
405,081108,Malgrat de Mar,2001,14246,7114,7132,1925,9904,2417
406,081115,Malla,2001,252,115,137,33,171,48
407,081120,Manlleu,2001,17872,9018,8854,2727,12053,3092
408,081136,Manresa,2001,63929,30850,33079,7574,42199,14156
409,430764,Marçà,2001,603,295,308,60,357,186
410,430751,Margalef,2001,129,66,63,8,74,47
411,082423,Marganell,2001,243,102,141,28,154,61
412,081141,Martorell,2001,22537,11429,11108,3421,16001,3115
413,081154,Martorelles,2001,4942,2476,2466,720,3516,706
414,430770,Mas de Barberans,2001,697,356,341,75,424,198
415,171002,Masarac,2001,240,118,122,25,137,78
416,430786,Masdenverge,2001,1004,520,484,132,639,233
417,081167,"Masies de Roda, les",2001,670,336,334,101,444,125
418,081173,"Masies de Voltregà, les",2001,2784,1347,1437,401,1942,441
419,430799,Masllorenç,2001,443,224,219,57,272,114
420,081189,"Masnou, el",2001,21121,10243,10878,3172,14962,2987
421,430803,"Masó, la",2001,277,135,142,24,190,63
422,430810,Maspujols,2001,482,253,229,65,296,121
423,081192,Masquefa,2001,5210,2671,2539,813,3737,660
424,430825,"Masroig, el",2001,515,252,263,41,291,183
425,251312,Massalcoreig,2001,624,303,321,71,361,192
426,171019,Massanes,2001,549,297,252,59,376,114
427,251327,Massoteres,2001,182,94,88,18,106,58
428,081206,Matadepera,2001,7197,3609,3588,1397,4990,810
429,081213,Mataró,2001,107191,52974,54217,15898,75252,16041
430,081228,Mediona,2001,1465,762,703,157,969,339
431,251348,Menàrguens,2001,815,416,399,86,497,232
432,170998,Meranges,2001,83,50,33,0,59,24
433,171058,Mieres,2001,333,173,160,49,198,86
434,430831,"Milà, el",2001,167,79,88,15,116,36
435,251351,Miralcamp,2001,1230,593,637,164,792,274
436,430846,Miravet,2001,782,416,366,85,482,215
437,081385,Moià,2001,4089,2016,2073,623,2705,761
438,430859,"Molar, el",2001,291,151,140,31,160,100
439,081234,Molins de Rei,2001,20198,9926,10272,2841,14231,3126
440,251370,Mollerussa,2001,9864,4887,4977,1572,6735,1557
441,171061,Mollet de Peralada,2001,187,101,86,13,110,64
442,081249,Mollet del Vallès,2001,46897,23472,23425,7325,34411,5161
443,171077,Molló,2001,335,172,163,23,213,99
444,251364,"Molsosa, la",2001,129,65,64,16,82,31
445,081287,Monistrol de Calders,2001,607,301,306,80,396,131
446,081271,Monistrol de Montserrat,2001,2559,1309,1250,294,1718,547
447,171096,Montagut i Oix,2001,784,403,381,93,469,222
448,430862,Montblanc,2001,6132,3045,3087,821,4093,1218
449,430884,Montbrió del Camp,2001,1519,772,747,199,957,363
450,081252,Montcada i Reixac,2001,28714,14159,14555,4243,20338,4133
451,081304,Montclar,2001,120,62,58,19,71,30
452,251399,Montellà i Martinet,2001,504,269,235,55,307,142
453,081311,Montesquiu,2001,834,413,421,87,528,219
454,251403,Montferrer i Castellbò,2001,753,412,341,73,521,159
455,430897,Montferri,2001,147,81,66,14,77,56
456,251386,Montgai,2001,790,402,388,82,456,252
457,081265,Montgat,2001,8423,4176,4247,1142,6097,1184
458,081326,Montmajor,2001,459,241,218,47,307,105
459,081332,Montmaneu,2001,190,100,90,14,124,52
460,430901,"Montmell, el",2001,386,213,173,34,269,83
461,081350,Montmeló,2001,8613,4316,4297,1276,6266,1071
462,251425,Montoliu de Lleida,2001,469,231,238,45,303,121
463,251410,Montoliu de Segarra,2001,193,109,84,16,103,74
464,251431,Montornès de Segarra,2001,106,49,57,6,58,42
465,081363,Montornès del Vallès,2001,12771,6476,6295,1941,9366,1464
466,430918,Mont-ral,2001,169,95,74,18,131,20
467,171100,Mont-ras,2001,1675,887,788,263,1197,215
468,430923,Mont-roig del Camp,2001,6965,3562,3403,918,4946,1101
469,081379,Montseny,2001,291,150,141,35,199,57
470,430939,Móra d'Ebre,2001,4788,2365,2423,698,3117,973
471,430944,Móra la Nova,2001,2715,1355,1360,377,1757,581
472,430957,"Morell, el",2001,2327,1176,1151,364,1607,356
473,430960,"Morera de Montsant, la",2001,170,95,75,18,111,41
474,081290,Muntanyola,2001,329,181,148,63,222,44
475,081398,Mura,2001,221,122,99,14,153,54
476,251459,Nalec,2001,102,48,54,6,57,39
477,250254,Naut Aran,2001,1498,785,713,230,1082,186
478,081402,Navarcles,2001,5363,2668,2695,712,3648,1003
479,081419,Navàs,2001,5580,2777,2803,706,3652,1222
480,171117,Navata,2001,720,358,362,115,450,155
481,251462,Navès,2001,267,132,135,29,160,78
482,081424,"Nou de Berguedà, la",2001,160,85,75,24,97,39
483,430976,"Nou de Gaià, la",2001,391,198,193,40,261,90
484,430982,Nulles,2001,358,167,191,29,219,110
485,251484,Odèn,2001,280,157,123,29,165,86
486,081430,Òdena,2001,2697,1341,1356,389,1844,464
487,171122,Ogassa,2001,242,142,100,26,167,49
488,081458,Olèrdola,2001,2326,1197,1129,347,1603,376
489,081461,Olesa de Bonesvalls,2001,1015,549,466,120,739,156
490,081477,Olesa de Montserrat,2001,17768,8988,8780,2708,12390,2670
491,251497,Oliana,2001,1856,938,918,195,1193,468
492,251500,Oliola,2001,217,117,100,20,146,51
493,251517,Olius,2001,564,284,280,100,372,92
494,081483,Olivella,2001,1443,768,675,206,1100,137
495,081496,Olost,2001,1177,581,596,149,713,315
496,171143,Olot,2001,28339,13757,14582,3773,18103,6463
497,251522,"Oluges, les",2001,189,96,93,11,120,58
498,081445,Olvan,2001,891,432,459,75,563,253
499,251538,"Omellons, els",2001,258,134,124,21,158,79
500,251543,"Omells de na Gaia, els",2001,148,80,68,16,86,46
501,171156,Ordis,2001,277,146,131,24,193,60
502,251556,Organyà,2001,989,505,484,96,613,280
503,081509,Orís,2001,230,114,116,29,146,55
504,081516,Oristà,2001,639,311,328,72,397,170
505,081521,Orpí,2001,146,80,66,17,97,32
506,081537,Òrrius,2001,397,208,189,45,285,67
507,251569,Os de Balaguer,2001,771,402,369,87,452,232
508,171169,Osor,2001,461,248,213,40,299,122
509,251575,Ossó de Sió,2001,229,118,111,21,145,63
510,081542,Pacs del Penedès,2001,694,347,347,97,506,91
511,081555,Palafolls,2001,5638,2843,2795,986,4042,610
512,171175,Palafrugell,2001,18588,9414,9174,2766,12644,3178
513,171181,Palamós,2001,15203,7534,7669,2306,10365,2532
514,251581,"Palau d'Anglesola, el",2001,1704,849,855,259,1083,362
515,171194,Palau de Santa Eulàlia,2001,89,53,36,7,66,16
516,171215,Palau-sator,2001,299,155,144,21,201,77
517,171208,Palau-saverdera,2001,945,474,471,94,614,237
518,081568,Palau-solità i Plegamans,2001,11419,5827,5592,1982,8343,1094
519,431009,"Pallaresos, els",2001,2664,1383,1281,528,1968,168
520,081574,Pallejà,2001,7751,3915,3836,1055,5749,947
521,430995,"Palma d'Ebre, la",2001,420,199,221,43,237,140
522,089058,"Palma de Cervelló, la",2001,2679,1361,1318,476,1899,304
523,171236,Palol de Revardit,2001,389,204,185,52,254,83
524,171241,Pals,2001,1976,1008,968,199,1320,457
525,081580,"Papiol, el",2001,3435,1708,1727,523,2389,523
526,171254,Pardines,2001,143,73,70,14,90,39
527,081593,Parets del Vallès,2001,14917,7591,7326,2462,10785,1670
528,171267,Parlavà,2001,337,171,166,39,220,78
529,431016,Passanant i Belltall,2001,189,110,79,8,102,79
530,171289,Pau,2001,440,219,221,54,295,91
531,431021,Paüls,2001,631,319,312,63,399,169
532,171292,Pedret i Marzà,2001,131,68,63,19,77,35
533,251641,Penelles,2001,523,282,241,52,314,157
534,171306,"Pera, la",2001,376,192,184,44,234,98
535,081607,Perafita,2001,362,178,184,45,224,93
536,431037,Perafort,2001,658,331,327,86,466,106
537,171328,Peralada,2001,1335,681,654,159,875,301
538,251654,Peramola,2001,381,204,177,39,224,118
539,431042,"Perelló, el",2001,2154,1119,1035,218,1357,579
540,081614,Piera,2001,9180,4714,4466,1428,6200,1552
541,431055,"Piles, les",2001,185,100,85,29,120,36
542,081635,Pineda de Mar,2001,20871,10486,10385,3256,14723,2892
543,431068,"Pinell de Brai, el",2001,1072,544,528,111,673,288
544,251667,Pinell de Solsonès,2001,215,115,100,17,143,55
545,251673,Pinós,2001,312,163,149,30,188,94
546,431074,Pira,2001,396,194,202,49,254,93
547,431080,"Pla de Santa Maria, el",2001,1685,875,810,270,1084,331
548,081640,"Pla del Penedès, el",2001,895,446,449,92,586,217
549,171334,"Planes d'Hostoles, les",2001,1768,879,889,191,1100,477
550,171349,Planoles,2001,284,153,131,17,182,85
551,259118,"Plans de Sió, els",2001,578,303,275,50,335,193
552,251689,"Poal, el",2001,634,339,295,88,356,190
553,251692,"Pobla de Cérvoles, la",2001,218,121,97,25,127,66
554,081653,"Pobla de Claramunt, la",2001,1712,880,832,221,1151,340
555,081666,"Pobla de Lillet, la",2001,1393,683,710,97,844,452
556,431093,"Pobla de Mafumet, la",2001,1147,571,576,203,768,176
557,431107,"Pobla de Massaluca, la",2001,439,228,211,26,248,165
558,431114,"Pobla de Montornès, la",2001,1495,826,669,151,1075,269
559,251713,"Pobla de Segur, la",2001,2832,1364,1468,272,1701,859
560,431129,Poboleda,2001,339,172,167,21,206,112
561,081672,Polinyà,2001,4767,2464,2303,860,3516,391
562,431135,"Pont d'Armentera, el",2001,565,293,272,48,345,172
563,250306,"Pont de Bar, el",2001,163,91,72,16,92,55
564,171352,Pont de Molins,2001,456,242,214,56,309,91
565,251734,"Pont de Suert, el",2001,2150,1083,1067,239,1393,518
566,081825,"Pont de Vilomara i Rocafort, el",2001,2656,1364,1292,388,1859,409
567,431418,Pontils,2001,147,73,74,12,101,34
568,081688,Pontons,2001,379,200,179,41,251,87
569,171365,Pontós,2001,227,128,99,19,155,53
570,251728,Ponts,2001,2429,1221,1208,323,1560,546
571,171371,Porqueres,2001,3727,1827,1900,606,2564,557
572,431140,Porrera,2001,467,253,214,60,284,123
573,171404,"Port de la Selva, el",2001,872,437,435,89,599,184
574,171387,Portbou,2001,1479,744,735,120,898,461
575,251749,"Portella, la",2001,577,311,266,56,378,143
576,431153,Pradell de la Teixeta,2001,191,96,95,11,124,56
577,431166,Prades,2001,565,285,280,59,343,163
578,431172,Prat de Comte,2001,177,87,90,13,97,67
579,081691,"Prat de Llobregat, el",2001,63139,31619,31520,9080,46291,7768
580,431188,Pratdip,2001,579,292,287,65,346,168
581,081712,Prats de Lluçanès,2001,2729,1342,1387,407,1729,593
582,081705,"Prats de Rei, els",2001,545,272,273,50,351,144
583,251752,Prats i Sansor,2001,214,121,93,33,152,29
584,251765,Preixana,2001,434,210,224,33,240,161
585,251771,Preixens,2001,537,253,284,51,312,174
586,082303,Premià de Dalt,2001,9146,4571,4575,1471,6673,1002
587,081727,Premià de Mar,2001,26555,13244,13311,3966,19106,3483
588,171390,"Preses, les",2001,1419,692,727,189,955,275
589,251790,Prullans,2001,217,109,108,24,136,57
590,171411,Puigcerdà,2001,7263,3731,3532,1070,5036,1157
591,081748,Puigdàlber,2001,350,160,190,55,234,61
592,251804,Puiggròs,2001,265,139,126,23,164,78
593,431191,Puigpelat,2001,580,293,287,81,393,106
594,081751,Puig-reig,2001,4275,2059,2216,462,2635,1178
595,251811,Puigverd d'Agramunt,2001,245,135,110,24,152,69
596,251826,Puigverd de Lleida,2001,1075,531,544,131,679,265
597,081764,Pujalt,2001,177,90,87,19,111,47
598,081770,"Quar, la",2001,76,42,34,11,53,12
599,171426,Quart,2001,2467,1262,1205,397,1793,277
600,170433,Queralbs,2001,200,114,86,24,117,59
601,431205,Querol,2001,298,170,128,35,208,55
602,171432,Rabós,2001,144,70,74,9,96,39
603,081786,Rajadell,2001,430,219,211,37,311,82
604,431212,Rasquera,2001,775,393,382,72,449,254
605,171447,Regencós,2001,291,169,122,36,182,73
606,081799,Rellinars,2001,410,217,193,64,272,74
607,431227,Renau,2001,66,31,35,11,40,15
608,431233,Reus,2001,90056,44036,46020,13891,61985,14180
609,251832,Rialp,2001,519,274,245,60,352,107
610,431248,"Riba, la",2001,704,366,338,71,462,171
611,431251,Riba-roja d'Ebre,2001,1329,687,642,135,810,384
612,259059,Ribera d'Ondara,2001,497,256,241,57,291,149
613,251850,Ribera d'Urgellet,2001,820,432,388,81,508,231
614,171450,Ribes de Freser,2001,2104,1023,1081,208,1300,596
615,171463,Riells i Viabrea,2001,2160,1131,1029,354,1569,237
616,431264,"Riera de Gaià, la",2001,1005,508,497,123,658,224
617,251863,Riner,2001,280,147,133,30,180,70
618,171479,Ripoll,2001,10744,5213,5531,1263,7031,2450
619,081803,Ripollet,2001,30548,15286,15262,4657,22281,3610
620,259139,Riu de Cerdanya,2001,81,40,41,9,56,16
621,171485,Riudarenes,2001,1342,699,643,175,888,279
622,171498,Riudaura,2001,413,205,208,42,290,81
623,431270,Riudecanyes,2001,720,368,352,79,459,182
624,431286,Riudecols,2001,993,517,476,142,645,206
625,171501,Riudellots de la Selva,2001,1557,798,759,229,1057,271
626,431299,Riudoms,2001,5297,2687,2610,776,3588,933
627,171518,Riumors,2001,184,92,92,19,105,60
628,081810,"Roca del Vallès, la",2001,7588,3816,3772,1130,5589,869
629,431303,Rocafort de Queralt,2001,276,144,132,22,152,102
630,431310,Roda de Berà,2001,3598,1958,1640,456,2684,458
631,081831,Roda de Ter,2001,5198,2523,2675,783,3414,1001
632,431325,Rodonyà,2001,415,216,199,56,243,116
633,431331,Roquetes,2001,6437,3250,3187,900,4274,1263
634,171523,Roses,2001,13594,6899,6695,2266,9449,1879
635,251898,Rosselló,2001,1891,929,962,293,1246,352
636,431346,"Rourell, el",2001,261,139,122,24,151,86
637,081846,Rubí,2001,60303,30247,30056,9437,43707,7159
638,081859,Rubió,2001,120,69,51,23,67,30
639,171539,Rupià,2001,192,102,90,15,128,49
640,089019,Rupit i Pruit,2001,341,171,170,36,232,73
641,081878,Sabadell,2001,185170,89920,95250,26251,127522,31397
642,081884,Sagàs,2001,156,78,78,21,96,39
643,251902,Salàs de Pallars,2001,330,163,167,23,176,131
644,081901,Saldes,2001,311,172,139,38,212,61
645,171544,Sales de Llierca,2001,91,51,40,16,63,12
646,081918,Sallent,2001,7153,3449,3704,825,4570,1758
647,431359,Salomó,2001,382,193,189,32,226,124
648,439057,Salou,2001,13952,7121,6831,2146,10396,1410
649,171557,Salt,2001,22472,11301,11171,3551,15557,3364
650,251919,Sanaüja,2001,465,228,237,52,270,143
651,081944,Sant Adrià de Besòs,2001,32439,16007,16432,4971,22568,4900
652,081957,Sant Agustí de Lluçanès,2001,117,63,54,17,82,18
653,081960,Sant Andreu de la Barca,2001,21301,10875,10426,3355,16126,1820
654,081976,Sant Andreu de Llavaneres,2001,7466,3737,3729,1259,5318,889
655,171576,Sant Andreu Salou,2001,140,64,76,26,84,30
656,171833,Sant Aniol de Finestres,2001,275,147,128,23,189,63
657,081982,Sant Antoni de Vilamajor,2001,3726,1871,1855,596,2614,516
658,081995,Sant Bartomeu del Grau,2001,1155,620,535,234,772,149
659,082009,Sant Boi de Llobregat,2001,79463,39535,39928,11404,57813,10246
660,082016,Sant Boi de Lluçanès,2001,550,274,276,46,368,136
661,431362,Sant Carles de la Ràpita,2001,11485,5731,5754,1584,7661,2240
662,082037,Sant Cebrià de Vallalta,2001,1904,1024,880,300,1401,203
663,082021,Sant Celoni,2001,12839,6389,6450,1916,8686,2237
664,082042,Sant Climent de Llobregat,2001,3042,1534,1508,484,2219,339
665,171582,Sant Climent Sescebes,2001,424,210,214,47,251,126
666,082055,Sant Cugat del Vallès,2001,55825,27529,28296,9902,39962,5961
667,082068,Sant Cugat Sesgarrigues,2001,736,381,355,94,488,154
668,251961,Sant Esteve de la Sarga,2001,112,67,45,4,75,33
669,082074,Sant Esteve de Palautordera,2001,1510,754,756,282,1024,204
670,082080,Sant Esteve Sesrovires,2001,5314,2767,2547,847,3884,583
671,171595,Sant Feliu de Buixalleu,2001,727,390,337,101,466,160
672,082107,Sant Feliu de Codines,2001,4461,2237,2224,646,3008,807
673,171609,Sant Feliu de Guíxols,2001,18677,9175,9502,2863,12531,3283
674,082114,Sant Feliu de Llobregat,2001,39603,19593,20010,5355,29509,4739
675,171616,Sant Feliu de Pallerols,2001,1128,551,577,128,694,306
676,082129,Sant Feliu Sasserra,2001,653,321,332,81,419,153
677,171621,Sant Ferriol,2001,202,113,89,32,124,46
678,082093,Sant Fost de Campsentelles,2001,6479,3278,3201,927,4767,785
679,082135,Sant Fruitós de Bages,2001,5719,2859,2860,840,4066,813
680,171637,Sant Gregori,2001,2406,1242,1164,375,1654,377
681,251924,Sant Guim de Freixenet,2001,1018,494,524,108,642,268
682,251977,Sant Guim de la Plana,2001,188,100,88,17,117,54
683,171642,Sant Hilari Sacalm,2001,5081,2607,2474,708,3429,944
684,082153,Sant Hipòlit de Voltregà,2001,3049,1515,1534,417,1934,698
685,081939,Sant Iscle de Vallalta,2001,894,470,424,132,628,134
686,439023,Sant Jaume d'Enveja,2001,3304,1684,1620,404,2214,686
687,082166,Sant Jaume de Frontanyà,2001,26,14,12,0,23,3
688,171655,Sant Jaume de Llierca,2001,764,380,384,108,433,223
689,431378,Sant Jaume dels Domenys,2001,1480,780,700,185,991,304
690,171674,Sant Joan de les Abadesses,2001,3630,1784,1846,369,2357,904
691,171680,Sant Joan de Mollet,2001,354,171,183,58,222,74
692,082188,Sant Joan de Vilatorrada,2001,9376,4681,4695,1334,6641,1401
693,082172,Sant Joan Despí,2001,28246,13924,14322,4391,20648,3207
694,171851,Sant Joan les Fonts,2001,2749,1373,1376,278,1846,625
695,171668,Sant Jordi Desvalls,2001,608,312,296,65,389,154
696,089030,Sant Julià de Cerdanyola,2001,228,121,107,19,149,60
697,171693,Sant Julià de Ramis,2001,2073,1034,1039,298,1453,322
698,082205,Sant Julià de Vilatorta,2001,2339,1152,1187,378,1613,348
699,179032,Sant Julià del Llor i Bonmatí,2001,940,474,466,125,605,210
700,082212,Sant Just Desvern,2001,14182,6824,7358,2192,9960,2030
701,082227,Sant Llorenç d'Hortons,2001,1638,831,807,238,1085,315
702,171714,Sant Llorenç de la Muga,2001,188,87,101,16,107,65
703,251930,Sant Llorenç de Morunys,2001,903,464,439,88,579,236
704,082233,Sant Llorenç Savall,2001,2053,1029,1024,276,1262,515
705,082251,Sant Martí d'Albars,2001,131,66,65,14,82,35
706,082248,Sant Martí de Centelles,2001,750,389,361,120,498,132
707,171729,Sant Martí de Llémena,2001,474,253,221,82,300,92
708,259025,Sant Martí de Riucorb,2001,686,356,330,52,417,217
709,082264,Sant Martí de Tous,2001,1000,504,496,147,631,222
710,082270,Sant Martí Sarroca,2001,2512,1253,1259,322,1632,558
711,082286,Sant Martí Sesgueioles,2001,347,172,175,37,220,90
712,171735,Sant Martí Vell,2001,160,81,79,26,97,37
713,082299,Sant Mateu de Bages,2001,643,313,330,60,386,197
714,171740,Sant Miquel de Campmajor,2001,197,108,89,24,133,40
715,171753,Sant Miquel de Fluvià,2001,631,321,310,98,415,118
716,171766,Sant Mori,2001,152,71,81,16,99,37
717,171772,Sant Pau de Segúries,2001,657,331,326,74,412,171
718,082310,Sant Pere de Ribes,2001,22902,11598,11304,3866,16579,2457
719,082325,Sant Pere de Riudebitlles,2001,2110,1040,1070,253,1440,417
720,082331,Sant Pere de Torelló,2001,2213,1093,1120,259,1505,449
721,082346,Sant Pere de Vilamajor,2001,2720,1426,1294,444,1943,333
722,171788,Sant Pere Pescador,2001,1524,855,669,186,1046,292
723,081897,Sant Pere Sallavinera,2001,153,78,75,12,89,52
724,082359,Sant Pol de Mar,2001,3821,1964,1857,514,2768,539
725,082362,Sant Quintí de Mediona,2001,1795,896,899,224,1191,380
726,082378,Sant Quirze de Besora,2001,1963,963,1000,216,1235,512
727,082384,Sant Quirze del Vallès,2001,13259,6635,6624,2460,9569,1230
728,082397,Sant Quirze Safaja,2001,402,220,182,47,306,49
729,251945,Sant Ramon,2001,570,289,281,54,352,164
730,082401,Sant Sadurní d'Anoia,2001,9805,4869,4936,1482,6651,1672
731,082418,Sant Sadurní d'Osormort,2001,79,43,36,8,54,17
732,080983,Sant Salvador de Guardiola,2001,2096,1082,1014,300,1495,301
733,082628,Sant Vicenç de Castellet,2001,7190,3450,3740,814,4800,1576
734,082649,Sant Vicenç de Montalt,2001,3709,1883,1826,653,2678,378
735,082652,Sant Vicenç de Torelló,2001,1814,870,944,262,1117,435
736,082634,Sant Vicenç dels Horts,2001,24885,12539,12346,4052,17894,2939
737,431384,Santa Bàrbara,2001,3332,1665,1667,414,2097,821
738,082439,Santa Cecília de Voltregà,2001,201,112,89,30,131,40
739,082444,Santa Coloma de Cervelló,2001,5054,2534,2520,875,3583,596
740,171805,Santa Coloma de Farners,2001,9127,4659,4468,1350,6195,1582
741,082457,Santa Coloma de Gramenet,2001,116064,57854,58210,13972,85433,16659
742,431397,Santa Coloma de Queralt,2001,2709,1322,1387,372,1725,612
743,171812,Santa Cristina d'Aro,2001,3049,1594,1455,505,2082,462
744,082460,Santa Eugènia de Berga,2001,1979,1003,976,312,1372,295
745,082476,Santa Eulàlia de Riuprimer,2001,866,451,415,124,564,178
746,082482,Santa Eulàlia de Ronçana,2001,4750,2407,2343,646,3411,693
747,082495,Santa Fe del Penedès,2001,302,148,154,54,199,49
748,171827,Santa Llogaia d'Àlguema,2001,286,148,138,38,201,47
749,082508,Santa Margarida de Montbui,2001,9071,4545,4526,1345,6553,1173
750,082515,Santa Margarida i els Monjos,2001,4834,2473,2361,760,3436,638
751,082589,Santa Maria d'Oló,2001,999,510,489,90,674,235
752,082536,Santa Maria de Besora,2001,189,95,94,26,111,52
753,082567,Santa Maria de Martorelles,2001,678,335,343,105,465,108
754,082554,Santa Maria de Merlès,2001,163,88,75,19,105,39
755,082573,Santa Maria de Miralles,2001,96,49,47,8,62,26
756,082592,Santa Maria de Palautordera,2001,6561,3336,3225,1008,4569,984
757,431401,Santa Oliva,2001,2175,1104,1071,340,1470,365
758,171848,Santa Pau,2001,1469,750,719,162,1004,303
759,082606,Santa Perpètua de Mogoda,2001,19235,9717,9518,2595,14617,2023
760,082613,Santa Susanna,2001,1996,1037,959,330,1406,260
761,081923,Santpedor,2001,5446,2672,2774,811,3775,860
762,431423,Sarral,2001,1459,762,697,173,946,340
763,171864,Sarrià de Ter,2001,3610,1788,1822,460,2477,673
764,252017,Sarroca de Bellera,2001,160,88,72,12,92,56
765,252000,Sarroca de Lleida,2001,462,232,230,51,278,133
766,171870,"Saus, Camallera i Llampaies",2001,681,334,347,78,453,150
767,431439,Savallà del Comtat,2001,73,38,35,7,40,26
768,431444,"Secuita, la",2001,1145,580,565,174,778,193
769,171886,"Selva de Mar, la",2001,196,101,95,26,118,52
770,431457,"Selva del Camp, la",2001,4256,2132,2124,776,2741,739
771,431460,Senan,2001,31,20,11,7,17,7
772,430445,"Sénia, la",2001,5322,2770,2552,740,3568,1014
773,252022,Senterada,2001,103,53,50,7,65,31
774,250352,"Sentiu de Sió, la",2001,465,228,237,42,293,130
775,082671,Sentmenat,2001,5820,2900,2920,881,4127,812
776,171903,Serinyà,2001,850,446,404,106,570,174
777,252043,Seròs,2001,1730,917,813,184,1076,470
778,171910,Serra de Daró,2001,176,90,86,19,98,59
779,171925,Setcases,2001,164,85,79,17,110,37
780,252038,"Seu d'Urgell, la",2001,11101,5428,5673,1571,7409,2121
781,082690,Seva,2001,2552,1305,1247,385,1763,404
782,252056,Sidamon,2001,583,291,292,66,406,111
783,171931,Sils,2001,3178,1595,1583,496,2160,522
784,082704,Sitges,2001,20345,6432,13913,2854,14417,3074
785,170524,Siurana,2001,158,82,76,22,87,49
786,082711,Sobremunt,2001,93,41,52,21,61,11
787,252069,"Soleràs, el",2001,434,232,202,29,265,140
788,431476,Solivella,2001,617,303,314,61,349,207
789,252075,Solsona,2001,7518,3761,3757,1073,5042,1403
790,082726,Sora,2001,187,101,86,22,121,44
791,252081,Soriguera,2001,314,156,158,37,187,90
792,252094,Sort,2001,1829,916,913,231,1189,409
793,252108,Soses,2001,1531,800,731,174,1027,330
794,082732,Subirats,2001,2557,1281,1276,360,1589,608
795,252115,Sudanell,2001,709,386,323,59,468,182
796,252120,Sunyer,2001,295,147,148,29,189,77
797,082747,Súria,2001,6139,3022,3117,832,3902,1405
798,171946,Susqueda,2001,89,50,39,8,63,18
799,082763,Tagamanent,2001,215,116,99,32,146,37
800,082779,Talamanca,2001,102,58,44,9,76,17
801,252154,Talarn,2001,353,174,179,42,228,83
802,252167,Talavera,2001,293,149,144,18,187,88
803,171959,"Tallada d'Empordà, la",2001,334,173,161,26,214,94
804,082785,Taradell,2001,5168,2578,2590,806,3528,834
805,431482,Tarragona,2001,115153,56259,58894,16680,80310,18163
806,252173,Tàrrega,2001,12735,6256,6479,1896,8477,2362
807,252189,Tarrés,2001,105,56,49,10,62,33
808,252192,Tarroja de Segarra,2001,179,90,89,17,94,68
809,082750,Tavèrnoles,2001,267,132,135,39,190,38
810,082802,Tavertet,2001,136,74,62,14,88,34
811,082819,Teià,2001,5406,2719,2687,930,3889,587
812,252206,Térmens,2001,1400,708,692,154,912,334
813,171962,Terrades,2001,190,90,100,13,109,68
814,082798,Terrassa,2001,174756,85770,88986,25950,120756,28050
815,082824,Tiana,2001,5972,2939,3033,987,4283,702
816,252213,Tírvia,2001,125,68,57,15,80,30
817,252228,Tiurana,2001,32,20,12,4,18,10
818,431495,Tivenys,2001,922,461,461,81,574,267
819,431508,Tivissa,2001,1775,881,894,206,1085,484
820,082830,Tona,2001,5967,2968,2999,838,4150,979
821,252234,Torà,2001,1189,596,593,145,757,287
822,082845,Tordera,2001,10105,5132,4973,1403,7019,1683
823,082858,Torelló,2001,12268,6000,6268,1697,8371,2200
824,252249,"Torms, els",2001,199,110,89,20,112,67
825,252252,Tornabous,2001,813,407,406,83,477,253
826,252271,"Torre de Cabdella, la",2001,670,339,331,36,401,233
827,082861,"Torre de Claramunt, la",2001,2510,1298,1212,408,1833,269
828,431515,"Torre de Fontaubella, la",2001,129,62,67,7,84,38
829,431520,"Torre de l'Espanyol, la",2001,687,358,329,61,425,201
830,252265,Torrebesses,2001,317,155,162,35,167,115
831,431536,Torredembarra,2001,11090,5511,5579,1728,7725,1637
832,252287,Torrefarrera,2001,1860,954,906,208,1288,364
833,259078,Torrefeta i Florejacs,2001,649,331,318,64,380,205
834,252304,Torregrossa,2001,2217,1102,1115,254,1332,631
835,252311,Torrelameu,2001,586,321,265,49,382,155
836,082877,Torrelavit,2001,1125,576,549,120,739,266
837,082883,Torrelles de Foix,2001,1711,913,798,241,1120,350
838,082896,Torrelles de Llobregat,2001,3722,1905,1817,695,2668,359
839,171978,Torrent,2001,176,86,90,22,122,32
840,252326,Torres de Segre,2001,1838,950,888,219,1212,407
841,252332,Torre-serona,2001,336,170,166,32,231,73
842,171984,Torroella de Fluvià,2001,342,190,152,33,211,98
843,171997,Torroella de Montgrí,2001,8725,4422,4303,1390,5922,1413
844,431541,Torroja del Priorat,2001,140,84,56,9,87,44
845,172001,Tortellà,2001,710,361,349,84,430,196
846,431554,Tortosa,2001,29821,14559,15262,3938,19570,6313
847,172018,Toses,2001,148,89,59,25,82,41
848,172023,Tossa de Mar,2001,4317,2168,2149,563,3102,652
849,252347,Tremp,2001,5388,2657,2731,687,3222,1479
850,172044,Ullà,2001,829,437,392,125,564,140
851,082900,Ullastrell,2001,1159,594,565,176,806,177
852,172057,Ullastret,2001,239,123,116,23,166,50
853,431567,Ulldecona,2001,5671,2885,2786,731,3690,1250
854,431573,Ulldemolins,2001,491,257,234,36,285,170
855,172039,Ultramort,2001,197,112,85,18,116,63
856,172060,Urús,2001,189,99,90,25,126,38
857,082917,Vacarisses,2001,2926,1554,1372,430,2104,392
858,170144,"Vajol, la",2001,122,66,56,15,84,23
859,172076,"Vall d'en Bas, la",2001,2538,1288,1250,304,1573,661
860,172082,"Vall de Bianya, la",2001,1123,560,563,151,734,238
861,250432,"Vall de Boí, la",2001,878,480,398,102,613,163
862,259010,Vall de Cardós,2001,334,172,162,41,204,89
863,082922,Vallbona d'Anoia,2001,1076,551,525,144,723,209
864,252385,Vallbona de les Monges,2001,257,128,129,15,147,95
865,082938,Vallcebre,2001,269,142,127,24,175,70
866,431589,Vallclara,2001,111,59,52,11,63,37
867,252402,Vallfogona de Balaguer,2001,1512,763,749,183,1004,325
868,171707,Vallfogona de Ripollès,2001,210,109,101,19,141,50
869,431592,Vallfogona de Riucorb,2001,146,78,68,3,67,76
870,082943,Vallgorguina,2001,1413,744,669,210,1019,184
871,082956,Vallirana,2001,9385,4787,4598,1467,6715,1203
872,172095,Vall-llobrega,2001,400,151,249,53,305,42
873,431606,Vallmoll,2001,1254,658,596,170,897,187
874,082969,Vallromanes,2001,1482,768,714,279,1050,153
875,431613,Valls,2001,20568,10126,10442,3049,13817,3702
876,259062,"Valls d'Aguilar, les",2001,315,171,144,33,185,97
877,252398,"Valls de Valira, les",2001,775,424,351,78,499,198
878,431628,Vandellòs i l'Hospitalet de l'Infant,2001,4487,2258,2229,650,3136,701
879,259097,"Vansa i Fórnols, la",2001,166,86,80,14,107,45
880,082975,Veciana,2001,153,82,71,16,96,41
881,431634,"Vendrell, el",2001,23774,11953,11821,3907,16759,3108
882,172109,Ventalló,2001,637,338,299,66,408,163
883,252424,Verdú,2001,1067,505,562,96,622,349
884,172116,Verges,2001,1135,573,562,141,697,297
885,431649,Vespella de Gaià,2001,204,114,90,16,149,39
886,082981,Vic,2001,32706,16070,16636,4741,21979,5986
887,172121,Vidrà,2001,160,80,80,23,103,34
888,172137,Vidreres,2001,5026,2572,2454,765,3474,787
889,252430,Vielha e Mijaran,2001,4233,2154,2079,711,3085,437
890,431652,Vilabella,2001,779,393,386,102,500,177
891,172142,Vilabertran,2001,791,401,390,92,524,175
892,172155,Vilablareix,2001,1982,991,991,321,1478,183
893,082994,Vilada,2001,537,273,264,47,327,163
894,172174,Viladamat,2001,405,211,194,38,252,115
895,172168,Viladasens,2001,181,94,87,23,99,59
896,083015,Viladecans,2001,57132,28769,28363,9009,42393,5730
897,083008,Viladecavalls,2001,6035,3057,2978,1192,4325,518
898,172180,Vilademuls,2001,728,370,358,69,486,173
899,172207,Viladrau,2001,863,430,433,104,568,191
900,172214,Vilafant,2001,4234,2118,2116,712,3077,445
901,083054,Vilafranca del Penedès,2001,30807,15224,15583,4436,21522,4849
902,252445,Vilagrassa,2001,436,231,205,48,275,113
903,172235,Vilajuïga,2001,980,491,489,156,657,167
904,431750,Vilalba dels Arcs,2001,753,394,359,79,436,238
905,083067,Vilalba Sasserra,2001,467,249,218,72,331,64
906,252458,Vilaller,2001,589,308,281,68,388,133
907,172240,Vilallonga de Ter,2001,416,227,189,30,261,125
908,431665,Vilallonga del Camp,2001,1251,616,635,174,855,222
909,172253,Vilamacolum,2001,253,130,123,28,155,70
910,172266,Vilamalla,2001,794,423,371,110,596,88
911,172272,Vilamaniscle,2001,118,64,54,12,69,37
912,252477,Vilamòs,2001,151,76,75,26,100,25
913,172288,Vilanant,2001,301,154,147,27,196,78
914,431671,Vilanova d'Escornalbou,2001,432,223,209,44,309,79
915,252483,Vilanova de Bellpuig,2001,1136,564,572,103,700,333
916,252496,Vilanova de l'Aguda,2001,266,135,131,30,153,83
917,252542,Vilanova de la Barca,2001,915,459,456,112,552,251
918,252509,Vilanova de Meià,2001,457,238,219,43,274,140
919,431687,Vilanova de Prades,2001,155,78,77,11,88,56
920,083036,Vilanova de Sau,2001,333,152,181,43,225,65
921,252516,Vilanova de Segrià,2001,806,417,389,94,556,156
922,083020,Vilanova del Camí,2001,10344,5208,5136,1742,7418,1184
923,089024,Vilanova del Vallès,2001,2439,1228,1211,405,1693,341
924,083073,Vilanova i la Geltrú,2001,53421,26318,27103,7540,36958,8923
925,431690,Vilaplana,2001,547,278,269,57,330,160
926,431704,Vila-rodona,2001,1033,570,463,102,661,270
927,172305,Vila-sacra,2001,398,203,195,37,288,73
928,252521,Vila-sana,2001,528,264,264,58,332,138
929,431711,Vila-seca,2001,13420,6757,6663,2128,9695,1597
930,082140,Vilassar de Dalt,2001,7486,3717,3769,895,5331,1260
931,082191,Vilassar de Mar,2001,17374,8498,8876,2692,12386,2296
932,172229,Vilaür,2001,130,72,58,13,93,24
933,431726,Vilaverd,2001,363,187,176,29,221,113
934,431732,"Vilella Alta, la",2001,123,65,58,7,73,43
935,431747,"Vilella Baixa, la",2001,179,98,81,11,110,58
936,172333,Vilobí d'Onyar,2001,2239,1187,1052,292,1567,380
937,083041,Vilobí del Penedès,2001,872,453,419,110,577,185
938,172327,Vilopriu,2001,155,79,76,11,91,53
939,252537,"Vilosell, el",2001,192,88,104,9,117,66
940,431763,Vimbodí i Poblet,2001,1045,571,474,92,644,309
941,252555,Vinaixa,2001,617,299,318,66,376,175
942,431779,Vinebre,2001,457,231,226,41,291,125
943,431785,Vinyols i els Arcs,2001,1236,642,594,164,847,225
944,083089,Viver i Serrateix,2001,196,102,94,18,127,51
945,430521,Xerta,2001,1242,623,619,151,762,329
946,000000,Catalunya,2001,6361365,3115336,3246029,865338,4388260,1107767
0,250019,Abella de la Conca,2002,188,101,87,29,117,42
1,080018,Abrera,2002,8823,4562,4261,1366,6653,804
2,250024,Àger,2002,507,279,228,38,276,193
3,250030,Agramunt,2002,5071,2633,2438,706,3314,1051
4,080023,Aguilar de Segarra,2002,215,112,103,27,122,66
5,170010,Agullana,2002,672,343,329,61,409,202
6,080142,Aiguafreda,2002,2175,1070,1105,278,1475,422
7,430017,Aiguamúrcia,2002,671,351,320,63,453,155
8,170025,Aiguaviva,2002,571,291,280,94,394,83
9,250387,Aitona,2002,2193,1111,1082,230,1425,538
10,250045,"Alamús, els",2002,693,346,347,77,446,170
11,250058,Alàs i Cerc,2002,405,214,191,39,259,107
12,250061,"Albagés, l'",2002,502,266,236,61,291,150
13,170031,Albanyà,2002,110,59,51,11,70,29
14,250077,Albatàrrec,2002,1236,638,598,169,829,238
15,250083,Albesa,2002,1515,755,760,182,953,380
16,250096,"Albi, l'",2002,806,417,389,80,521,205
17,430022,Albinyana,2002,1695,884,811,202,1189,304
18,430038,"Albiol, l'",2002,214,118,96,40,148,26
19,170046,Albons,2002,588,307,281,66,394,128
20,430043,Alcanar,2002,8390,4251,4139,1061,5599,1730
21,250100,Alcanó,2002,256,131,125,26,144,86
22,250117,Alcarràs,2002,4838,2418,2420,679,3227,932
23,250122,Alcoletge,2002,1862,985,877,247,1303,312
24,430056,Alcover,2002,4042,2048,1994,612,2737,693
25,439044,"Aldea, l'",2002,3524,1819,1705,436,2299,789
26,430069,Aldover,2002,785,376,409,63,490,232
27,430075,"Aleixar, l'",2002,740,381,359,99,462,179
28,080039,Alella,2002,8796,4379,4417,1353,6406,1037
29,430081,Alfara de Carles,2002,355,187,168,25,213,117
30,250138,Alfarràs,2002,2974,1466,1508,371,1925,678
31,250143,Alfés,2002,331,176,155,32,207,92
32,430094,Alforja,2002,1303,672,631,146,815,342
33,250156,Algerri,2002,510,254,256,35,308,167
34,250169,Alguaire,2002,2844,1441,1403,347,1878,619
35,250175,Alins,2002,272,135,137,22,158,92
36,430108,Alió,2002,382,192,190,37,239,106
37,250194,Almacelles,2002,5753,2948,2805,737,3842,1174
38,250208,Almatret,2002,468,241,227,33,254,181
39,250215,Almenar,2002,3488,1785,1703,421,2259,808
40,430115,Almoster,2002,927,486,441,174,631,122
41,250220,Alòs de Balaguer,2002,174,103,71,8,107,59
42,170062,Alp,2002,1272,673,599,164,946,162
43,080044,Alpens,2002,277,150,127,43,168,66
44,250236,Alpicat,2002,4481,2234,2247,772,3090,619
45,250241,Alt Àneu,2002,442,257,185,54,292,96
46,430120,Altafulla,2002,3563,1819,1744,562,2600,401
47,170078,Amer,2002,2196,1080,1116,252,1429,515
48,430136,"Ametlla de Mar, l'",2002,5211,2651,2560,647,3551,1013
49,080057,"Ametlla del Vallès, l'",2002,6328,3132,3196,1186,4410,732
50,439060,"Ampolla, l'",2002,1988,995,993,223,1281,484
51,430141,Amposta,2002,17372,8682,8690,2397,11815,3160
52,170084,Anglès,2002,5020,2572,2448,651,3319,1050
53,250273,Anglesola,2002,1284,653,631,131,814,339
54,250292,Arbeca,2002,2436,1244,1192,282,1507,647
55,430167,"Arboç, l'",2002,3873,2018,1855,535,2701,637
56,430154,Arbolí,2002,125,66,59,4,92,29
57,170097,Arbúcies,2002,5416,2787,2629,824,3581,1011
58,080060,Arenys de Mar,2002,13107,6362,6745,1892,8808,2407
59,080076,Arenys de Munt,2002,6827,3415,3412,1092,4718,1017
60,170101,Argelaguer,2002,404,213,191,71,229,104
61,080082,Argençola,2002,195,102,93,22,126,47
62,430173,"Argentera, l'",2002,151,86,65,14,108,29
63,080095,Argentona,2002,10056,5014,5042,1580,7048,1428
64,170118,"Armentera, l'",2002,755,373,382,72,483,200
65,430189,Arnes,2002,498,255,243,39,271,188
66,250313,Arres,2002,59,31,28,6,39,14
67,250328,Arsèguel,2002,103,57,46,8,68,27
68,080109,Artés,2002,4552,2267,2285,663,3019,870
69,250334,Artesa de Lleida,2002,1323,688,635,175,833,315
70,250349,Artesa de Segre,2002,3283,1697,1586,396,2059,828
71,430192,Ascó,2002,1657,839,818,203,1067,387
72,250365,Aspa,2002,272,135,137,27,151,94
73,250371,"Avellanes i Santa Linya, les",2002,482,262,220,31,281,170
74,080116,Avià,2002,1921,974,947,238,1221,462
75,080121,Avinyó,2002,2046,1023,1023,302,1299,445
76,170123,Avinyonet de Puigventós,2002,805,417,388,122,577,106
77,080137,Avinyonet del Penedès,2002,1304,694,610,164,859,281
78,080155,Badalona,2002,210370,104409,105961,29049,150687,30634
79,089045,Badia del Vallès,2002,14600,7317,7283,2080,10754,1766
80,080168,Bagà,2002,2133,1027,1106,263,1347,523
81,250390,Baix Pallars,2002,350,199,151,22,213,115
82,250404,Balaguer,2002,13718,6754,6964,1991,9015,2712
83,080174,Balenyà,2002,3208,1603,1605,507,2225,476
84,080180,Balsareny,2002,3238,1602,1636,400,2125,713
85,430206,Banyeres del Penedès,2002,1830,979,851,227,1361,242
86,170157,Banyoles,2002,15796,7824,7972,2663,10237,2896
87,250411,Barbens,2002,801,415,386,78,505,218
88,430213,Barberà de la Conca,2002,434,214,220,46,265,123
89,082520,Barberà del Vallès,2002,26902,13534,13368,4200,19941,2761
90,080193,Barcelona,2002,1527190,717654,809536,176499,1017007,333684
91,250426,"Baronia de Rialb, la",2002,276,146,130,35,161,80
92,170160,Bàscara,2002,845,443,402,82,580,183
93,250447,Bassella,2002,306,154,152,38,167,101
94,430228,Batea,2002,2031,1039,992,202,1253,576
95,250450,Bausen,2002,55,31,24,2,24,29
96,080207,Begues,2002,4775,2381,2394,1022,3294,459
97,170139,Begur,2002,3626,1840,1786,559,2516,551
98,250463,Belianes,2002,590,289,301,71,324,195
99,251706,Bellaguarda,2002,358,178,180,40,191,127
100,170182,Bellcaire d'Empordà,2002,595,314,281,79,387,129
101,250479,Bellcaire d'Urgell,2002,1257,599,658,118,749,390
102,250485,Bell-lloc d'Urgell,2002,2122,1052,1070,255,1380,487
103,250498,Bellmunt d'Urgell,2002,235,113,122,30,137,68
104,430234,Bellmunt del Priorat,2002,311,153,158,23,173,115
105,080214,Bellprat,2002,94,54,40,9,60,25
106,250501,Bellpuig,2002,4200,2127,2073,565,2779,856
107,430249,Bellvei,2002,1431,755,676,220,973,238
108,250518,Bellver de Cerdanya,2002,1673,887,786,171,1134,368
109,250523,Bellvís,2002,2174,1091,1083,244,1281,649
110,250539,Benavent de Segrià,2002,1003,528,475,156,694,153
111,430252,Benifallet,2002,863,433,430,97,489,277
112,430265,Benissanet,2002,1077,564,513,117,680,280
113,080229,Berga,2002,14995,7300,7695,1766,9751,3478
114,170195,Besalú,2002,2073,1021,1052,231,1333,509
115,170209,Bescanó,2002,3419,1715,1704,523,2284,612
116,170216,Beuda,2002,139,79,60,19,96,24
117,080235,Bigues i Riells del Fai,2002,6032,3163,2869,1017,4401,614
118,250557,Biosca,2002,245,125,120,29,143,73
119,170221,"Bisbal d'Empordà, la",2002,8288,4114,4174,1187,5503,1598
120,430271,"Bisbal de Falset, la",2002,250,131,119,31,147,72
121,430287,"Bisbal del Penedès, la",2002,2209,1177,1032,304,1503,402
122,172348,Biure,2002,227,112,115,27,148,52
123,430290,Blancafort,2002,407,216,191,51,224,132
124,170237,Blanes,2002,32926,16595,16331,5029,23166,4731
125,170293,Boadella i les Escaules,2002,226,110,116,26,144,56
126,170242,Bolvir,2002,277,139,138,24,203,50
127,430304,Bonastre,2002,387,205,182,53,243,91
128,250576,"Bòrdes, Es",2002,222,115,107,21,164,37
129,170255,Bordils,2002,1393,685,708,211,923,259
130,250582,"Borges Blanques, les",2002,5313,2659,2654,665,3445,1203
131,430311,"Borges del Camp, les",2002,1666,833,833,211,1123,332
132,170268,Borrassà,2002,534,267,267,51,342,141
133,080240,Borredà,2002,497,254,243,70,314,113
134,250595,Bossòst,2002,966,498,468,137,658,171
135,430326,Bot,2002,809,411,398,61,472,276
136,430332,Botarell,2002,749,386,363,111,534,104
137,250560,Bovera,2002,385,191,194,22,218,145
138,430347,Bràfim,2002,580,275,305,47,378,155
139,170274,Breda,2002,3484,1780,1704,501,2348,635
140,080253,"Bruc, el",2002,1302,687,615,212,877,213
141,080266,"Brull, el",2002,193,105,88,17,138,38
142,170280,Brunyola i Sant Martí Sapresa,2002,364,185,179,29,211,124
143,430350,Cabacés,2002,342,180,162,31,204,107
144,250609,Cabanabona,2002,98,45,53,10,52,36
145,170314,Cabanelles,2002,230,134,96,25,146,59
146,170307,Cabanes,2002,796,414,382,89,536,171
147,080272,"Cabanyes, les",2002,585,307,278,87,399,99
148,250616,Cabó,2002,118,65,53,9,67,42
149,430363,Cabra del Camp,2002,668,354,314,83,440,145
150,080288,Cabrera d'Anoia,2002,649,360,289,83,463,103
151,080291,Cabrera de Mar,2002,3863,1944,1919,647,2751,465
152,080305,Cabrils,2002,5282,2595,2687,1015,3768,499
153,170329,Cadaqués,2002,2487,1217,1270,351,1716,420
154,080312,Calaf,2002,3080,1564,1516,382,2090,608
155,430379,Calafell,2002,14637,7405,7232,1980,10484,2173
156,080348,Calders,2002,788,409,379,134,512,142
157,080327,Caldes d'Estrac,2002,2137,1043,1094,289,1426,422
158,170335,Caldes de Malavella,2002,4365,2201,2164,610,2960,795
159,080333,Caldes de Montbui,2002,13244,6594,6650,1756,9283,2205
160,080351,Calella,2002,14530,7107,7423,2049,9976,2505
161,080370,Calldetenes,2002,2083,1069,1014,339,1449,295
162,080386,Callús,2002,1366,670,696,166,870,330
163,080364,Calonge de Segarra,2002,198,103,95,23,110,65
164,170340,Calonge i Sant Antoni,2002,7684,3884,3800,1153,5287,1244
165,250621,Camarasa,2002,882,453,429,64,515,303
166,439039,Camarles,2002,2975,1493,1482,376,1937,662
167,430385,Cambrils,2002,22215,11132,11083,3576,15933,2706
168,170353,Camós,2002,639,331,308,69,428,142
169,170366,Campdevànol,2002,3412,1682,1730,380,2199,833
170,170372,Campelles,2002,128,68,60,5,90,33
171,080399,Campins,2002,305,158,147,53,213,39
172,170388,Campllong,2002,317,166,151,53,204,60
173,170391,Camprodon,2002,2312,1141,1171,227,1507,578
174,250637,Canejan,2002,109,55,54,10,65,34
175,170405,Canet d'Adri,2002,527,274,253,60,366,101
176,080403,Canet de Mar,2002,11065,5471,5594,1393,7632,2040
177,080410,Canovelles,2002,13375,6843,6532,1970,9669,1736
178,080425,Cànoves i Samalús,2002,2066,1102,964,312,1486,268
179,170412,Cantallops,2002,263,128,135,23,156,84
180,080431,Canyelles,2002,2268,1214,1054,337,1665,266
181,430398,Capafonts,2002,124,66,58,3,86,35
182,430402,Capçanes,2002,413,193,220,37,263,113
183,080446,Capellades,2002,5049,2475,2574,688,3451,910
184,170427,Capmany,2002,493,247,246,68,302,123
185,080459,Capolat,2002,54,32,22,1,31,22
186,080462,Cardedeu,2002,13167,6569,6598,2271,9252,1644
187,080478,Cardona,2002,5399,2623,2776,579,3454,1366
188,080484,Carme,2002,670,343,327,64,429,177
189,430419,Caseres,2002,326,156,170,42,172,112
190,170448,Cassà de la Selva,2002,8016,4026,3990,1206,5239,1571
191,080497,Casserres,2002,1562,745,817,159,957,446
192,080575,Castell de l'Areny,2002,61,37,24,6,41,14
193,259046,Castell de Mur,2002,151,80,71,14,88,49
194,250642,Castellar de la Ribera,2002,144,65,79,17,82,45
195,080522,Castellar de n'Hug,2002,192,101,91,16,127,49
196,080500,Castellar del Riu,2002,124,73,51,20,84,20
197,080517,Castellar del Vallès,2002,18644,9350,9294,3161,13117,2366
198,080538,Castellbell i el Vilar,2002,3035,1549,1486,381,2036,618
199,080543,Castellbisbal,2002,9344,4808,4536,1801,6633,910
200,080556,Castellcir,2002,419,236,183,72,287,60
201,250674,Castelldans,2002,967,507,460,111,570,286
202,080569,Castelldefels,2002,48982,24468,24514,7890,36202,4890
203,080581,Castellet i la Gornal,2002,1508,763,745,193,1022,293
204,170464,Castellfollit de la Roca,2002,1001,512,489,109,631,261
205,080608,Castellfollit de Riubregós,2002,224,112,112,28,141,55
206,080594,Castellfollit del Boix,2002,385,186,199,64,225,96
207,080615,Castellgalí,2002,993,524,469,134,657,202
208,080620,Castellnou de Bages,2002,625,334,291,93,477,55
209,250680,Castellnou de Seana,2002,723,382,341,79,453,191
210,170470,Castelló d'Empúries,2002,7530,3910,3620,1150,5109,1271
211,250693,Castelló de Farfanya,2002,582,286,296,64,339,179
212,080636,Castellolí,2002,434,219,215,71,279,84
213,170486,Castell-Platja d'Aro,2002,7691,3903,3788,1056,5678,957
214,250707,Castellserà,2002,1110,548,562,116,681,313
215,080641,Castellterçol,2002,2106,1027,1079,274,1369,463
216,430424,Castellvell del Camp,2002,1388,705,683,227,985,176
217,080654,Castellví de la Marca,2002,1466,744,722,184,955,327
218,080667,Castellví de Rosanes,2002,1195,610,585,196,854,145
219,430430,"Catllar, el",2002,2691,1394,1297,410,1947,334
220,250714,Cava,2002,58,34,24,4,38,16
221,171899,"Cellera de Ter, la",2002,2062,1043,1019,287,1360,415
222,170499,Celrà,2002,2860,1416,1444,506,1904,450
223,080673,Centelles,2002,5939,2916,3023,793,3974,1172
224,082687,Cercs,2002,1414,717,697,163,870,381
225,082665,Cerdanyola del Vallès,2002,54404,27218,27186,7928,40531,5945
226,080689,Cervelló,2002,6528,3319,3209,1021,4766,741
227,250729,Cervera,2002,8123,4126,3997,1244,5399,1480
228,250735,Cervià de les Garrigues,2002,874,449,425,78,524,272
229,170502,Cervià de Ter,2002,672,337,335,85,415,172
230,170519,Cistella,2002,222,112,110,23,138,61
231,250740,Ciutadilla,2002,202,105,97,17,118,67
232,250753,Clariana de Cardener,2002,148,77,71,22,105,21
233,250766,"Cogul, el",2002,236,126,110,20,131,85
234,170545,Colera,2002,575,288,287,66,371,138
235,250772,Coll de Nargó,2002,599,315,284,67,362,170
236,080692,Collbató,2002,2519,1341,1178,418,1818,283
237,430458,Colldejou,2002,196,107,89,17,141,38
238,080706,Collsuspina,2002,273,146,127,33,199,41
239,170558,Colomers,2002,199,101,98,10,119,70
240,251636,"Coma i la Pedra, la",2002,245,148,97,21,163,61
241,251615,Conca de Dalt,2002,425,216,209,36,244,145
242,430461,Conesa,2002,136,74,62,14,85,37
243,430477,Constantí,2002,5206,2733,2473,748,3695,763
244,080713,Copons,2002,287,135,152,22,178,87
245,430483,Corbera d'Ebre,2002,1043,546,497,127,621,295
246,080728,Corbera de Llobregat,2002,10194,5201,4993,1815,7317,1062
247,250788,Corbins,2002,1110,573,537,140,708,262
248,170577,Corçà,2002,1158,587,571,123,810,225
249,080734,Cornellà de Llobregat,2002,81881,40490,41391,10537,57982,13362
250,170561,Cornellà del Terri,2002,1918,964,954,249,1272,397
251,430496,Cornudella de Montsant,2002,873,441,432,82,535,256
252,430509,Creixell,2002,2197,1112,1085,310,1484,403
253,170583,Crespià,2002,226,106,120,21,127,78
254,179011,"Cruïlles, Monells i Sant Sadurní de l'Heura",2002,1150,576,574,147,793,210
255,080749,Cubelles,2002,7733,3946,3787,1126,5507,1100
256,250791,Cubells,2002,378,190,188,43,200,135
257,430516,Cunit,2002,6828,3525,3303,904,4897,1027
258,170600,Darnius,2002,519,277,242,40,336,143
259,170617,Das,2002,157,87,70,18,108,31
260,439018,Deltebre,2002,10541,5319,5222,1361,7086,2094
261,080752,Dosrius,2002,3293,1670,1623,533,2443,317
262,430537,Duesaigües,2002,202,122,80,10,127,65
263,170622,"Escala, l'",2002,6398,3220,3178,713,4533,1152
264,080765,Esparreguera,2002,18708,9498,9210,3080,13280,2348
265,170638,Espinelves,2002,182,93,89,17,108,57
266,250812,"Espluga Calba, l'",2002,429,231,198,34,270,125
267,430542,"Espluga de Francolí, l'",2002,3664,1822,1842,494,2293,877
268,080771,Esplugues de Llobregat,2002,45988,22618,23370,5641,33793,6554
269,170643,Espolla,2002,382,192,190,43,228,111
270,170656,Esponellà,2002,392,189,203,46,265,81
271,250827,Espot,2002,320,171,149,33,221,66
272,080787,"Espunyola, l'",2002,275,140,135,35,170,70
273,082541,"Esquirol, l'",2002,2139,1070,1069,297,1385,457
274,250886,Estamariu,2002,127,68,59,7,84,36
275,080790,"Estany, l'",2002,404,189,215,37,246,121
276,250851,Estaràs,2002,193,104,89,24,114,55
277,250864,Esterri d'Àneu,2002,677,329,348,73,441,163
278,250870,Esterri de Cardós,2002,77,38,39,7,48,22
279,430555,Falset,2002,2581,1322,1259,353,1656,572
280,170059,"Far d'Empordà, el",2002,397,206,191,53,260,84
281,250899,Farrera,2002,95,57,38,7,66,22
282,430568,"Fatarella, la",2002,1202,604,598,106,722,374
283,430574,"Febró, la",2002,63,41,22,4,48,11
284,081347,Figaró-Montmany,2002,901,472,429,122,610,169
285,080804,Fígols,2002,52,30,22,2,32,18
286,259084,Fígols i Alinyà,2002,274,147,127,12,153,109
287,430580,"Figuera, la",2002,124,65,59,16,68,40
288,170669,Figueres,2002,35174,17109,18065,5578,23517,6079
289,430593,Figuerola del Camp,2002,301,144,157,42,192,67
290,170675,Flaçà,2002,884,445,439,96,584,204
291,430607,Flix,2002,4076,2051,2025,461,2665,950
292,250925,"Floresta, la",2002,192,103,89,24,99,69
293,080826,Fogars de la Selva,2002,786,417,369,113,546,127
294,080811,Fogars de Montclús,2002,365,198,167,49,249,67
295,170681,Foixà,2002,319,152,167,46,188,85
296,080832,Folgueroles,2002,1724,863,861,278,1179,267
297,250931,Fondarella,2002,694,351,343,92,478,124
298,080847,Fonollosa,2002,1061,542,519,146,732,183
299,170694,Fontanals de Cerdanya,2002,428,204,224,52,295,81
300,170708,Fontanilles,2002,147,87,60,8,108,31
301,170715,Fontcoberta,2002,1176,573,603,182,820,174
302,080850,Font-rubí,2002,1303,680,623,183,795,325
303,250946,Foradada,2002,201,119,82,13,128,60
304,179026,Forallac,2002,1683,833,850,197,1170,316
305,430614,Forès,2002,62,32,30,0,37,25
306,170736,Fornells de la Selva,2002,1616,776,840,281,1125,210
307,170741,Fortià,2002,531,259,272,56,347,128
308,080863,"Franqueses del Vallès, les",2002,13581,6844,6737,2149,9857,1575
309,430629,Freginals,2002,389,203,186,40,232,117
310,250962,"Fuliola, la",2002,1253,629,624,154,768,331
311,250978,Fulleda,2002,113,59,54,13,66,34
312,080902,Gaià,2002,150,79,71,23,103,24
313,430635,"Galera, la",2002,750,373,377,71,444,235
314,080879,Gallifa,2002,200,107,93,37,138,25
315,430640,Gandesa,2002,2697,1374,1323,331,1737,629
316,430653,Garcia,2002,511,266,245,38,308,165
317,430666,"Garidells, els",2002,158,82,76,19,102,37
318,080885,"Garriga, la",2002,12333,6011,6322,2044,8455,1834
319,170754,Garrigàs,2002,311,174,137,35,191,85
320,170767,Garrigoles,2002,150,82,68,16,92,42
321,170773,Garriguella,2002,725,375,350,86,466,173
322,080898,Gavà,2002,41162,20564,20598,6321,29420,5421
323,250984,Gavet de la Conca,2002,316,155,161,28,169,119
324,080919,Gelida,2002,4682,2381,2301,659,3234,789
325,170789,Ger,2002,401,209,192,51,273,77
326,259123,Gimenells i el Pla de la Font,2002,1089,568,521,125,696,268
327,430672,Ginestar,2002,847,425,422,81,490,276
328,170792,Girona,2002,77475,37364,40111,12303,53403,11769
329,080924,Gironella,2002,4899,2385,2514,484,3081,1334
330,080930,Gisclareny,2002,30,16,14,2,25,3
331,430688,Godall,2002,741,379,362,68,426,247
332,250997,Golmés,2002,1431,724,707,181,960,290
333,170806,Gombrèn,2002,232,108,124,19,156,57
334,251001,Gósol,2002,235,126,109,17,157,61
335,080945,"Granada, la",2002,1429,708,721,220,950,259
336,251018,"Granadella, la",2002,799,412,387,81,447,271
337,080958,Granera,2002,66,45,21,0,49,17
338,251023,"Granja d'Escarp, la",2002,1093,584,509,121,714,258
339,080961,Granollers,2002,54634,26857,27777,8134,38697,7803
340,251039,Granyanella,2002,137,73,64,6,88,43
341,251057,Granyena de les Garrigues,2002,156,82,74,8,88,60
342,251044,Granyena de Segarra,2002,147,75,72,5,85,57
343,430691,Gratallops,2002,228,121,107,28,146,54
344,080977,Gualba,2002,857,441,416,115,610,132
345,170813,Gualta,2002,334,187,147,57,217,60
346,080996,Guardiola de Berguedà,2002,964,496,468,116,575,273
347,430705,"Guiamets, els",2002,308,158,150,35,186,87
348,170828,Guils de Cerdanya,2002,338,172,166,38,244,56
349,251095,Guimerà,2002,383,194,189,23,203,157
350,259031,"Guingueta d'Àneu, la",2002,328,175,153,40,208,80
351,251109,Guissona,2002,3745,1959,1786,629,2582,534
352,251116,Guixers,2002,153,93,60,8,103,42
353,081000,Gurb,2002,1993,1004,989,336,1366,291
354,430712,Horta de Sant Joan,2002,1217,644,573,126,740,351
355,081017,"Hospitalet de Llobregat, l'",2002,244323,119644,124679,27539,173313,43471
356,081629,"Hostalets de Pierola, els",2002,1460,760,700,181,1019,260
357,170834,Hostalric,2002,2905,1438,1467,388,2055,462
358,081022,Igualada,2002,33382,16282,17100,4594,22542,6246
359,251155,Isona i Conca Dellà,2002,1214,648,566,110,713,391
360,170849,Isòvol,2002,198,109,89,10,134,54
361,251137,Ivars d'Urgell,2002,1799,934,865,187,1135,477
362,251121,Ivars de Noguera,2002,329,169,160,30,213,86
363,251142,Ivorra,2002,159,75,84,16,92,51
364,170852,Jafre,2002,313,161,152,21,185,107
365,170865,"Jonquera, la",2002,2790,1406,1384,425,2001,364
366,081038,Jorba,2002,617,292,325,112,361,144
367,259101,Josa i Tuixén,2002,151,83,68,12,90,49
368,170871,Juià,2002,261,128,133,19,174,68
369,251180,Juncosa,2002,616,353,263,72,368,176
370,251193,Juneda,2002,2944,1489,1455,335,1889,720
371,251214,Les,2002,680,341,339,93,451,136
372,251229,Linyola,2002,2438,1215,1223,305,1594,539
373,081043,"Llacuna, la",2002,857,453,404,99,555,203
374,170887,Lladó,2002,525,267,258,65,321,139
375,251235,Lladorre,2002,224,114,110,17,150,57
376,251240,Lladurs,2002,227,117,110,29,148,50
377,081056,"Llagosta, la",2002,12350,6235,6115,1653,9129,1568
378,170890,Llagostera,2002,6072,3114,2958,879,4039,1154
379,170904,Llambilles,2002,491,253,238,64,329,98
380,170911,Llanars,2002,529,279,250,48,367,114
381,170926,Llançà,2002,4129,2050,2079,486,2703,940
382,251253,Llardecans,2002,614,317,297,66,354,194
383,251266,Llavorsí,2002,286,141,145,39,171,76
384,251207,Lleida,2002,115000,56101,58899,16665,78642,19693
385,170932,Llers,2002,1052,529,523,128,726,198
386,251272,Lles de Cerdanya,2002,270,153,117,28,172,70
387,081075,Lliçà d'Amunt,2002,10821,5583,5238,1845,7818,1158
388,081081,Lliçà de Vall,2002,5396,2775,2621,838,3992,566
389,251288,Llimiana,2002,141,75,66,11,85,45
390,081069,Llinars del Vallès,2002,7363,3695,3668,1199,5176,988
391,170947,Llívia,2002,1133,600,533,121,817,195
392,430727,"Lloar, el",2002,123,64,59,4,75,44
393,251291,Llobera,2002,223,115,108,21,137,65
394,430733,Llorac,2002,126,60,66,12,79,35
395,430748,Llorenç del Penedès,2002,1692,820,872,260,1112,320
396,170950,Lloret de Mar,2002,23424,11958,11466,3736,17026,2662
397,170963,"Llosses, les",2002,260,139,121,28,181,51
398,081094,Lluçà,2002,269,144,125,44,170,55
399,171024,Maçanet de Cabrenys,2002,679,352,327,47,416,216
400,171030,Maçanet de la Selva,2002,4194,2148,2046,619,2946,629
401,170979,Madremanya,2002,201,90,111,18,140,43
402,170985,Maià de Montcal,2002,324,165,159,35,217,72
403,251333,Maials,2002,957,482,475,86,554,317
404,251305,Maldà,2002,273,141,132,22,151,100
405,081108,Malgrat de Mar,2002,14933,7494,7439,2079,10315,2539
406,081115,Malla,2002,258,120,138,33,176,49
407,081120,Manlleu,2002,18229,9248,8981,2839,12258,3132
408,081136,Manresa,2002,65440,31829,33611,8193,42936,14311
409,430764,Marçà,2002,617,311,306,62,370,185
410,430751,Margalef,2002,128,67,61,9,73,46
411,082423,Marganell,2002,238,107,131,27,144,67
412,081141,Martorell,2002,23529,12031,11498,3642,16685,3202
413,081154,Martorelles,2002,4981,2492,2489,730,3509,742
414,430770,Mas de Barberans,2002,682,348,334,66,416,200
415,171002,Masarac,2002,239,119,120,28,137,74
416,430786,Masdenverge,2002,996,515,481,127,639,230
417,081167,"Masies de Roda, les",2002,717,360,357,109,480,128
418,081173,"Masies de Voltregà, les",2002,2883,1398,1485,437,1999,447
419,430799,Masllorenç,2002,424,210,214,49,260,115
420,081189,"Masnou, el",2002,21220,10291,10929,3158,14999,3063
421,430803,"Masó, la",2002,278,136,142,26,188,64
422,430810,Maspujols,2002,498,256,242,74,303,121
423,081192,Masquefa,2002,5700,2907,2793,932,4068,700
424,430825,"Masroig, el",2002,518,253,265,46,296,176
425,251312,Massalcoreig,2002,619,305,314,67,363,189
426,171019,Massanes,2002,569,313,256,59,397,113
427,251327,Massoteres,2002,195,103,92,19,119,57
428,081206,Matadepera,2002,7404,3733,3671,1457,5103,844
429,081213,Mataró,2002,109298,54191,55107,16106,76764,16428
430,081228,Mediona,2002,1507,784,723,157,1014,336
431,251348,Menàrguens,2002,830,425,405,86,499,245
432,170998,Meranges,2002,80,50,30,0,57,23
433,171058,Mieres,2002,333,171,162,48,200,85
434,430831,"Milà, el",2002,162,74,88,16,108,38
435,251351,Miralcamp,2002,1228,599,629,153,816,259
436,430846,Miravet,2002,791,418,373,84,494,213
437,081385,Moià,2002,4378,2174,2204,690,2894,794
438,430859,"Molar, el",2002,295,155,140,29,165,101
439,081234,Molins de Rei,2002,21197,10423,10774,3039,14956,3202
440,251370,Mollerussa,2002,10184,5095,5089,1625,6970,1589
441,171061,Mollet de Peralada,2002,190,100,90,16,107,67
442,081249,Mollet del Vallès,2002,48727,24554,24173,7719,35662,5346
443,171077,Molló,2002,322,163,159,21,202,99
444,251364,"Molsosa, la",2002,125,62,63,16,78,31
445,081287,Monistrol de Calders,2002,617,304,313,80,409,128
446,081271,Monistrol de Montserrat,2002,2578,1323,1255,297,1729,552
447,171096,Montagut i Oix,2002,826,424,402,95,507,224
448,430862,Montblanc,2002,6243,3113,3130,858,4184,1201
449,430884,Montbrió del Camp,2002,1538,784,754,213,969,356
450,081252,Montcada i Reixac,2002,29653,14659,14994,4378,20966,4309
451,081304,Montclar,2002,118,60,58,18,71,29
452,251399,Montellà i Martinet,2002,538,288,250,58,328,152
453,081311,Montesquiu,2002,854,433,421,88,550,216
454,251403,Montferrer i Castellbò,2002,753,410,343,73,513,167
455,430897,Montferri,2002,131,72,59,12,70,49
456,251386,Montgai,2002,795,403,392,89,457,249
457,081265,Montgat,2002,8690,4320,4370,1191,6321,1178
458,081326,Montmajor,2002,465,245,220,47,308,110
459,081332,Montmaneu,2002,180,92,88,11,116,53
460,430901,"Montmell, el",2002,727,398,329,100,513,114
461,081350,Montmeló,2002,8667,4370,4297,1301,6275,1091
462,251425,Montoliu de Lleida,2002,451,222,229,37,295,119
463,251410,Montoliu de Segarra,2002,184,102,82,12,102,70
464,251431,Montornès de Segarra,2002,102,46,56,5,54,43
465,081363,Montornès del Vallès,2002,13171,6722,6449,1994,9652,1525
466,430918,Mont-ral,2002,165,90,75,14,129,22
467,171100,Mont-ras,2002,1684,881,803,246,1211,227
468,430923,Mont-roig del Camp,2002,7438,3840,3598,967,5306,1165
469,081379,Montseny,2002,295,152,143,33,203,59
470,430939,Móra d'Ebre,2002,4776,2345,2431,675,3139,962
471,430944,Móra la Nova,2002,2922,1482,1440,424,1914,584
472,430957,"Morell, el",2002,2358,1194,1164,375,1605,378
473,430960,"Morera de Montsant, la",2002,168,94,74,21,110,37
474,081290,Muntanyola,2002,347,188,159,64,238,45
475,081398,Mura,2002,207,112,95,14,141,52
476,251459,Nalec,2002,100,47,53,6,54,40
477,250254,Naut Aran,2002,1493,774,719,211,1097,185
478,081402,Navarcles,2002,5400,2673,2727,731,3635,1034
479,081419,Navàs,2002,5600,2776,2824,737,3640,1223
480,171117,Navata,2002,753,379,374,117,470,166
481,251462,Navès,2002,278,135,143,33,166,79
482,081424,"Nou de Berguedà, la",2002,161,83,78,26,96,39
483,430976,"Nou de Gaià, la",2002,395,204,191,43,258,94
484,430982,Nulles,2002,379,174,205,39,238,102
485,251484,Odèn,2002,278,155,123,28,166,84
486,081430,Òdena,2002,2743,1376,1367,413,1864,466
487,171122,Ogassa,2002,253,149,104,25,176,52
488,081458,Olèrdola,2002,2428,1252,1176,383,1663,382
489,081461,Olesa de Bonesvalls,2002,1085,580,505,131,795,159
490,081477,Olesa de Montserrat,2002,18492,9380,9112,2834,12864,2794
491,251497,Oliana,2002,1870,951,919,196,1208,466
492,251500,Oliola,2002,220,118,102,22,150,48
493,251517,Olius,2002,582,293,289,100,387,95
494,081483,Olivella,2002,1552,835,717,224,1180,148
495,081496,Olost,2002,1170,580,590,146,719,305
496,171143,Olot,2002,28890,14141,14749,3851,18476,6563
497,251522,"Oluges, les",2002,180,92,88,10,112,58
498,081445,Olvan,2002,874,429,445,77,543,254
499,251538,"Omellons, els",2002,251,128,123,20,153,78
500,251543,"Omells de na Gaia, els",2002,151,82,69,16,85,50
501,171156,Ordis,2002,343,178,165,46,243,54
502,251556,Organyà,2002,966,492,474,81,604,281
503,081509,Orís,2002,236,118,118,34,149,53
504,081516,Oristà,2002,624,300,324,60,393,171
505,081521,Orpí,2002,140,78,62,14,95,31
506,081537,Òrrius,2002,364,189,175,36,263,65
507,251569,Os de Balaguer,2002,778,415,363,85,457,236
508,171169,Osor,2002,457,246,211,38,300,119
509,251575,Ossó de Sió,2002,239,121,118,26,149,64
510,081542,Pacs del Penedès,2002,680,340,340,97,493,90
511,081555,Palafolls,2002,6010,3025,2985,1075,4255,680
512,171175,Palafrugell,2002,19115,9733,9382,2808,13036,3271
513,171181,Palamós,2002,15662,7780,7882,2339,10715,2608
514,251581,"Palau d'Anglesola, el",2002,1725,861,864,243,1117,365
515,171194,Palau de Santa Eulàlia,2002,79,46,33,6,58,15
516,171215,Palau-sator,2002,286,148,138,20,192,74
517,171208,Palau-saverdera,2002,975,496,479,102,635,238
518,081568,Palau-solità i Plegamans,2002,11586,5910,5676,1995,8439,1152
519,431009,"Pallaresos, els",2002,2761,1432,1329,564,2021,176
520,081574,Pallejà,2002,8192,4145,4047,1071,6136,985
521,430995,"Palma d'Ebre, la",2002,411,196,215,42,233,136
522,089058,"Palma de Cervelló, la",2002,2794,1422,1372,495,1976,323
523,171236,Palol de Revardit,2002,388,201,187,52,256,80
524,171241,Pals,2002,2055,1051,1004,201,1379,475
525,081580,"Papiol, el",2002,3512,1762,1750,520,2453,539
526,171254,Pardines,2002,146,74,72,15,89,42
527,081593,Parets del Vallès,2002,15323,7781,7542,2504,11070,1749
528,171267,Parlavà,2002,358,184,174,44,230,84
529,431016,Passanant i Belltall,2002,198,115,83,9,109,80
530,171289,Pau,2002,462,233,229,51,315,96
531,431021,Paüls,2002,630,317,313,60,397,173
532,171292,Pedret i Marzà,2002,141,72,69,20,88,33
533,251641,Penelles,2002,523,286,237,48,313,162
534,171306,"Pera, la",2002,398,201,197,51,244,103
535,081607,Perafita,2002,366,179,187,43,225,98
536,431037,Perafort,2002,663,337,326,83,475,105
537,171328,Peralada,2002,1382,703,679,178,901,303
538,251654,Peramola,2002,385,208,177,38,227,120
539,431042,"Perelló, el",2002,2144,1113,1031,205,1365,574
540,081614,Piera,2002,10194,5236,4958,1669,6850,1675
541,431055,"Piles, les",2002,194,106,88,29,129,36
542,081635,Pineda de Mar,2002,21958,11059,10899,3395,15458,3105
543,431068,"Pinell de Brai, el",2002,1077,547,530,106,679,292
544,251667,Pinell de Solsonès,2002,212,116,96,18,141,53
545,251673,Pinós,2002,311,166,145,30,185,96
546,431074,Pira,2002,435,218,217,66,273,96
547,431080,"Pla de Santa Maria, el",2002,1717,893,824,276,1105,336
548,081640,"Pla del Penedès, el",2002,903,454,449,104,576,223
549,171334,"Planes d'Hostoles, les",2002,1750,878,872,185,1089,476
550,171349,Planoles,2002,281,150,131,18,183,80
551,259118,"Plans de Sió, els",2002,559,293,266,47,320,192
552,251689,"Poal, el",2002,639,344,295,82,378,179
553,251692,"Pobla de Cérvoles, la",2002,224,121,103,25,122,77
554,081653,"Pobla de Claramunt, la",2002,1797,929,868,242,1213,342
555,081666,"Pobla de Lillet, la",2002,1320,646,674,87,805,428
556,431093,"Pobla de Mafumet, la",2002,1220,612,608,210,828,182
557,431107,"Pobla de Massaluca, la",2002,435,225,210,24,246,165
558,431114,"Pobla de Montornès, la",2002,1622,885,737,163,1176,283
559,251713,"Pobla de Segur, la",2002,2866,1377,1489,268,1723,875
560,431129,Poboleda,2002,326,166,160,20,194,112
561,081672,Polinyà,2002,5246,2714,2532,934,3884,428
562,431135,"Pont d'Armentera, el",2002,541,274,267,43,330,168
563,250306,"Pont de Bar, el",2002,154,84,70,15,87,52
564,171352,Pont de Molins,2002,446,237,209,57,305,84
565,251734,"Pont de Suert, el",2002,2166,1083,1083,247,1418,501
566,081825,"Pont de Vilomara i Rocafort, el",2002,2750,1417,1333,387,1931,432
567,431418,Pontils,2002,136,66,70,10,95,31
568,081688,Pontons,2002,408,217,191,45,276,87
569,171365,Pontós,2002,219,123,96,19,145,55
570,251728,Ponts,2002,2405,1212,1193,307,1544,554
571,171371,Porqueres,2002,3768,1855,1913,606,2597,565
572,431140,Porrera,2002,467,253,214,61,285,121
573,171404,"Port de la Selva, el",2002,897,448,449,106,613,178
574,171387,Portbou,2002,1443,725,718,117,868,458
575,251749,"Portella, la",2002,636,348,288,55,439,142
576,431153,Pradell de la Teixeta,2002,182,93,89,10,117,55
577,431166,Prades,2002,581,300,281,57,356,168
578,431172,Prat de Comte,2002,182,89,93,17,102,63
579,081691,"Prat de Llobregat, el",2002,63112,31645,31467,8994,46082,8036
580,431188,Pratdip,2002,617,315,302,64,379,174
581,081712,Prats de Lluçanès,2002,2715,1347,1368,392,1719,604
582,081705,"Prats de Rei, els",2002,558,282,276,57,359,142
583,251752,Prats i Sansor,2002,225,132,93,37,159,29
584,251765,Preixana,2002,437,216,221,33,245,159
585,251771,Preixens,2002,526,252,274,45,299,182
586,082303,Premià de Dalt,2002,9356,4701,4655,1495,6796,1065
587,081727,Premià de Mar,2002,26889,13436,13453,4016,19319,3554
588,171390,"Preses, les",2002,1511,736,775,216,1003,292
589,251790,Prullans,2002,223,114,109,25,138,60
590,171411,Puigcerdà,2002,7774,4005,3769,1155,5433,1186
591,081748,Puigdàlber,2002,348,160,188,57,228,63
592,251804,Puiggròs,2002,268,137,131,26,166,76
593,431191,Puigpelat,2002,552,280,272,84,370,98
594,081751,Puig-reig,2002,4269,2065,2204,442,2633,1194
595,251811,Puigverd d'Agramunt,2002,253,137,116,26,158,69
596,251826,Puigverd de Lleida,2002,1089,535,554,134,691,264
597,081764,Pujalt,2002,186,95,91,20,118,48
598,081770,"Quar, la",2002,78,44,34,8,54,16
599,171426,Quart,2002,2545,1292,1253,406,1843,296
600,170433,Queralbs,2002,196,108,88,24,117,55
601,431205,Querol,2002,305,172,133,34,220,51
602,171432,Rabós,2002,155,78,77,13,103,39
603,081786,Rajadell,2002,426,218,208,43,302,81
604,431212,Rasquera,2002,750,381,369,66,436,248
605,171447,Regencós,2002,287,165,122,34,183,70
606,081799,Rellinars,2002,412,218,194,62,272,78
607,431227,Renau,2002,73,36,37,11,48,14
608,431233,Reus,2002,91616,44947,46669,14124,63080,14412
609,251832,Rialp,2002,554,287,267,64,389,101
610,431248,"Riba, la",2002,694,366,328,68,453,173
611,431251,Riba-roja d'Ebre,2002,1334,686,648,129,814,391
612,259059,Ribera d'Ondara,2002,475,248,227,41,287,147
613,251850,Ribera d'Urgellet,2002,844,442,402,87,527,230
614,171450,Ribes de Freser,2002,2064,1009,1055,194,1283,587
615,171463,Riells i Viabrea,2002,2332,1221,1111,414,1665,253
616,431264,"Riera de Gaià, la",2002,1061,535,526,136,710,215
617,251863,Riner,2002,276,143,133,29,182,65
618,171479,Ripoll,2002,10842,5291,5551,1258,7138,2446
619,081803,Ripollet,2002,31401,15768,15633,4769,22869,3763
620,259139,Riu de Cerdanya,2002,84,43,41,11,59,14
621,171485,Riudarenes,2002,1415,741,674,194,948,273
622,171498,Riudaura,2002,413,205,208,45,286,82
623,431270,Riudecanyes,2002,750,378,372,92,472,186
624,431286,Riudecols,2002,1009,532,477,138,656,215
625,171501,Riudellots de la Selva,2002,1597,815,782,241,1083,273
626,431299,Riudoms,2002,5356,2717,2639,797,3609,950
627,171518,Riumors,2002,178,88,90,16,103,59
628,081810,"Roca del Vallès, la",2002,7964,4006,3958,1225,5815,924
629,431303,Rocafort de Queralt,2002,273,142,131,21,151,101
630,431310,Roda de Berà,2002,3885,2110,1775,488,2909,488
631,081831,Roda de Ter,2002,5294,2588,2706,783,3499,1012
632,431325,Rodonyà,2002,437,231,206,64,250,123
633,431331,Roquetes,2002,6640,3401,3239,907,4452,1281
634,171523,Roses,2002,14214,7213,7001,2359,9876,1979
635,251898,Rosselló,2002,1972,978,994,305,1304,363
636,431346,"Rourell, el",2002,292,148,144,34,174,84
637,081846,Rubí,2002,62638,31480,31158,9760,45435,7443
638,081859,Rubió,2002,125,71,54,23,71,31
639,171539,Rupià,2002,190,101,89,14,122,54
640,089019,Rupit i Pruit,2002,328,163,165,30,228,70
641,081878,Sabadell,2002,187201,91147,96054,26506,128644,32051
642,081884,Sagàs,2002,155,79,76,22,94,39
643,251902,Salàs de Pallars,2002,329,163,166,21,181,127
644,081901,Saldes,2002,325,179,146,40,224,61
645,171544,Sales de Llierca,2002,99,53,46,19,70,10
646,081918,Sallent,2002,7079,3424,3655,813,4528,1738
647,431359,Salomó,2002,375,192,183,31,218,126
648,439057,Salou,2002,15360,7894,7466,2354,11471,1535
649,171557,Salt,2002,23214,11769,11445,3643,16156,3415
650,251919,Sanaüja,2002,463,233,230,52,261,150
651,081944,Sant Adrià de Besòs,2002,32641,16094,16547,4994,22622,5025
652,081957,Sant Agustí de Lluçanès,2002,107,59,48,17,71,19
653,081960,Sant Andreu de la Barca,2002,22396,11493,10903,3590,16864,1942
654,081976,Sant Andreu de Llavaneres,2002,8091,4043,4048,1365,5749,977
655,171576,Sant Andreu Salou,2002,141,64,77,28,81,32
656,171833,Sant Aniol de Finestres,2002,288,152,136,35,197,56
657,081982,Sant Antoni de Vilamajor,2002,3951,1966,1985,645,2773,533
658,081995,Sant Bartomeu del Grau,2002,1134,600,534,216,750,168
659,082009,Sant Boi de Llobregat,2002,80041,39820,40221,11475,57906,10660
660,082016,Sant Boi de Lluçanès,2002,572,294,278,44,367,161
661,431362,Sant Carles de la Ràpita,2002,11735,5870,5865,1599,7846,2290
662,082037,Sant Cebrià de Vallalta,2002,2060,1112,948,323,1518,219
663,082021,Sant Celoni,2002,13291,6631,6660,1983,9039,2269
664,082042,Sant Climent de Llobregat,2002,3140,1578,1562,523,2268,349
665,171582,Sant Climent Sescebes,2002,416,211,205,38,254,124
666,082055,Sant Cugat del Vallès,2002,59837,29528,30309,11092,42555,6190
667,082068,Sant Cugat Sesgarrigues,2002,770,402,368,103,506,161
668,251961,Sant Esteve de la Sarga,2002,104,64,40,4,68,32
669,082074,Sant Esteve de Palautordera,2002,1591,797,794,291,1088,212
670,082080,Sant Esteve Sesrovires,2002,5591,2898,2693,933,4041,617
671,171595,Sant Feliu de Buixalleu,2002,734,396,338,108,470,156
672,082107,Sant Feliu de Codines,2002,4715,2387,2328,700,3180,835
673,171609,Sant Feliu de Guíxols,2002,18994,9380,9614,2835,12844,3315
674,082114,Sant Feliu de Llobregat,2002,40695,20102,20593,5621,30078,4996
675,171616,Sant Feliu de Pallerols,2002,1163,565,598,137,725,301
676,082129,Sant Feliu Sasserra,2002,656,323,333,88,421,147
677,171621,Sant Ferriol,2002,204,114,90,34,127,43
678,082093,Sant Fost de Campsentelles,2002,6713,3402,3311,971,4932,810
679,082135,Sant Fruitós de Bages,2002,6036,3032,3004,914,4288,834
680,171637,Sant Gregori,2002,2509,1293,1216,404,1707,398
681,251924,Sant Guim de Freixenet,2002,1071,525,546,109,697,265
682,251977,Sant Guim de la Plana,2002,183,97,86,17,111,55
683,171642,Sant Hilari Sacalm,2002,5220,2708,2512,706,3546,968
684,082153,Sant Hipòlit de Voltregà,2002,3087,1536,1551,426,1955,706
685,081939,Sant Iscle de Vallalta,2002,961,508,453,157,659,145
686,439023,Sant Jaume d'Enveja,2002,3318,1690,1628,422,2187,709
687,082166,Sant Jaume de Frontanyà,2002,25,13,12,0,23,2
688,171655,Sant Jaume de Llierca,2002,758,386,372,108,427,223
689,431378,Sant Jaume dels Domenys,2002,1596,836,760,216,1051,329
690,171674,Sant Joan de les Abadesses,2002,3655,1798,1857,375,2368,912
691,171680,Sant Joan de Mollet,2002,351,170,181,57,216,78
692,082188,Sant Joan de Vilatorrada,2002,9390,4695,4695,1297,6663,1430
693,082172,Sant Joan Despí,2002,29064,14367,14697,4519,21174,3371
694,171851,Sant Joan les Fonts,2002,2735,1367,1368,277,1831,627
695,171668,Sant Jordi Desvalls,2002,640,327,313,65,413,162
696,089030,Sant Julià de Cerdanyola,2002,241,126,115,28,153,60
697,171693,Sant Julià de Ramis,2002,2166,1091,1075,329,1509,328
698,082205,Sant Julià de Vilatorta,2002,2473,1223,1250,418,1696,359
699,179032,Sant Julià del Llor i Bonmatí,2002,965,492,473,123,631,211
700,082212,Sant Just Desvern,2002,14557,6973,7584,2297,10187,2073
701,082227,Sant Llorenç d'Hortons,2002,1779,902,877,274,1175,330
702,171714,Sant Llorenç de la Muga,2002,185,85,100,15,106,64
703,251930,Sant Llorenç de Morunys,2002,901,465,436,83,586,232
704,082233,Sant Llorenç Savall,2002,2123,1069,1054,291,1306,526
705,082251,Sant Martí d'Albars,2002,132,67,65,15,83,34
706,082248,Sant Martí de Centelles,2002,784,409,375,131,515,138
707,171729,Sant Martí de Llémena,2002,475,256,219,74,310,91
708,259025,Sant Martí de Riucorb,2002,698,362,336,51,424,223
709,082264,Sant Martí de Tous,2002,1027,518,509,149,654,224
710,082270,Sant Martí Sarroca,2002,2531,1268,1263,324,1655,552
711,082286,Sant Martí Sesgueioles,2002,356,176,180,46,221,89
712,171735,Sant Martí Vell,2002,161,82,79,29,92,40
713,082299,Sant Mateu de Bages,2002,702,345,357,62,416,224
714,171740,Sant Miquel de Campmajor,2002,196,107,89,21,136,39
715,171753,Sant Miquel de Fluvià,2002,609,307,302,89,396,124
716,171766,Sant Mori,2002,156,75,81,16,103,37
717,171772,Sant Pau de Segúries,2002,658,333,325,74,409,175
718,082310,Sant Pere de Ribes,2002,23823,12053,11770,4076,17186,2561
719,082325,Sant Pere de Riudebitlles,2002,2123,1045,1078,262,1449,412
720,082331,Sant Pere de Torelló,2002,2230,1108,1122,262,1508,460
721,082346,Sant Pere de Vilamajor,2002,2934,1537,1397,503,2062,369
722,171788,Sant Pere Pescador,2002,1577,876,701,209,1080,288
723,081897,Sant Pere Sallavinera,2002,149,76,73,13,85,51
724,082359,Sant Pol de Mar,2002,4035,2054,1981,556,2908,571
725,082362,Sant Quintí de Mediona,2002,1843,945,898,234,1224,385
726,082378,Sant Quirze de Besora,2002,1986,982,1004,212,1253,521
727,082384,Sant Quirze del Vallès,2002,13916,6964,6952,2580,10077,1259
728,082397,Sant Quirze Safaja,2002,441,246,195,54,327,60
729,251945,Sant Ramon,2002,564,288,276,52,351,161
730,082401,Sant Sadurní d'Anoia,2002,10099,5019,5080,1552,6865,1682
731,082418,Sant Sadurní d'Osormort,2002,83,45,38,12,57,14
732,080983,Sant Salvador de Guardiola,2002,2245,1170,1075,309,1618,318
733,082628,Sant Vicenç de Castellet,2002,7139,3416,3723,748,4821,1570
734,082649,Sant Vicenç de Montalt,2002,4123,2099,2024,776,2944,403
735,082652,Sant Vicenç de Torelló,2002,1833,881,952,282,1130,421
736,082634,Sant Vicenç dels Horts,2002,25294,12775,12519,4161,18072,3061
737,431384,Santa Bàrbara,2002,3439,1730,1709,445,2153,841
738,082439,Santa Cecília de Voltregà,2002,207,116,91,29,136,42
739,082444,Santa Coloma de Cervelló,2002,5633,2839,2794,986,4003,644
740,171805,Santa Coloma de Farners,2002,9396,4801,4595,1431,6386,1579
741,082457,Santa Coloma de Gramenet,2002,115568,57760,57808,13938,84499,17131
742,431397,Santa Coloma de Queralt,2002,2831,1412,1419,391,1811,629
743,171812,Santa Cristina d'Aro,2002,3206,1687,1519,531,2193,482
744,082460,Santa Eugènia de Berga,2002,1999,1018,981,301,1405,293
745,082476,Santa Eulàlia de Riuprimer,2002,869,451,418,123,569,177
746,082482,Santa Eulàlia de Ronçana,2002,4988,2522,2466,697,3549,742
747,082495,Santa Fe del Penedès,2002,321,154,167,61,213,47
748,171827,Santa Llogaia d'Àlguema,2002,285,145,140,39,198,48
749,082508,Santa Margarida de Montbui,2002,9076,4540,4536,1366,6496,1214
750,082515,Santa Margarida i els Monjos,2002,5179,2682,2497,827,3697,655
751,082589,Santa Maria d'Oló,2002,998,508,490,88,672,238
752,082536,Santa Maria de Besora,2002,180,91,89,26,103,51
753,082567,Santa Maria de Martorelles,2002,698,341,357,124,472,102
754,082554,Santa Maria de Merlès,2002,156,83,73,18,99,39
755,082573,Santa Maria de Miralles,2002,98,48,50,10,64,24
756,082592,Santa Maria de Palautordera,2002,6826,3493,3333,1064,4755,1007
757,431401,Santa Oliva,2002,2286,1154,1132,350,1546,390
758,171848,Santa Pau,2002,1506,765,741,180,1015,311
759,082606,Santa Perpètua de Mogoda,2002,19486,9850,9636,2557,14856,2073
760,082613,Santa Susanna,2002,2258,1153,1105,365,1603,290
761,081923,Santpedor,2002,5477,2695,2782,789,3822,866
762,431423,Sarral,2002,1452,754,698,172,941,339
763,171864,Sarrià de Ter,2002,3730,1850,1880,483,2553,694
764,252017,Sarroca de Bellera,2002,156,84,72,10,88,58
765,252000,Sarroca de Lleida,2002,456,225,231,45,286,125
766,171870,"Saus, Camallera i Llampaies",2002,719,353,366,83,475,161
767,431439,Savallà del Comtat,2002,67,33,34,7,35,25
768,431444,"Secuita, la",2002,1175,601,574,167,800,208
769,171886,"Selva de Mar, la",2002,207,109,98,29,125,53
770,431457,"Selva del Camp, la",2002,4385,2199,2186,816,2810,759
771,431460,Senan,2002,33,23,10,6,21,6
772,430445,"Sénia, la",2002,5579,2933,2646,765,3822,992
773,252022,Senterada,2002,102,52,50,8,64,30
774,250352,"Sentiu de Sió, la",2002,472,232,240,40,297,135
775,082671,Sentmenat,2002,6037,3015,3022,921,4285,831
776,171903,Serinyà,2002,878,467,411,117,588,173
777,252043,Seròs,2002,1731,921,810,189,1068,474
778,171910,Serra de Daró,2002,178,94,84,22,97,59
779,171925,Setcases,2002,181,96,85,20,120,41
780,252038,"Seu d'Urgell, la",2002,11434,5590,5844,1615,7653,2166
781,082690,Seva,2002,2662,1362,1300,395,1845,422
782,252056,Sidamon,2002,577,296,281,66,405,106
783,171931,Sils,2002,3365,1692,1673,549,2272,544
784,082704,Sitges,2002,21377,10464,10913,3018,15148,3211
785,170524,Siurana,2002,190,98,92,16,126,48
786,082711,Sobremunt,2002,93,44,49,20,60,13
787,252069,"Soleràs, el",2002,438,235,203,30,271,137
788,431476,Solivella,2002,610,299,311,57,348,205
789,252075,Solsona,2002,7689,3856,3833,1130,5130,1429
790,082726,Sora,2002,189,102,87,29,116,44
791,252081,Soriguera,2002,325,164,161,39,197,89
792,252094,Sort,2002,1895,944,951,249,1240,406
793,252108,Soses,2002,1535,800,735,178,1031,326
794,082732,Subirats,2002,2623,1315,1308,396,1623,604
795,252115,Sudanell,2002,701,378,323,56,470,175
796,252120,Sunyer,2002,290,146,144,29,184,77
797,082747,Súria,2002,6148,3032,3116,822,3901,1425
798,171946,Susqueda,2002,100,54,46,10,70,20
799,082763,Tagamanent,2002,221,119,102,33,150,38
800,082779,Talamanca,2002,109,59,50,11,80,18
801,252154,Talarn,2002,351,178,173,40,228,83
802,252167,Talavera,2002,288,152,136,15,181,92
803,171959,"Tallada d'Empordà, la",2002,332,174,158,26,210,96
804,082785,Taradell,2002,5330,2675,2655,839,3627,864
805,431482,Tarragona,2002,117184,57337,59847,17060,81571,18553
806,252173,Tàrrega,2002,13210,6528,6682,1962,8869,2379
807,252189,Tarrés,2002,119,62,57,10,76,33
808,252192,Tarroja de Segarra,2002,173,87,86,14,92,67
809,082750,Tavèrnoles,2002,270,134,136,38,194,38
810,082802,Tavertet,2002,137,74,63,16,86,35
811,082819,Teià,2002,5581,2785,2796,969,4004,608
812,252206,Térmens,2002,1386,705,681,145,897,344
813,171962,Terrades,2002,182,87,95,11,108,63
814,082798,Terrassa,2002,179300,88425,90875,26657,123902,28741
815,082824,Tiana,2002,6201,3047,3154,1033,4445,723
816,252213,Tírvia,2002,120,63,57,9,81,30
817,252228,Tiurana,2002,32,20,12,4,17,11
818,431495,Tivenys,2002,928,468,460,85,565,278
819,431508,Tivissa,2002,1796,891,905,218,1089,489
820,082830,Tona,2002,6183,3093,3090,898,4270,1015
821,252234,Torà,2002,1220,622,598,150,776,294
822,082845,Tordera,2002,10325,5236,5089,1418,7153,1754
823,082858,Torelló,2002,12454,6146,6308,1691,8524,2239
824,252249,"Torms, els",2002,194,107,87,19,109,66
825,252252,Tornabous,2002,825,426,399,82,497,246
826,252271,"Torre de Cabdella, la",2002,670,341,329,36,410,224
827,082861,"Torre de Claramunt, la",2002,2595,1326,1269,439,1861,295
828,431515,"Torre de Fontaubella, la",2002,133,68,65,8,84,41
829,431520,"Torre de l'Espanyol, la",2002,744,388,356,79,458,207
830,252265,Torrebesses,2002,317,156,161,37,166,114
831,431536,Torredembarra,2002,11593,5796,5797,1789,8059,1745
832,252287,Torrefarrera,2002,2012,1035,977,238,1405,369
833,259078,Torrefeta i Florejacs,2002,653,335,318,68,386,199
834,252304,Torregrossa,2002,2195,1100,1095,240,1328,627
835,252311,Torrelameu,2002,601,334,267,57,388,156
836,082877,Torrelavit,2002,1152,595,557,127,752,273
837,082883,Torrelles de Foix,2002,1762,940,822,239,1163,360
838,082896,Torrelles de Llobregat,2002,3912,1990,1922,719,2799,394
839,171978,Torrent,2002,180,92,88,18,128,34
840,252326,Torres de Segre,2002,1854,955,899,226,1224,404
841,252332,Torre-serona,2002,347,178,169,35,237,75
842,171984,Torroella de Fluvià,2002,365,211,154,30,233,102
843,171997,Torroella de Montgrí,2002,9004,4584,4420,1406,6130,1468
844,431541,Torroja del Priorat,2002,143,85,58,9,95,39
845,172001,Tortellà,2002,713,359,354,82,429,202
846,431554,Tortosa,2002,30431,14983,15448,3967,20130,6334
847,172018,Toses,2002,151,94,57,25,87,39
848,172023,Tossa de Mar,2002,4608,2320,2288,590,3310,708
849,252347,Tremp,2002,5367,2660,2707,675,3208,1484
850,172044,Ullà,2002,880,476,404,128,618,134
851,082900,Ullastrell,2002,1230,633,597,201,844,185
852,172057,Ullastret,2002,230,117,113,20,162,48
853,431567,Ulldecona,2002,5843,3000,2843,744,3835,1264
854,431573,Ulldemolins,2002,494,260,234,37,290,167
855,172039,Ultramort,2002,203,115,88,18,122,63
856,172060,Urús,2002,195,103,92,28,130,37
857,082917,Vacarisses,2002,3181,1686,1495,475,2288,418
858,170144,"Vajol, la",2002,123,67,56,17,84,22
859,172076,"Vall d'en Bas, la",2002,2508,1273,1235,277,1568,663
860,172082,"Vall de Bianya, la",2002,1158,573,585,162,752,244
861,250432,"Vall de Boí, la",2002,910,497,413,102,648,160
862,259010,Vall de Cardós,2002,336,172,164,41,204,91
863,082922,Vallbona d'Anoia,2002,1079,547,532,146,724,209
864,252385,Vallbona de les Monges,2002,272,133,139,16,155,101
865,082938,Vallcebre,2002,266,138,128,25,167,74
866,431589,Vallclara,2002,111,60,51,11,62,38
867,252402,Vallfogona de Balaguer,2002,1528,775,753,177,1024,327
868,171707,Vallfogona de Ripollès,2002,214,113,101,19,140,55
869,431592,Vallfogona de Riucorb,2002,164,81,83,1,67,96
870,082943,Vallgorguina,2002,1516,800,716,238,1081,197
871,082956,Vallirana,2002,10493,5339,5154,1663,7489,1341
872,172095,Vall-llobrega,2002,452,177,275,65,343,44
873,431606,Vallmoll,2002,1300,684,616,173,932,195
874,082969,Vallromanes,2002,1595,823,772,295,1131,169
875,431613,Valls,2002,21048,10444,10604,3095,14229,3724
876,259062,"Valls d'Aguilar, les",2002,316,170,146,33,188,95
877,252398,"Valls de Valira, les",2002,803,431,372,81,521,201
878,431628,Vandellòs i l'Hospitalet de l'Infant,2002,4623,2313,2310,651,3248,724
879,259097,"Vansa i Fórnols, la",2002,182,93,89,17,112,53
880,082975,Veciana,2002,156,82,74,18,94,44
881,431634,"Vendrell, el",2002,24997,12600,12397,4126,17565,3306
882,172109,Ventalló,2002,663,349,314,67,427,169
883,252424,Verdú,2002,1067,505,562,97,622,348
884,172116,Verges,2002,1139,573,566,144,706,289
885,431649,Vespella de Gaià,2002,226,128,98,19,164,43
886,082981,Vic,2002,33935,16873,17062,4984,22851,6100
887,172121,Vidrà,2002,163,82,81,26,103,34
888,172137,Vidreres,2002,5287,2719,2568,809,3658,820
889,252430,Vielha e Mijaran,2002,4352,2241,2111,702,3200,450
890,431652,Vilabella,2002,793,405,388,98,506,189
891,172142,Vilabertran,2002,813,413,400,98,525,190
892,172155,Vilablareix,2002,2098,1053,1045,352,1553,193
893,082994,Vilada,2002,538,273,265,49,332,157
894,172174,Viladamat,2002,397,206,191,39,250,108
895,172168,Viladasens,2002,173,89,84,20,96,57
896,083015,Viladecans,2002,58213,29344,28869,9167,42959,6087
897,083008,Viladecavalls,2002,6304,3197,3107,1237,4532,535
898,172180,Vilademuls,2002,737,384,353,75,486,176
899,172207,Viladrau,2002,879,451,428,95,598,186
900,172214,Vilafant,2002,4359,2180,2179,745,3147,467
901,083054,Vilafranca del Penedès,2002,31939,15852,16087,4590,22375,4974
902,252445,Vilagrassa,2002,424,225,199,43,262,119
903,172235,Vilajuïga,2002,1002,500,502,154,675,173
904,431750,Vilalba dels Arcs,2002,742,387,355,75,429,238
905,083067,Vilalba Sasserra,2002,498,268,230,74,363,61
906,252458,Vilaller,2002,579,299,280,68,377,134
907,172240,Vilallonga de Ter,2002,432,237,195,31,271,130
908,431665,Vilallonga del Camp,2002,1255,625,630,167,852,236
909,172253,Vilamacolum,2002,281,149,132,35,178,68
910,172266,Vilamalla,2002,851,456,395,113,641,97
911,172272,Vilamaniscle,2002,140,77,63,21,77,42
912,252477,Vilamòs,2002,151,76,75,29,98,24
913,172288,Vilanant,2002,285,144,141,25,184,76
914,431671,Vilanova d'Escornalbou,2002,413,209,204,38,292,83
915,252483,Vilanova de Bellpuig,2002,1112,545,567,102,683,327
916,252496,Vilanova de l'Aguda,2002,264,134,130,29,148,87
917,252542,Vilanova de la Barca,2002,905,456,449,111,550,244
918,252509,Vilanova de Meià,2002,438,224,214,40,266,132
919,431687,Vilanova de Prades,2002,148,78,70,13,81,54
920,083036,Vilanova de Sau,2002,329,150,179,40,223,66
921,252516,Vilanova de Segrià,2002,800,402,398,88,553,159
922,083020,Vilanova del Camí,2002,10446,5265,5181,1764,7474,1208
923,089024,Vilanova del Vallès,2002,2604,1307,1297,443,1816,345
924,083073,Vilanova i la Geltrú,2002,55063,27142,27921,7857,38069,9137
925,431690,Vilaplana,2002,552,284,268,56,337,159
926,431704,Vila-rodona,2002,1043,573,470,102,680,261
927,172305,Vila-sacra,2002,414,209,205,37,303,74
928,252521,Vila-sana,2002,551,272,279,57,338,156
929,431711,Vila-seca,2002,13927,7014,6913,2162,10082,1683
930,082140,Vilassar de Dalt,2002,7752,3858,3894,924,5557,1271
931,082191,Vilassar de Mar,2002,17721,8691,9030,2749,12578,2394
932,172229,Vilaür,2002,123,69,54,12,88,23
933,431726,Vilaverd,2002,386,197,189,36,237,113
934,431732,"Vilella Alta, la",2002,116,62,54,7,68,41
935,431747,"Vilella Baixa, la",2002,179,97,82,8,115,56
936,172333,Vilobí d'Onyar,2002,2328,1252,1076,318,1616,394
937,083041,Vilobí del Penedès,2002,921,477,444,117,616,188
938,172327,Vilopriu,2002,152,77,75,10,87,55
939,252537,"Vilosell, el",2002,194,91,103,10,117,67
940,431763,Vimbodí i Poblet,2002,1053,578,475,91,644,318
941,252555,Vinaixa,2002,618,309,309,64,381,173
942,431779,Vinebre,2002,459,238,221,30,304,125
943,431785,Vinyols i els Arcs,2002,1323,693,630,170,929,224
944,083089,Viver i Serrateix,2002,194,100,94,18,126,50
945,430521,Xerta,2002,1212,600,612,135,743,334
946,000000,Catalunya,2002,6506440,3201029,3305411,889097,4487305,1130038
0,250019,Abella de la Conca,2003,183,99,84,28,114,41
1,080018,Abrera,2003,9166,4753,4413,1441,6877,848
2,250024,Àger,2003,497,272,225,32,277,188
3,250030,Agramunt,2003,5071,2637,2434,718,3307,1046
4,080023,Aguilar de Segarra,2003,224,117,107,28,133,63
5,170010,Agullana,2003,723,369,354,83,450,190
6,080142,Aiguafreda,2003,2206,1075,1131,279,1490,437
7,430017,Aiguamúrcia,2003,672,355,317,65,455,152
8,170025,Aiguaviva,2003,587,295,292,106,396,85
9,250387,Aitona,2003,2218,1123,1095,229,1428,561
10,250045,"Alamús, els",2003,691,350,341,72,452,167
11,250058,Alàs i Cerc,2003,396,215,181,39,256,101
12,250061,"Albagés, l'",2003,512,272,240,63,305,144
13,170031,Albanyà,2003,116,62,54,15,74,27
14,250077,Albatàrrec,2003,1306,673,633,191,873,242
15,250083,Albesa,2003,1523,768,755,186,962,375
16,250096,"Albi, l'",2003,826,426,400,87,531,208
17,430022,Albinyana,2003,1780,913,867,215,1247,318
18,430038,"Albiol, l'",2003,230,121,109,41,157,32
19,170046,Albons,2003,607,322,285,77,404,126
20,430043,Alcanar,2003,8738,4441,4297,1109,5862,1767
21,250100,Alcanó,2003,258,130,128,29,142,87
22,250117,Alcarràs,2003,4903,2458,2445,681,3241,981
23,250122,Alcoletge,2003,1899,1000,899,262,1316,321
24,430056,Alcover,2003,4197,2145,2052,653,2818,726
25,439044,"Aldea, l'",2003,3590,1857,1733,425,2353,812
26,430069,Aldover,2003,814,387,427,67,511,236
27,430075,"Aleixar, l'",2003,750,381,369,111,461,178
28,080039,Alella,2003,8847,4408,4439,1339,6455,1053
29,430081,Alfara de Carles,2003,377,198,179,30,233,114
30,250138,Alfarràs,2003,2881,1421,1460,331,1878,672
31,250143,Alfés,2003,320,168,152,33,201,86
32,430094,Alforja,2003,1393,717,676,179,867,347
33,250156,Algerri,2003,507,256,251,35,303,169
34,250169,Alguaire,2003,2872,1468,1404,361,1891,620
35,250175,Alins,2003,270,136,134,21,156,93
36,430108,Alió,2003,376,185,191,38,238,100
37,250194,Almacelles,2003,5702,2913,2789,722,3801,1179
38,250208,Almatret,2003,461,239,222,35,246,180
39,250215,Almenar,2003,3481,1793,1688,431,2258,792
40,430115,Almoster,2003,1017,521,496,197,695,125
41,250220,Alòs de Balaguer,2003,167,99,68,9,100,58
42,170062,Alp,2003,1297,685,612,162,974,161
43,080044,Alpens,2003,287,154,133,46,175,66
44,250236,Alpicat,2003,4672,2335,2337,804,3239,629
45,250241,Alt Àneu,2003,414,235,179,55,268,91
46,430120,Altafulla,2003,3710,1896,1814,614,2677,419
47,170078,Amer,2003,2189,1075,1114,246,1419,524
48,430136,"Ametlla de Mar, l'",2003,5835,3013,2822,741,4009,1085
49,080057,"Ametlla del Vallès, l'",2003,6757,3364,3393,1294,4699,764
50,439060,"Ampolla, l'",2003,2133,1071,1062,248,1370,515
51,430141,Amposta,2003,17759,8912,8847,2452,12098,3209
52,170084,Anglès,2003,5049,2606,2443,648,3355,1046
53,250273,Anglesola,2003,1273,650,623,125,804,344
54,250292,Arbeca,2003,2295,1163,1132,243,1424,628
55,430167,"Arboç, l'",2003,3977,2080,1897,580,2764,633
56,430154,Arbolí,2003,122,65,57,2,92,28
57,170097,Arbúcies,2003,5599,2953,2646,852,3746,1001
58,080060,Arenys de Mar,2003,13431,6549,6882,1911,9038,2482
59,080076,Arenys de Munt,2003,6977,3509,3468,1121,4817,1039
60,170101,Argelaguer,2003,406,217,189,71,231,104
61,080082,Argençola,2003,202,110,92,22,134,46
62,430173,"Argentera, l'",2003,154,87,67,16,107,31
63,080095,Argentona,2003,10302,5137,5165,1664,7183,1455
64,170118,"Armentera, l'",2003,747,373,374,64,485,198
65,430189,Arnes,2003,501,258,243,37,272,192
66,250313,Arres,2003,63,37,26,8,40,15
67,250328,Arsèguel,2003,98,52,46,11,63,24
68,080109,Artés,2003,4696,2364,2332,662,3148,886
69,250334,Artesa de Lleida,2003,1318,681,637,169,829,320
70,250349,Artesa de Segre,2003,3413,1782,1631,422,2185,806
71,430192,Ascó,2003,1635,828,807,190,1051,394
72,250365,Aspa,2003,269,134,135,27,149,93
73,250371,"Avellanes i Santa Linya, les",2003,475,262,213,31,281,163
74,080116,Avià,2003,1935,978,957,249,1246,440
75,080121,Avinyó,2003,2049,1024,1025,310,1284,455
76,170123,Avinyonet de Puigventós,2003,955,481,474,145,698,112
77,080137,Avinyonet del Penedès,2003,1334,720,614,169,889,276
78,080155,Badalona,2003,214440,106935,107505,29668,153510,31262
79,089045,Badia del Vallès,2003,14553,7272,7281,2151,10554,1848
80,080168,Bagà,2003,2119,1026,1093,257,1331,531
81,250390,Baix Pallars,2003,360,203,157,23,221,116
82,250404,Balaguer,2003,14068,6947,7121,2089,9277,2702
83,080174,Balenyà,2003,3280,1638,1642,509,2269,502
84,080180,Balsareny,2003,3256,1609,1647,396,2134,726
85,430206,Banyeres del Penedès,2003,1862,1003,859,238,1377,247
86,170157,Banyoles,2003,16244,8077,8167,2713,10563,2968
87,250411,Barbens,2003,795,404,391,73,488,234
88,430213,Barberà de la Conca,2003,434,221,213,44,276,114
89,082520,Barberà del Vallès,2003,27153,13642,13511,4244,20024,2885
90,080193,Barcelona,2003,1582738,748149,834589,183265,1063232,336241
91,250426,"Baronia de Rialb, la",2003,285,149,136,41,161,83
92,170160,Bàscara,2003,844,436,408,90,560,194
93,250447,Bassella,2003,265,135,130,32,151,82
94,430228,Batea,2003,2063,1046,1017,220,1282,561
95,250450,Bausen,2003,51,30,21,2,20,29
96,080207,Begues,2003,5023,2516,2507,1074,3460,489
97,170139,Begur,2003,3748,1913,1835,580,2572,596
98,250463,Belianes,2003,611,309,302,84,332,195
99,251706,Bellaguarda,2003,351,175,176,36,189,126
100,170182,Bellcaire d'Empordà,2003,619,331,288,78,407,134
101,250479,Bellcaire d'Urgell,2003,1215,580,635,105,717,393
102,250485,Bell-lloc d'Urgell,2003,2068,1028,1040,249,1333,486
103,250498,Bellmunt d'Urgell,2003,232,112,120,31,135,66
104,430234,Bellmunt del Priorat,2003,304,152,152,21,169,114
105,080214,Bellprat,2003,92,51,41,10,56,26
106,250501,Bellpuig,2003,4224,2144,2080,554,2784,886
107,430249,Bellvei,2003,1532,812,720,225,1059,248
108,250518,Bellver de Cerdanya,2003,1689,897,792,175,1154,360
109,250523,Bellvís,2003,2137,1081,1056,218,1286,633
110,250539,Benavent de Segrià,2003,1077,559,518,169,750,158
111,430252,Benifallet,2003,843,417,426,92,473,278
112,430265,Benissanet,2003,1124,601,523,119,723,282
113,080229,Berga,2003,15437,7591,7846,1865,10021,3551
114,170195,Besalú,2003,2112,1029,1083,242,1348,522
115,170209,Bescanó,2003,3525,1762,1763,558,2343,624
116,170216,Beuda,2003,139,76,63,17,99,23
117,080235,Bigues i Riells del Fai,2003,6400,3345,3055,1089,4639,672
118,250557,Biosca,2003,241,125,116,29,139,73
119,170221,"Bisbal d'Empordà, la",2003,8651,4317,4334,1258,5790,1603
120,430271,"Bisbal de Falset, la",2003,250,129,121,27,145,78
121,430287,"Bisbal del Penedès, la",2003,2349,1251,1098,333,1600,416
122,172348,Biure,2003,232,116,116,30,153,49
123,430290,Blancafort,2003,412,221,191,50,235,127
124,170237,Blanes,2003,34477,17386,17091,5239,24261,4977
125,170293,Boadella i les Escaules,2003,236,115,121,25,154,57
126,170242,Bolvir,2003,271,140,131,26,192,53
127,430304,Bonastre,2003,424,225,199,52,287,85
128,250576,"Bòrdes, Es",2003,218,111,107,20,162,36
129,170255,Bordils,2003,1422,711,711,221,933,268
130,250582,"Borges Blanques, les",2003,5365,2696,2669,700,3477,1188
131,430311,"Borges del Camp, les",2003,1686,846,840,218,1129,339
132,170268,Borrassà,2003,524,265,259,41,345,138
133,080240,Borredà,2003,498,257,241,69,318,111
134,250595,Bossòst,2003,1011,520,491,144,698,169
135,430326,Bot,2003,793,402,391,58,461,274
136,430332,Botarell,2003,831,437,394,130,594,107
137,250560,Bovera,2003,378,187,191,19,211,148
138,430347,Bràfim,2003,600,296,304,55,393,152
139,170274,Breda,2003,3543,1816,1727,512,2387,644
140,080253,"Bruc, el",2003,1379,723,656,214,959,206
141,080266,"Brull, el",2003,195,106,89,20,134,41
142,170280,Brunyola i Sant Martí Sapresa,2003,362,184,178,33,210,119
143,430350,Cabacés,2003,345,182,163,31,205,109
144,250609,Cabanabona,2003,96,45,51,10,50,36
145,170314,Cabanelles,2003,240,136,104,25,154,61
146,170307,Cabanes,2003,811,428,383,95,550,166
147,080272,"Cabanyes, les",2003,603,313,290,93,411,99
148,250616,Cabó,2003,115,63,52,8,67,40
149,430363,Cabra del Camp,2003,709,373,336,93,472,144
150,080288,Cabrera d'Anoia,2003,727,399,328,97,520,110
151,080291,Cabrera de Mar,2003,3869,1957,1912,627,2755,487
152,080305,Cabrils,2003,5703,2786,2917,1133,4014,556
153,170329,Cadaqués,2003,2612,1271,1341,368,1826,418
154,080312,Calaf,2003,3110,1601,1509,384,2112,614
155,430379,Calafell,2003,15883,8013,7870,2144,11419,2320
156,080348,Calders,2003,781,396,385,130,499,152
157,080327,Caldes d'Estrac,2003,2310,1134,1176,322,1559,429
158,170335,Caldes de Malavella,2003,4602,2322,2280,685,3096,821
159,080333,Caldes de Montbui,2003,13803,6886,6917,1909,9649,2245
160,080351,Calella,2003,15400,7576,7824,2147,10590,2663
161,080370,Calldetenes,2003,2098,1098,1000,327,1466,305
162,080386,Callús,2003,1417,698,719,163,930,324
163,080364,Calonge de Segarra,2003,192,98,94,22,104,66
164,170340,Calonge i Sant Antoni,2003,8282,4192,4090,1266,5669,1347
165,250621,Camarasa,2003,886,460,426,67,525,294
166,439039,Camarles,2003,3060,1546,1514,389,2001,670
167,430385,Cambrils,2003,23555,11797,11758,3778,16929,2848
168,170353,Camós,2003,661,344,317,82,428,151
169,170366,Campdevànol,2003,3374,1661,1713,371,2161,842
170,170372,Campelles,2003,124,66,58,10,82,32
171,080399,Campins,2003,313,159,154,55,222,36
172,170388,Campllong,2003,338,173,165,59,211,68
173,170391,Camprodon,2003,2343,1154,1189,237,1529,577
174,250637,Canejan,2003,105,52,53,11,60,34
175,170405,Canet d'Adri,2003,519,271,248,54,367,98
176,080403,Canet de Mar,2003,11722,5812,5910,1608,8045,2069
177,080410,Canovelles,2003,13701,7034,6667,2032,9896,1773
178,080425,Cànoves i Samalús,2003,2155,1134,1021,336,1543,276
179,170412,Cantallops,2003,265,126,139,26,157,82
180,080431,Canyelles,2003,2485,1327,1158,379,1819,287
181,430398,Capafonts,2003,119,63,56,4,78,37
182,430402,Capçanes,2003,401,188,213,34,257,110
183,080446,Capellades,2003,5111,2509,2602,706,3473,932
184,170427,Capmany,2003,481,250,231,57,301,123
185,080459,Capolat,2003,70,35,35,6,44,20
186,080462,Cardedeu,2003,13870,6917,6953,2383,9751,1736
187,080478,Cardona,2003,5312,2589,2723,556,3390,1366
188,080484,Carme,2003,721,371,350,81,464,176
189,430419,Caseres,2003,323,157,166,37,178,108
190,170448,Cassà de la Selva,2003,8150,4124,4026,1253,5336,1561
191,080497,Casserres,2003,1547,751,796,147,958,442
192,080575,Castell de l'Areny,2003,66,37,29,8,46,12
193,259046,Castell de Mur,2003,156,83,73,16,86,54
194,250642,Castellar de la Ribera,2003,162,80,82,23,94,45
195,080522,Castellar de n'Hug,2003,197,105,92,15,132,50
196,080500,Castellar del Riu,2003,138,80,58,24,89,25
197,080517,Castellar del Vallès,2003,18934,9482,9452,3276,13247,2411
198,080538,Castellbell i el Vilar,2003,3080,1580,1500,384,2082,614
199,080543,Castellbisbal,2003,9791,5042,4749,1872,6975,944
200,080556,Castellcir,2003,452,243,209,73,296,83
201,250674,Castelldans,2003,962,505,457,107,572,283
202,080569,Castelldefels,2003,52405,26201,26204,8543,38674,5188
203,080581,Castellet i la Gornal,2003,1562,794,768,213,1036,313
204,170464,Castellfollit de la Roca,2003,984,500,484,114,607,263
205,080608,Castellfollit de Riubregós,2003,217,108,109,28,136,53
206,080594,Castellfollit del Boix,2003,389,193,196,63,233,93
207,080615,Castellgalí,2003,1066,559,507,148,714,204
208,080620,Castellnou de Bages,2003,670,357,313,102,499,69
209,250680,Castellnou de Seana,2003,697,362,335,78,427,192
210,170470,Castelló d'Empúries,2003,8165,4232,3933,1252,5478,1435
211,250693,Castelló de Farfanya,2003,570,285,285,54,337,179
212,080636,Castellolí,2003,441,223,218,66,290,85
213,170486,Castell-Platja d'Aro,2003,7905,4013,3892,1066,5805,1034
214,250707,Castellserà,2003,1123,565,558,123,684,316
215,080641,Castellterçol,2003,2168,1063,1105,295,1399,474
216,430424,Castellvell del Camp,2003,1722,855,867,314,1217,191
217,080654,Castellví de la Marca,2003,1497,762,735,192,976,329
218,080667,Castellví de Rosanes,2003,1281,653,628,217,911,153
219,430430,"Catllar, el",2003,2847,1470,1377,458,2051,338
220,250714,Cava,2003,54,30,24,4,32,18
221,171899,"Cellera de Ter, la",2003,2064,1048,1016,277,1370,417
222,170499,Celrà,2003,3072,1526,1546,540,2089,443
223,080673,Centelles,2003,6155,3039,3116,859,4109,1187
224,082687,Cercs,2003,1376,699,677,152,842,382
225,082665,Cerdanyola del Vallès,2003,55731,27868,27863,8177,41329,6225
226,080689,Cervelló,2003,6848,3483,3365,1082,4979,787
227,250729,Cervera,2003,8424,4350,4074,1308,5630,1486
228,250735,Cervià de les Garrigues,2003,842,437,405,76,506,260
229,170502,Cervià de Ter,2003,702,348,354,105,428,169
230,170519,Cistella,2003,232,117,115,27,144,61
231,250740,Ciutadilla,2003,233,122,111,24,139,70
232,250753,Clariana de Cardener,2003,153,80,73,24,111,18
233,250766,"Cogul, el",2003,224,120,104,16,128,80
234,170545,Colera,2003,613,307,306,55,402,156
235,250772,Coll de Nargó,2003,577,303,274,60,353,164
236,080692,Collbató,2003,2752,1465,1287,473,1996,283
237,430458,Colldejou,2003,192,103,89,14,140,38
238,080706,Collsuspina,2003,283,151,132,37,207,39
239,170558,Colomers,2003,206,104,102,9,125,72
240,251636,"Coma i la Pedra, la",2003,242,148,94,20,164,58
241,251615,Conca de Dalt,2003,426,217,209,36,250,140
242,430461,Conesa,2003,123,68,55,13,76,34
243,430477,Constantí,2003,5314,2804,2510,777,3741,796
244,080713,Copons,2003,281,136,145,25,175,81
245,430483,Corbera d'Ebre,2003,1040,548,492,111,630,299
246,080728,Corbera de Llobregat,2003,10903,5565,5338,1926,7811,1166
247,250788,Corbins,2003,1133,581,552,146,732,255
248,170577,Corçà,2003,1174,596,578,133,817,224
249,080734,Cornellà de Llobregat,2003,82817,41066,41751,10823,58302,13692
250,170561,Cornellà del Terri,2003,1918,967,951,248,1276,394
251,430496,Cornudella de Montsant,2003,863,444,419,74,540,249
252,430509,Creixell,2003,2326,1191,1135,322,1565,439
253,170583,Crespià,2003,231,110,121,26,137,68
254,179011,"Cruïlles, Monells i Sant Sadurní de l'Heura",2003,1168,584,584,155,810,203
255,080749,Cubelles,2003,8548,4344,4204,1264,6092,1192
256,250791,Cubells,2003,381,189,192,47,199,135
257,430516,Cunit,2003,7339,3817,3522,1005,5222,1112
258,170600,Darnius,2003,519,269,250,43,333,143
259,170617,Das,2003,159,87,72,15,113,31
260,439018,Deltebre,2003,10697,5394,5303,1351,7195,2151
261,080752,Dosrius,2003,3504,1768,1736,550,2604,350
262,430537,Duesaigües,2003,187,112,75,9,115,63
263,170622,"Escala, l'",2003,6997,3545,3452,737,5012,1248
264,080765,Esparreguera,2003,19403,9865,9538,3161,13857,2385
265,170638,Espinelves,2003,191,101,90,15,118,58
266,250812,"Espluga Calba, l'",2003,429,233,196,34,274,121
267,430542,"Espluga de Francolí, l'",2003,3687,1844,1843,500,2322,865
268,080771,Esplugues de Llobregat,2003,46447,22826,23621,5697,33928,6822
269,170643,Espolla,2003,374,185,189,39,222,113
270,170656,Esponellà,2003,422,209,213,53,291,78
271,250827,Espot,2003,339,181,158,43,232,64
272,080787,"Espunyola, l'",2003,270,138,132,36,164,70
273,082541,"Esquirol, l'",2003,2247,1101,1146,321,1418,508
274,250886,Estamariu,2003,125,70,55,6,80,39
275,080790,"Estany, l'",2003,408,194,214,38,247,123
276,250851,Estaràs,2003,193,106,87,24,115,54
277,250864,Esterri d'Àneu,2003,705,349,356,83,463,159
278,250870,Esterri de Cardós,2003,75,36,39,7,45,23
279,430555,Falset,2003,2595,1319,1276,364,1670,561
280,170059,"Far d'Empordà, el",2003,404,209,195,59,262,83
281,250899,Farrera,2003,106,61,45,8,77,21
282,430568,"Fatarella, la",2003,1184,597,587,107,708,369
283,430574,"Febró, la",2003,60,40,20,2,48,10
284,081347,Figaró-Montmany,2003,957,491,466,132,627,198
285,080804,Fígols,2003,50,29,21,3,30,17
286,259084,Fígols i Alinyà,2003,275,149,126,12,163,100
287,430580,"Figuera, la",2003,140,74,66,18,82,40
288,170669,Figueres,2003,36338,17713,18625,5669,24508,6161
289,430593,Figuerola del Camp,2003,292,138,154,41,187,64
290,170675,Flaçà,2003,900,457,443,102,598,200
291,430607,Flix,2003,4051,2045,2006,459,2633,959
292,250925,"Floresta, la",2003,186,100,86,19,98,69
293,080826,Fogars de la Selva,2003,920,488,432,142,635,143
294,080811,Fogars de Montclús,2003,368,200,168,49,252,67
295,170681,Foixà,2003,303,149,154,44,178,81
296,080832,Folgueroles,2003,1778,885,893,306,1204,268
297,250931,Fondarella,2003,721,364,357,97,501,123
298,080847,Fonollosa,2003,1097,562,535,164,751,182
299,170694,Fontanals de Cerdanya,2003,419,198,221,47,287,85
300,170708,Fontanilles,2003,165,95,70,13,121,31
301,170715,Fontcoberta,2003,1152,558,594,181,808,163
302,080850,Font-rubí,2003,1297,686,611,172,806,319
303,250946,Foradada,2003,209,119,90,10,139,60
304,179026,Forallac,2003,1684,818,866,184,1180,320
305,430614,Forès,2003,60,31,29,0,36,24
306,170736,Fornells de la Selva,2003,1691,819,872,309,1173,209
307,170741,Fortià,2003,534,262,272,63,349,122
308,080863,"Franqueses del Vallès, les",2003,14121,7163,6958,2229,10235,1657
309,430629,Freginals,2003,391,202,189,38,238,115
310,250962,"Fuliola, la",2003,1227,620,607,139,765,323
311,250978,Fulleda,2003,113,60,53,12,63,38
312,080902,Gaià,2003,155,78,77,25,105,25
313,430635,"Galera, la",2003,754,378,376,75,456,223
314,080879,Gallifa,2003,200,104,96,36,137,27
315,430640,Gandesa,2003,2805,1440,1365,342,1824,639
316,430653,Garcia,2003,505,262,243,38,302,165
317,430666,"Garidells, els",2003,173,90,83,19,113,41
318,080885,"Garriga, la",2003,12634,6153,6481,2139,8655,1840
319,170754,Garrigàs,2003,313,173,140,30,196,87
320,170767,Garrigoles,2003,144,75,69,16,90,38
321,170773,Garriguella,2003,702,364,338,78,447,177
322,080898,Gavà,2003,42304,21173,21131,6500,30247,5557
323,250984,Gavet de la Conca,2003,303,147,156,28,165,110
324,080919,Gelida,2003,4929,2510,2419,721,3399,809
325,170789,Ger,2003,376,200,176,41,263,72
326,259123,Gimenells i el Pla de la Font,2003,1079,560,519,125,689,265
327,430672,Ginestar,2003,893,458,435,85,535,273
328,170792,Girona,2003,81220,39266,41954,13007,56216,11997
329,080924,Gironella,2003,4908,2408,2500,466,3126,1316
330,080930,Gisclareny,2003,30,17,13,1,26,3
331,430688,Godall,2003,728,378,350,61,434,233
332,250997,Golmés,2003,1433,719,714,179,970,284
333,170806,Gombrèn,2003,239,113,126,22,162,55
334,251001,Gósol,2003,225,119,106,16,153,56
335,080945,"Granada, la",2003,1479,735,744,223,1001,255
336,251018,"Granadella, la",2003,777,398,379,75,436,266
337,080958,Granera,2003,77,48,29,1,56,20
338,251023,"Granja d'Escarp, la",2003,1059,566,493,111,685,263
339,080961,Granollers,2003,55913,27710,28203,8279,39652,7982
340,251039,Granyanella,2003,146,77,69,9,96,41
341,251057,Granyena de les Garrigues,2003,165,92,73,10,98,57
342,251044,Granyena de Segarra,2003,147,77,70,4,84,59
343,430691,Gratallops,2003,223,122,101,25,145,53
344,080977,Gualba,2003,912,471,441,131,643,138
345,170813,Gualta,2003,321,181,140,51,207,63
346,080996,Guardiola de Berguedà,2003,937,482,455,106,568,263
347,430705,"Guiamets, els",2003,311,163,148,36,184,91
348,170828,Guils de Cerdanya,2003,347,172,175,35,254,58
349,251095,Guimerà,2003,346,174,172,19,187,140
350,259031,"Guingueta d'Àneu, la",2003,342,182,160,45,217,80
351,251109,Guissona,2003,4138,2194,1944,675,2908,555
352,251116,Guixers,2003,165,98,67,10,115,40
353,081000,Gurb,2003,2049,1041,1008,348,1415,286
354,430712,Horta de Sant Joan,2003,1189,630,559,129,710,350
355,081017,"Hospitalet de Llobregat, l'",2003,246415,120707,125708,28221,174173,44021
356,081629,"Hostalets de Pierola, els",2003,1611,834,777,218,1114,279
357,170834,Hostalric,2003,3019,1496,1523,413,2130,476
358,081022,Igualada,2003,34391,16926,17465,4851,23270,6270
359,251155,Isona i Conca Dellà,2003,1197,648,549,113,710,374
360,170849,Isòvol,2003,205,115,90,12,140,53
361,251137,Ivars d'Urgell,2003,1781,914,867,193,1118,470
362,251121,Ivars de Noguera,2003,340,175,165,28,220,92
363,251142,Ivorra,2003,155,73,82,15,89,51
364,170852,Jafre,2003,348,184,164,34,209,105
365,170865,"Jonquera, la",2003,2849,1450,1399,407,2071,371
366,081038,Jorba,2003,599,286,313,113,349,137
367,259101,Josa i Tuixén,2003,181,100,81,15,118,48
368,170871,Juià,2003,262,128,134,28,167,67
369,251180,Juncosa,2003,589,338,251,63,348,178
370,251193,Juneda,2003,2992,1524,1468,327,1934,731
371,251214,Les,2003,676,336,340,78,467,131
372,251229,Linyola,2003,2464,1242,1222,316,1615,533
373,081043,"Llacuna, la",2003,884,475,409,107,567,210
374,170887,Lladó,2003,541,277,264,72,337,132
375,251235,Lladorre,2003,215,111,104,17,141,57
376,251240,Lladurs,2003,220,115,105,29,144,47
377,081056,"Llagosta, la",2003,12630,6346,6284,1738,9243,1649
378,170890,Llagostera,2003,6293,3233,3060,938,4178,1177
379,170904,Llambilles,2003,504,257,247,69,342,93
380,170911,Llanars,2003,511,274,237,47,352,112
381,170926,Llançà,2003,4232,2105,2127,511,2766,955
382,251253,Llardecans,2003,595,311,284,63,343,189
383,251266,Llavorsí,2003,295,148,147,33,184,78
384,251207,Lleida,2003,118035,57736,60299,17175,80968,19892
385,170932,Llers,2003,1068,536,532,144,723,201
386,251272,Lles de Cerdanya,2003,256,147,109,23,162,71
387,081075,Lliçà d'Amunt,2003,11435,5904,5531,2014,8186,1235
388,081081,Lliçà de Vall,2003,5529,2860,2669,887,4049,593
389,251288,Llimiana,2003,158,84,74,6,103,49
390,081069,Llinars del Vallès,2003,7631,3833,3798,1269,5349,1013
391,170947,Llívia,2003,1160,617,543,124,843,193
392,430727,"Lloar, el",2003,114,58,56,4,67,43
393,251291,Llobera,2003,223,119,104,20,140,63
394,430733,Llorac,2003,128,59,69,12,80,36
395,430748,Llorenç del Penedès,2003,1821,891,930,300,1199,322
396,170950,Lloret de Mar,2003,25457,13111,12346,3982,18682,2793
397,170963,"Llosses, les",2003,262,142,120,26,186,50
398,081094,Lluçà,2003,263,143,120,43,164,56
399,171024,Maçanet de Cabrenys,2003,700,361,339,69,431,200
400,171030,Maçanet de la Selva,2003,4524,2308,2216,708,3149,667
401,170979,Madremanya,2003,188,84,104,16,130,42
402,170985,Maià de Montcal,2003,346,182,164,37,236,73
403,251333,Maials,2003,947,481,466,84,545,318
404,251305,Maldà,2003,266,134,132,23,145,98
405,081108,Malgrat de Mar,2003,15614,7862,7752,2194,10800,2620
406,081115,Malla,2003,250,116,134,31,175,44
407,081120,Manlleu,2003,18549,9440,9109,2873,12499,3177
408,081136,Manresa,2003,67269,32913,34356,8579,44273,14417
409,430764,Marçà,2003,596,298,298,56,356,184
410,430751,Margalef,2003,124,65,59,9,69,46
411,082423,Marganell,2003,245,112,133,29,147,69
412,081141,Martorell,2003,24549,12663,11886,3868,17353,3328
413,081154,Martorelles,2003,4915,2466,2449,694,3452,769
414,430770,Mas de Barberans,2003,687,348,339,64,420,203
415,171002,Masarac,2003,251,119,132,31,145,75
416,430786,Masdenverge,2003,1005,531,474,127,643,235
417,081167,"Masies de Roda, les",2003,697,344,353,99,472,126
418,081173,"Masies de Voltregà, les",2003,2922,1433,1489,452,2015,455
419,430799,Masllorenç,2003,453,228,225,52,281,120
420,081189,"Masnou, el",2003,21001,10170,10831,3084,14831,3086
421,430803,"Masó, la",2003,287,143,144,29,193,65
422,430810,Maspujols,2003,496,257,239,65,310,121
423,081192,Masquefa,2003,6209,3191,3018,1079,4387,743
424,430825,"Masroig, el",2003,519,249,270,45,299,175
425,251312,Massalcoreig,2003,607,301,306,71,354,182
426,171019,Massanes,2003,567,304,263,63,393,111
427,251327,Massoteres,2003,206,107,99,24,127,55
428,081206,Matadepera,2003,7423,3740,3683,1501,5099,823
429,081213,Mataró,2003,111879,55707,56172,16395,78796,16688
430,081228,Mediona,2003,1638,855,783,196,1093,349
431,251348,Menàrguens,2003,830,422,408,85,501,244
432,170998,Meranges,2003,81,50,31,0,57,24
433,171058,Mieres,2003,347,181,166,55,211,81
434,430831,"Milà, el",2003,160,74,86,16,104,40
435,251351,Miralcamp,2003,1248,617,631,145,836,267
436,430846,Miravet,2003,781,414,367,85,484,212
437,081385,Moià,2003,4647,2321,2326,759,3065,823
438,430859,"Molar, el",2003,293,155,138,29,167,97
439,081234,Molins de Rei,2003,21958,10829,11129,3161,15513,3284
440,251370,Mollerussa,2003,10625,5388,5237,1722,7294,1609
441,171061,Mollet de Peralada,2003,172,90,82,14,96,62
442,081249,Mollet del Vallès,2003,50001,25332,24669,7903,36591,5507
443,171077,Molló,2003,333,167,166,20,216,97
444,251364,"Molsosa, la",2003,119,60,59,15,75,29
445,081287,Monistrol de Calders,2003,623,309,314,89,402,132
446,081271,Monistrol de Montserrat,2003,2559,1296,1263,291,1712,556
447,171096,Montagut i Oix,2003,839,434,405,106,519,214
448,430862,Montblanc,2003,6388,3184,3204,881,4305,1202
449,430884,Montbrió del Camp,2003,1535,778,757,213,957,365
450,081252,Montcada i Reixac,2003,30354,15033,15321,4613,21347,4394
451,081304,Montclar,2003,121,62,59,19,73,29
452,251399,Montellà i Martinet,2003,531,283,248,55,321,155
453,081311,Montesquiu,2003,851,434,417,93,538,220
454,251403,Montferrer i Castellbò,2003,766,416,350,71,531,164
455,430897,Montferri,2003,163,91,72,13,97,53
456,251386,Montgai,2003,819,413,406,101,475,243
457,081265,Montgat,2003,8775,4368,4407,1240,6353,1182
458,081326,Montmajor,2003,457,239,218,48,306,103
459,081332,Montmaneu,2003,193,101,92,15,125,53
460,430901,"Montmell, el",2003,784,434,350,112,547,125
461,081350,Montmeló,2003,8754,4419,4335,1321,6307,1126
462,251425,Montoliu de Lleida,2003,456,226,230,35,301,120
463,251410,Montoliu de Segarra,2003,188,104,84,8,118,62
464,251431,Montornès de Segarra,2003,98,46,52,3,56,39
465,081363,Montornès del Vallès,2003,13484,6916,6568,2087,9843,1554
466,430918,Mont-ral,2003,166,93,73,13,136,17
467,171100,Mont-ras,2003,1749,914,835,255,1260,234
468,430923,Mont-roig del Camp,2003,7897,4070,3827,1018,5638,1241
469,081379,Montseny,2003,310,161,149,27,221,62
470,430939,Móra d'Ebre,2003,4847,2390,2457,707,3168,972
471,430944,Móra la Nova,2003,3084,1590,1494,444,2049,591
472,430957,"Morell, el",2003,2420,1240,1180,408,1632,380
473,430960,"Morera de Montsant, la",2003,176,95,81,26,114,36
474,081290,Muntanyola,2003,361,196,165,62,251,48
475,081398,Mura,2003,225,118,107,23,148,54
476,251459,Nalec,2003,92,43,49,6,48,38
477,250254,Naut Aran,2003,1543,805,738,218,1128,197
478,081402,Navarcles,2003,5442,2698,2744,741,3654,1047
479,081419,Navàs,2003,5629,2798,2831,743,3644,1242
480,171117,Navata,2003,793,394,399,125,493,175
481,251462,Navès,2003,274,133,141,32,168,74
482,081424,"Nou de Berguedà, la",2003,155,79,76,26,91,38
483,430976,"Nou de Gaià, la",2003,404,210,194,50,257,97
484,430982,Nulles,2003,379,181,198,35,248,96
485,251484,Odèn,2003,273,154,119,24,169,80
486,081430,Òdena,2003,2737,1365,1372,410,1856,471
487,171122,Ogassa,2003,255,147,108,26,176,53
488,081458,Olèrdola,2003,2578,1335,1243,433,1771,374
489,081461,Olesa de Bonesvalls,2003,1173,622,551,158,853,162
490,081477,Olesa de Montserrat,2003,19800,10056,9744,3128,13763,2909
491,251497,Oliana,2003,1872,949,923,199,1197,476
492,251500,Oliola,2003,283,155,128,24,195,64
493,251517,Olius,2003,585,293,292,94,394,97
494,081483,Olivella,2003,1737,947,790,272,1298,167
495,081496,Olost,2003,1192,595,597,150,740,302
496,171143,Olot,2003,29546,14622,14924,3950,18998,6598
497,251522,"Oluges, les",2003,180,94,86,8,113,59
498,081445,Olvan,2003,896,438,458,88,557,251
499,251538,"Omellons, els",2003,253,130,123,21,156,76
500,251543,"Omells de na Gaia, els",2003,153,81,72,13,92,48
501,171156,Ordis,2003,345,180,165,47,240,58
502,251556,Organyà,2003,954,484,470,85,591,278
503,081509,Orís,2003,242,121,121,33,156,53
504,081516,Oristà,2003,616,295,321,60,388,168
505,081521,Orpí,2003,145,83,62,12,98,35
506,081537,Òrrius,2003,350,182,168,30,256,64
507,251569,Os de Balaguer,2003,822,441,381,97,484,241
508,171169,Osor,2003,437,224,213,44,265,128
509,251575,Ossó de Sió,2003,244,124,120,24,155,65
510,081542,Pacs del Penedès,2003,701,359,342,107,504,90
511,081555,Palafolls,2003,6329,3191,3138,1159,4453,717
512,171175,Palafrugell,2003,19635,10041,9594,2827,13430,3378
513,171181,Palamós,2003,15968,7943,8025,2343,10952,2673
514,251581,"Palau d'Anglesola, el",2003,1741,871,870,248,1119,374
515,171194,Palau de Santa Eulàlia,2003,86,50,36,4,64,18
516,171215,Palau-sator,2003,287,147,140,24,188,75
517,171208,Palau-saverdera,2003,1068,538,530,117,696,255
518,081568,Palau-solità i Plegamans,2003,11919,6068,5851,2062,8630,1227
519,431009,"Pallaresos, els",2003,2811,1455,1356,600,2040,171
520,081574,Pallejà,2003,8544,4334,4210,1121,6437,986
521,430995,"Palma d'Ebre, la",2003,406,193,213,40,230,136
522,089058,"Palma de Cervelló, la",2003,2898,1471,1427,508,2060,330
523,171236,Palol de Revardit,2003,417,220,197,59,280,78
524,171241,Pals,2003,2143,1083,1060,217,1416,510
525,081580,"Papiol, el",2003,3518,1773,1745,532,2456,530
526,171254,Pardines,2003,146,76,70,16,88,42
527,081593,Parets del Vallès,2003,15752,7998,7754,2619,11340,1793
528,171267,Parlavà,2003,348,177,171,37,226,85
529,431016,Passanant i Belltall,2003,217,120,97,8,130,79
530,171289,Pau,2003,471,241,230,55,320,96
531,431021,Paüls,2003,625,313,312,57,395,173
532,171292,Pedret i Marzà,2003,142,71,71,22,89,31
533,251641,Penelles,2003,538,294,244,50,328,160
534,171306,"Pera, la",2003,401,202,199,49,250,102
535,081607,Perafita,2003,364,176,188,45,220,99
536,431037,Perafort,2003,710,365,345,90,512,108
537,171328,Peralada,2003,1413,728,685,192,919,302
538,251654,Peramola,2003,385,206,179,41,224,120
539,431042,"Perelló, el",2003,2246,1193,1053,205,1467,574
540,081614,Piera,2003,10869,5597,5272,1760,7285,1824
541,431055,"Piles, les",2003,180,101,79,23,125,32
542,081635,Pineda de Mar,2003,22843,11567,11276,3435,16159,3249
543,431068,"Pinell de Brai, el",2003,1075,550,525,108,670,297
544,251667,Pinell de Solsonès,2003,204,109,95,18,135,51
545,251673,Pinós,2003,303,165,138,31,188,84
546,431074,Pira,2003,440,215,225,67,276,97
547,431080,"Pla de Santa Maria, el",2003,1727,902,825,269,1136,322
548,081640,"Pla del Penedès, el",2003,893,449,444,102,577,214
549,171334,"Planes d'Hostoles, les",2003,1728,866,862,180,1073,475
550,171349,Planoles,2003,292,157,135,20,195,77
551,259118,"Plans de Sió, els",2003,573,294,279,53,338,182
552,251689,"Poal, el",2003,651,346,305,78,393,180
553,251692,"Pobla de Cérvoles, la",2003,233,126,107,29,127,77
554,081653,"Pobla de Claramunt, la",2003,1874,977,897,277,1262,335
555,081666,"Pobla de Lillet, la",2003,1359,658,701,99,829,431
556,431093,"Pobla de Mafumet, la",2003,1270,637,633,229,862,179
557,431107,"Pobla de Massaluca, la",2003,426,222,204,21,243,162
558,431114,"Pobla de Montornès, la",2003,1682,907,775,189,1193,300
559,251713,"Pobla de Segur, la",2003,2912,1419,1493,277,1761,874
560,431129,Poboleda,2003,325,167,158,22,195,108
561,081672,Polinyà,2003,5514,2830,2684,978,4099,437
562,431135,"Pont d'Armentera, el",2003,551,284,267,47,343,161
563,250306,"Pont de Bar, el",2003,153,84,69,14,88,51
564,171352,Pont de Molins,2003,464,245,219,58,319,87
565,251734,"Pont de Suert, el",2003,2165,1080,1085,270,1400,495
566,081825,"Pont de Vilomara i Rocafort, el",2003,2838,1457,1381,409,1985,444
567,431418,Pontils,2003,130,67,63,10,89,31
568,081688,Pontons,2003,450,238,212,44,312,94
569,171365,Pontós,2003,215,118,97,20,143,52
570,251728,Ponts,2003,2366,1191,1175,311,1503,552
571,171371,Porqueres,2003,3803,1882,1921,612,2617,574
572,431140,Porrera,2003,465,251,214,63,282,120
573,171404,"Port de la Selva, el",2003,913,463,450,125,606,182
574,171387,Portbou,2003,1399,692,707,122,847,430
575,251749,"Portella, la",2003,643,353,290,60,441,142
576,431153,Pradell de la Teixeta,2003,196,101,95,15,128,53
577,431166,Prades,2003,579,297,282,55,358,166
578,431172,Prat de Comte,2003,187,92,95,18,103,66
579,081691,"Prat de Llobregat, el",2003,63312,31799,31513,8943,46098,8271
580,431188,Pratdip,2003,646,334,312,62,401,183
581,081712,Prats de Lluçanès,2003,2704,1364,1340,398,1705,601
582,081705,"Prats de Rei, els",2003,530,273,257,55,342,133
583,251752,Prats i Sansor,2003,211,121,90,31,149,31
584,251765,Preixana,2003,427,209,218,35,237,155
585,251771,Preixens,2003,522,252,270,49,299,174
586,082303,Premià de Dalt,2003,9543,4782,4761,1542,6909,1092
587,081727,Premià de Mar,2003,27326,13710,13616,4108,19561,3657
588,171390,"Preses, les",2003,1554,759,795,211,1054,289
589,251790,Prullans,2003,215,114,101,25,133,57
590,171411,Puigcerdà,2003,8034,4173,3861,1217,5619,1198
591,081748,Puigdàlber,2003,376,175,201,63,250,63
592,251804,Puiggròs,2003,259,133,126,26,160,73
593,431191,Puigpelat,2003,706,364,342,129,466,111
594,081751,Puig-reig,2003,4225,2052,2173,437,2611,1177
595,251811,Puigverd d'Agramunt,2003,265,140,125,26,170,69
596,251826,Puigverd de Lleida,2003,1092,543,549,136,690,266
597,081764,Pujalt,2003,191,100,91,21,120,50
598,081770,"Quar, la",2003,70,40,30,6,49,15
599,171426,Quart,2003,2586,1301,1285,395,1880,311
600,170433,Queralbs,2003,192,107,85,23,113,56
601,431205,Querol,2003,320,175,145,31,233,56
602,171432,Rabós,2003,154,78,76,14,102,38
603,081786,Rajadell,2003,405,211,194,38,276,91
604,431212,Rasquera,2003,807,408,399,85,474,248
605,171447,Regencós,2003,288,162,126,33,188,67
606,081799,Rellinars,2003,547,278,269,79,368,100
607,431227,Renau,2003,81,40,41,15,53,13
608,431233,Reus,2003,94407,46551,47856,14614,65122,14671
609,251832,Rialp,2003,558,282,276,67,394,97
610,431248,"Riba, la",2003,681,366,315,67,444,170
611,431251,Riba-roja d'Ebre,2003,1339,689,650,133,828,378
612,259059,Ribera d'Ondara,2003,467,239,228,41,281,145
613,251850,Ribera d'Urgellet,2003,829,428,401,81,527,221
614,171450,Ribes de Freser,2003,2049,1011,1038,197,1278,574
615,171463,Riells i Viabrea,2003,2541,1333,1208,471,1798,272
616,431264,"Riera de Gaià, la",2003,1135,577,558,153,772,210
617,251863,Riner,2003,274,139,135,33,173,68
618,171479,Ripoll,2003,10754,5245,5509,1207,7117,2430
619,081803,Ripollet,2003,32429,16383,16046,4868,23634,3927
620,259139,Riu de Cerdanya,2003,86,43,43,9,63,14
621,171485,Riudarenes,2003,1432,742,690,191,952,289
622,171498,Riudaura,2003,411,204,207,42,293,76
623,431270,Riudecanyes,2003,746,377,369,84,477,185
624,431286,Riudecols,2003,1033,548,485,139,682,212
625,171501,Riudellots de la Selva,2003,1707,868,839,258,1133,316
626,431299,Riudoms,2003,5462,2773,2689,823,3694,945
627,171518,Riumors,2003,174,86,88,14,102,58
628,081810,"Roca del Vallès, la",2003,8362,4220,4142,1340,6042,980
629,431303,Rocafort de Queralt,2003,277,146,131,23,160,94
630,431310,Roda de Berà,2003,4127,2211,1916,542,3035,550
631,081831,Roda de Ter,2003,5361,2625,2736,817,3514,1030
632,431325,Rodonyà,2003,434,228,206,67,246,121
633,431331,Roquetes,2003,6839,3518,3321,967,4607,1265
634,171523,Roses,2003,14719,7441,7278,2425,10220,2074
635,251898,Rosselló,2003,1986,985,1001,311,1322,353
636,431346,"Rourell, el",2003,309,156,153,42,184,83
637,081846,Rubí,2003,64848,32720,32128,10066,47032,7750
638,081859,Rubió,2003,131,73,58,27,73,31
639,171539,Rupià,2003,179,96,83,14,112,53
640,089019,Rupit i Pruit,2003,354,178,176,35,239,80
641,081878,Sabadell,2003,191057,93221,97836,27196,131109,32752
642,081884,Sagàs,2003,146,73,73,23,88,35
643,251902,Salàs de Pallars,2003,319,157,162,18,177,124
644,081901,Saldes,2003,325,184,141,44,223,58
645,171544,Sales de Llierca,2003,109,57,52,25,73,11
646,081918,Sallent,2003,7101,3438,3663,819,4514,1768
647,431359,Salomó,2003,363,185,178,33,207,123
648,439057,Salou,2003,16952,8854,8098,2519,12803,1630
649,171557,Salt,2003,24513,12643,11870,3894,17154,3465
650,251919,Sanaüja,2003,469,234,235,53,270,146
651,081944,Sant Adrià de Besòs,2003,32845,16232,16613,5034,22650,5161
652,081957,Sant Agustí de Lluçanès,2003,104,56,48,16,69,19
653,081960,Sant Andreu de la Barca,2003,23307,12003,11304,3754,17525,2028
654,081976,Sant Andreu de Llavaneres,2003,8450,4224,4226,1501,5940,1009
655,171576,Sant Andreu Salou,2003,144,66,78,25,82,37
656,171833,Sant Aniol de Finestres,2003,292,154,138,42,198,52
657,081982,Sant Antoni de Vilamajor,2003,4189,2110,2079,709,2917,563
658,081995,Sant Bartomeu del Grau,2003,1141,605,536,212,748,181
659,082009,Sant Boi de Llobregat,2003,80738,40243,40495,11447,58262,11029
660,082016,Sant Boi de Lluçanès,2003,577,293,284,47,367,163
661,431362,Sant Carles de la Ràpita,2003,12095,6071,6024,1665,8086,2344
662,082037,Sant Cebrià de Vallalta,2003,2195,1181,1014,352,1603,240
663,082021,Sant Celoni,2003,13759,6901,6858,2087,9330,2342
664,082042,Sant Climent de Llobregat,2003,3233,1629,1604,543,2323,367
665,171582,Sant Climent Sescebes,2003,423,215,208,44,254,125
666,082055,Sant Cugat del Vallès,2003,63132,31139,31993,12080,44652,6400
667,082068,Sant Cugat Sesgarrigues,2003,814,429,385,123,531,160
668,251961,Sant Esteve de la Sarga,2003,106,65,41,4,69,33
669,082074,Sant Esteve de Palautordera,2003,1699,846,853,319,1157,223
670,082080,Sant Esteve Sesrovires,2003,5783,2965,2818,967,4180,636
671,171595,Sant Feliu de Buixalleu,2003,722,390,332,102,465,155
672,082107,Sant Feliu de Codines,2003,4897,2504,2393,737,3324,836
673,171609,Sant Feliu de Guíxols,2003,19456,9639,9817,2942,13098,3416
674,082114,Sant Feliu de Llobregat,2003,41543,20513,21030,5897,30493,5153
675,171616,Sant Feliu de Pallerols,2003,1190,582,608,150,745,295
676,082129,Sant Feliu Sasserra,2003,649,323,326,81,421,147
677,171621,Sant Ferriol,2003,209,116,93,34,133,42
678,082093,Sant Fost de Campsentelles,2003,6852,3474,3378,1006,5000,846
679,082135,Sant Fruitós de Bages,2003,6342,3181,3161,1003,4467,872
680,171637,Sant Gregori,2003,2590,1335,1255,394,1790,406
681,251924,Sant Guim de Freixenet,2003,1031,505,526,101,675,255
682,251977,Sant Guim de la Plana,2003,176,93,83,18,102,56
683,171642,Sant Hilari Sacalm,2003,5375,2807,2568,707,3686,982
684,082153,Sant Hipòlit de Voltregà,2003,3119,1549,1570,456,1952,711
685,081939,Sant Iscle de Vallalta,2003,995,528,467,160,684,151
686,439023,Sant Jaume d'Enveja,2003,3296,1684,1612,424,2154,718
687,082166,Sant Jaume de Frontanyà,2003,27,14,13,0,25,2
688,171655,Sant Jaume de Llierca,2003,764,392,372,106,434,224
689,431378,Sant Jaume dels Domenys,2003,1637,851,786,217,1085,335
690,171674,Sant Joan de les Abadesses,2003,3602,1785,1817,359,2314,929
691,171680,Sant Joan de Mollet,2003,419,207,212,71,254,94
692,082188,Sant Joan de Vilatorrada,2003,9688,4853,4835,1351,6865,1472
693,082172,Sant Joan Despí,2003,29982,14823,15159,4745,21803,3434
694,171851,Sant Joan les Fonts,2003,2718,1368,1350,273,1820,625
695,171668,Sant Jordi Desvalls,2003,630,318,312,65,405,160
696,089030,Sant Julià de Cerdanyola,2003,240,129,111,31,146,63
697,171693,Sant Julià de Ramis,2003,2240,1138,1102,360,1535,345
698,082205,Sant Julià de Vilatorta,2003,2593,1279,1314,454,1768,371
699,179032,Sant Julià del Llor i Bonmatí,2003,1009,521,488,138,666,205
700,082212,Sant Just Desvern,2003,14809,7099,7710,2362,10360,2087
701,082227,Sant Llorenç d'Hortons,2003,1838,926,912,292,1211,335
702,171714,Sant Llorenç de la Muga,2003,177,84,93,15,104,58
703,251930,Sant Llorenç de Morunys,2003,925,475,450,94,583,248
704,082233,Sant Llorenç Savall,2003,2166,1100,1066,309,1336,521
705,082251,Sant Martí d'Albars,2003,125,64,61,14,80,31
706,082248,Sant Martí de Centelles,2003,833,430,403,145,547,141
707,171729,Sant Martí de Llémena,2003,487,256,231,77,319,91
708,259025,Sant Martí de Riucorb,2003,690,359,331,51,427,212
709,082264,Sant Martí de Tous,2003,1037,525,512,155,653,229
710,082270,Sant Martí Sarroca,2003,2569,1306,1263,339,1681,549
711,082286,Sant Martí Sesgueioles,2003,350,176,174,52,211,87
712,171735,Sant Martí Vell,2003,191,104,87,31,120,40
713,082299,Sant Mateu de Bages,2003,679,332,347,62,403,214
714,171740,Sant Miquel de Campmajor,2003,201,111,90,24,138,39
715,171753,Sant Miquel de Fluvià,2003,616,315,301,90,397,129
716,171766,Sant Mori,2003,160,77,83,13,109,38
717,171772,Sant Pau de Segúries,2003,656,333,323,69,411,176
718,082310,Sant Pere de Ribes,2003,24741,12518,12223,4328,17725,2688
719,082325,Sant Pere de Riudebitlles,2003,2112,1047,1065,266,1435,411
720,082331,Sant Pere de Torelló,2003,2231,1122,1109,263,1521,447
721,082346,Sant Pere de Vilamajor,2003,3039,1582,1457,535,2112,392
722,171788,Sant Pere Pescador,2003,1604,898,706,216,1099,289
723,081897,Sant Pere Sallavinera,2003,153,76,77,17,84,52
724,082359,Sant Pol de Mar,2003,4276,2182,2094,613,3075,588
725,082362,Sant Quintí de Mediona,2003,1906,993,913,243,1273,390
726,082378,Sant Quirze de Besora,2003,1963,968,995,209,1231,523
727,082384,Sant Quirze del Vallès,2003,14720,7335,7385,2699,10672,1349
728,082397,Sant Quirze Safaja,2003,446,249,197,57,333,56
729,251945,Sant Ramon,2003,564,291,273,55,345,164
730,082401,Sant Sadurní d'Anoia,2003,10708,5370,5338,1729,7228,1751
731,082418,Sant Sadurní d'Osormort,2003,86,44,42,12,57,17
732,080983,Sant Salvador de Guardiola,2003,2390,1241,1149,341,1711,338
733,082628,Sant Vicenç de Castellet,2003,7334,3537,3797,852,4890,1592
734,082649,Sant Vicenç de Montalt,2003,4326,2196,2130,835,3064,427
735,082652,Sant Vicenç de Torelló,2003,1869,914,955,300,1153,416
736,082634,Sant Vicenç dels Horts,2003,26008,13165,12843,4328,18493,3187
737,431384,Santa Bàrbara,2003,3541,1804,1737,460,2233,848
738,082439,Santa Cecília de Voltregà,2003,198,109,89,28,135,35
739,082444,Santa Coloma de Cervelló,2003,6212,3127,3085,1121,4415,676
740,171805,Santa Coloma de Farners,2003,9741,5006,4735,1493,6649,1599
741,082457,Santa Coloma de Gramenet,2003,116012,58194,57818,14059,84460,17493
742,431397,Santa Coloma de Queralt,2003,2880,1439,1441,423,1835,622
743,171812,Santa Cristina d'Aro,2003,3522,1819,1703,575,2431,516
744,082460,Santa Eugènia de Berga,2003,1995,1036,959,297,1409,289
745,082476,Santa Eulàlia de Riuprimer,2003,866,445,421,113,578,175
746,082482,Santa Eulàlia de Ronçana,2003,5175,2606,2569,755,3642,778
747,082495,Santa Fe del Penedès,2003,334,164,170,62,223,49
748,171827,Santa Llogaia d'Àlguema,2003,299,157,142,44,208,47
749,082508,Santa Margarida de Montbui,2003,9236,4639,4597,1388,6611,1237
750,082515,Santa Margarida i els Monjos,2003,5545,2903,2642,865,4012,668
751,082589,Santa Maria d'Oló,2003,1018,519,499,99,690,229
752,082536,Santa Maria de Besora,2003,184,95,89,25,110,49
753,082567,Santa Maria de Martorelles,2003,709,346,363,128,476,105
754,082554,Santa Maria de Merlès,2003,154,82,72,18,101,35
755,082573,Santa Maria de Miralles,2003,102,49,53,9,68,25
756,082592,Santa Maria de Palautordera,2003,7318,3779,3539,1211,5072,1035
757,431401,Santa Oliva,2003,2422,1226,1196,383,1640,399
758,171848,Santa Pau,2003,1481,750,731,178,997,306
759,082606,Santa Perpètua de Mogoda,2003,20652,10471,10181,3210,15246,2196
760,082613,Santa Susanna,2003,2413,1240,1173,391,1701,321
761,081923,Santpedor,2003,5610,2782,2828,839,3891,880
762,431423,Sarral,2003,1481,774,707,190,959,332
763,171864,Sarrià de Ter,2003,3858,1910,1948,515,2637,706
764,252017,Sarroca de Bellera,2003,154,84,70,9,86,59
765,252000,Sarroca de Lleida,2003,444,221,223,38,278,128
766,171870,"Saus, Camallera i Llampaies",2003,708,353,355,82,468,158
767,431439,Savallà del Comtat,2003,72,36,36,9,39,24
768,431444,"Secuita, la",2003,1150,592,558,156,786,208
769,171886,"Selva de Mar, la",2003,202,104,98,26,128,48
770,431457,"Selva del Camp, la",2003,4507,2265,2242,835,2901,771
771,431460,Senan,2003,35,24,11,6,23,6
772,430445,"Sénia, la",2003,5737,2999,2738,775,3969,993
773,252022,Senterada,2003,100,48,52,7,66,27
774,250352,"Sentiu de Sió, la",2003,469,230,239,33,299,137
775,082671,Sentmenat,2003,6402,3193,3209,1006,4552,844
776,171903,Serinyà,2003,901,471,430,125,602,174
777,252043,Seròs,2003,1754,945,809,178,1095,481
778,171910,Serra de Daró,2003,176,97,79,22,98,56
779,171925,Setcases,2003,192,101,91,24,126,42
780,252038,"Seu d'Urgell, la",2003,11726,5748,5978,1659,7937,2130
781,082690,Seva,2003,2741,1401,1340,409,1890,442
782,252056,Sidamon,2003,679,365,314,87,476,116
783,171931,Sils,2003,3512,1770,1742,579,2372,561
784,082704,Sitges,2003,22625,11124,11501,3184,16125,3316
785,170524,Siurana,2003,176,89,87,13,115,48
786,082711,Sobremunt,2003,89,41,48,18,57,14
787,252069,"Soleràs, el",2003,428,234,194,35,262,131
788,431476,Solivella,2003,574,281,293,49,326,199
789,252075,Solsona,2003,7925,4008,3917,1195,5250,1480
790,082726,Sora,2003,198,103,95,31,126,41
791,252081,Soriguera,2003,330,172,158,37,204,89
792,252094,Sort,2003,1924,975,949,257,1267,400
793,252108,Soses,2003,1552,825,727,181,1038,333
794,082732,Subirats,2003,2665,1331,1334,413,1651,601
795,252115,Sudanell,2003,738,396,342,61,499,178
796,252120,Sunyer,2003,289,145,144,31,185,73
797,082747,Súria,2003,6154,3031,3123,820,3850,1484
798,171946,Susqueda,2003,107,55,52,10,72,25
799,082763,Tagamanent,2003,239,125,114,38,166,35
800,082779,Talamanca,2003,114,63,51,10,84,20
801,252154,Talarn,2003,346,173,173,38,219,89
802,252167,Talavera,2003,281,148,133,15,180,86
803,171959,"Tallada d'Empordà, la",2003,332,180,152,30,208,94
804,082785,Taradell,2003,5469,2765,2704,866,3713,890
805,431482,Tarragona,2003,121076,59283,61793,17826,84302,18948
806,252173,Tàrrega,2003,13616,6789,6827,2051,9171,2394
807,252189,Tarrés,2003,115,58,57,7,74,34
808,252192,Tarroja de Segarra,2003,160,77,83,13,89,58
809,082750,Tavèrnoles,2003,277,140,137,36,202,39
810,082802,Tavertet,2003,143,76,67,12,96,35
811,082819,Teià,2003,5724,2851,2873,989,4080,655
812,252206,Térmens,2003,1394,713,681,160,895,339
813,171962,Terrades,2003,174,83,91,11,101,62
814,082798,Terrassa,2003,184829,91613,93216,27561,128017,29251
815,082824,Tiana,2003,6519,3213,3306,1118,4654,747
816,252213,Tírvia,2003,128,65,63,14,84,30
817,252228,Tiurana,2003,30,19,11,4,17,9
818,431495,Tivenys,2003,910,458,452,82,548,280
819,431508,Tivissa,2003,1790,894,896,216,1099,475
820,082830,Tona,2003,6486,3278,3208,981,4448,1057
821,252234,Torà,2003,1227,631,596,153,781,293
822,082845,Tordera,2003,10850,5518,5332,1509,7498,1843
823,082858,Torelló,2003,12543,6207,6336,1707,8581,2255
824,252249,"Torms, els",2003,188,107,81,18,107,63
825,252252,Tornabous,2003,833,435,398,79,508,246
826,252271,"Torre de Cabdella, la",2003,685,339,346,41,420,224
827,082861,"Torre de Claramunt, la",2003,2794,1422,1372,490,1983,321
828,431515,"Torre de Fontaubella, la",2003,140,72,68,9,88,43
829,431520,"Torre de l'Espanyol, la",2003,724,378,346,75,453,196
830,252265,Torrebesses,2003,305,151,154,37,162,106
831,431536,Torredembarra,2003,12113,6076,6037,1867,8434,1812
832,252287,Torrefarrera,2003,2138,1102,1036,281,1490,367
833,259078,Torrefeta i Florejacs,2003,646,325,321,71,374,201
834,252304,Torregrossa,2003,2213,1105,1108,254,1349,610
835,252311,Torrelameu,2003,578,319,259,46,380,152
836,082877,Torrelavit,2003,1138,598,540,117,761,260
837,082883,Torrelles de Foix,2003,1842,990,852,251,1218,373
838,082896,Torrelles de Llobregat,2003,4115,2080,2035,753,2936,426
839,171978,Torrent,2003,168,92,76,15,117,36
840,252326,Torres de Segre,2003,1879,969,910,237,1226,416
841,252332,Torre-serona,2003,347,183,164,34,246,67
842,171984,Torroella de Fluvià,2003,378,216,162,28,257,93
843,171997,Torroella de Montgrí,2003,9393,4778,4615,1463,6407,1523
844,431541,Torroja del Priorat,2003,147,89,58,9,101,37
845,172001,Tortellà,2003,713,354,359,84,421,208
846,431554,Tortosa,2003,31164,15471,15693,4131,20682,6351
847,172018,Toses,2003,159,97,62,22,101,36
848,172023,Tossa de Mar,2003,4786,2425,2361,661,3399,726
849,252347,Tremp,2003,5518,2733,2785,710,3331,1477
850,172044,Ullà,2003,893,498,395,131,620,142
851,082900,Ullastrell,2003,1340,684,656,220,932,188
852,172057,Ullastret,2003,230,117,113,25,155,50
853,431567,Ulldecona,2003,5997,3092,2905,780,3956,1261
854,431573,Ulldemolins,2003,501,263,238,40,291,170
855,172039,Ultramort,2003,199,112,87,18,120,61
856,172060,Urús,2003,203,107,96,28,136,39
857,082917,Vacarisses,2003,3467,1830,1637,544,2487,436
858,170144,"Vajol, la",2003,114,65,49,13,79,22
859,172076,"Vall d'en Bas, la",2003,2565,1293,1272,306,1600,659
860,172082,"Vall de Bianya, la",2003,1172,584,588,175,755,242
861,250432,"Vall de Boí, la",2003,952,524,428,113,674,165
862,259010,Vall de Cardós,2003,335,174,161,43,200,92
863,082922,Vallbona d'Anoia,2003,1111,560,551,152,747,212
864,252385,Vallbona de les Monges,2003,268,133,135,13,153,102
865,082938,Vallcebre,2003,270,140,130,23,168,79
866,431589,Vallclara,2003,113,64,49,8,63,42
867,252402,Vallfogona de Balaguer,2003,1511,764,747,172,1007,332
868,171707,Vallfogona de Ripollès,2003,213,112,101,20,138,55
869,431592,Vallfogona de Riucorb,2003,172,87,85,3,75,94
870,082943,Vallgorguina,2003,1597,840,757,254,1147,196
871,082956,Vallirana,2003,11110,5593,5517,1780,7874,1456
872,172095,Vall-llobrega,2003,549,249,300,92,408,49
873,431606,Vallmoll,2003,1337,705,632,182,952,203
874,082969,Vallromanes,2003,1697,876,821,345,1183,169
875,431613,Valls,2003,21649,10755,10894,3186,14694,3769
876,259062,"Valls d'Aguilar, les",2003,332,180,152,32,203,97
877,252398,"Valls de Valira, les",2003,803,430,373,82,527,194
878,431628,Vandellòs i l'Hospitalet de l'Infant,2003,4642,2353,2289,660,3241,741
879,259097,"Vansa i Fórnols, la",2003,200,101,99,21,121,58
880,082975,Veciana,2003,168,90,78,25,98,45
881,431634,"Vendrell, el",2003,26820,13529,13291,4400,18862,3558
882,172109,Ventalló,2003,668,347,321,61,443,164
883,252424,Verdú,2003,1112,535,577,109,649,354
884,172116,Verges,2003,1145,578,567,135,728,282
885,431649,Vespella de Gaià,2003,236,139,97,23,165,48
886,082981,Vic,2003,35354,17799,17555,5249,23935,6170
887,172121,Vidrà,2003,157,79,78,24,101,32
888,172137,Vidreres,2003,5559,2873,2686,842,3865,852
889,252430,Vielha e Mijaran,2003,4547,2378,2169,701,3381,465
890,431652,Vilabella,2003,795,407,388,96,510,189
891,172142,Vilabertran,2003,798,410,388,104,506,188
892,172155,Vilablareix,2003,2099,1056,1043,350,1554,195
893,082994,Vilada,2003,515,261,254,44,322,149
894,172174,Viladamat,2003,386,198,188,36,247,103
895,172168,Viladasens,2003,167,89,78,18,90,59
896,083015,Viladecans,2003,59343,29958,29385,9388,43627,6328
897,083008,Viladecavalls,2003,6639,3365,3274,1306,4705,628
898,172180,Vilademuls,2003,770,403,367,87,503,180
899,172207,Viladrau,2003,906,469,437,116,615,175
900,172214,Vilafant,2003,4482,2238,2244,756,3231,495
901,083054,Vilafranca del Penedès,2003,33381,16611,16770,4897,23286,5198
902,252445,Vilagrassa,2003,424,218,206,43,265,116
903,172235,Vilajuïga,2003,1013,503,510,160,684,169
904,431750,Vilalba dels Arcs,2003,736,381,355,69,426,241
905,083067,Vilalba Sasserra,2003,524,275,249,81,382,61
906,252458,Vilaller,2003,570,293,277,67,373,130
907,172240,Vilallonga de Ter,2003,442,240,202,34,286,122
908,431665,Vilallonga del Camp,2003,1283,639,644,169,877,237
909,172253,Vilamacolum,2003,291,153,138,41,185,65
910,172266,Vilamalla,2003,868,463,405,133,631,104
911,172272,Vilamaniscle,2003,149,81,68,27,83,39
912,252477,Vilamòs,2003,159,88,71,29,107,23
913,172288,Vilanant,2003,328,162,166,29,222,77
914,431671,Vilanova d'Escornalbou,2003,447,227,220,52,313,82
915,252483,Vilanova de Bellpuig,2003,1111,547,564,106,669,336
916,252496,Vilanova de l'Aguda,2003,256,130,126,29,140,87
917,252542,Vilanova de la Barca,2003,904,452,452,106,558,240
918,252509,Vilanova de Meià,2003,423,221,202,33,263,127
919,431687,Vilanova de Prades,2003,145,74,71,15,81,49
920,083036,Vilanova de Sau,2003,335,154,181,42,225,68
921,252516,Vilanova de Segrià,2003,782,396,386,82,545,155
922,083020,Vilanova del Camí,2003,10793,5451,5342,1832,7730,1231
923,089024,Vilanova del Vallès,2003,2796,1421,1375,482,1955,359
924,083073,Vilanova i la Geltrú,2003,57300,28283,29017,8248,39627,9425
925,431690,Vilaplana,2003,528,274,254,61,311,156
926,431704,Vila-rodona,2003,1061,582,479,98,701,262
927,172305,Vila-sacra,2003,452,227,225,47,329,76
928,252521,Vila-sana,2003,570,273,297,77,339,154
929,431711,Vila-seca,2003,14377,7232,7145,2241,10429,1707
930,082140,Vilassar de Dalt,2003,7814,3898,3916,966,5567,1281
931,082191,Vilassar de Mar,2003,18321,8948,9373,2938,12908,2475
932,172229,Vilaür,2003,131,68,63,17,93,21
933,431726,Vilaverd,2003,399,203,196,47,242,110
934,431732,"Vilella Alta, la",2003,110,60,50,6,66,38
935,431747,"Vilella Baixa, la",2003,197,104,93,20,121,56
936,172333,Vilobí d'Onyar,2003,2430,1306,1124,339,1700,391
937,083041,Vilobí del Penedès,2003,944,496,448,123,637,184
938,172327,Vilopriu,2003,167,84,83,20,93,54
939,252537,"Vilosell, el",2003,233,109,124,13,150,70
940,431763,Vimbodí i Poblet,2003,1054,575,479,101,637,316
941,252555,Vinaixa,2003,600,298,302,62,375,163
942,431779,Vinebre,2003,478,245,233,33,319,126
943,431785,Vinyols i els Arcs,2003,1369,724,645,185,948,236
944,083089,Viver i Serrateix,2003,192,100,92,20,127,45
945,430521,Xerta,2003,1240,626,614,145,760,335
946,000000,Catalunya,2003,6704146,3309850,3394296,923636,4630739,1149771
0,250019,Abella de la Conca,2004,187,104,83,27,120,40
1,080018,Abrera,2004,9422,4890,4532,1510,7039,873
2,250024,Àger,2004,502,269,233,34,287,181
3,250030,Agramunt,2004,5212,2715,2497,744,3427,1041
4,080023,Aguilar de Segarra,2004,230,122,108,25,140,65
5,170010,Agullana,2004,746,382,364,87,473,186
6,080142,Aiguafreda,2004,2241,1078,1163,289,1510,442
7,430017,Aiguamúrcia,2004,690,373,317,68,477,145
8,170025,Aiguaviva,2004,593,301,292,102,407,84
9,250387,Aitona,2004,2248,1155,1093,242,1461,545
10,250045,"Alamús, els",2004,724,374,350,74,481,169
11,250058,Alàs i Cerc,2004,403,221,182,41,256,106
12,250061,"Albagés, l'",2004,502,264,238,66,297,139
13,170031,Albanyà,2004,135,71,64,23,87,25
14,250077,Albatàrrec,2004,1393,731,662,220,931,242
15,250083,Albesa,2004,1531,776,755,186,981,364
16,250096,"Albi, l'",2004,836,431,405,95,539,202
17,430022,Albinyana,2004,1926,986,940,266,1334,326
18,430038,"Albiol, l'",2004,288,148,140,60,197,31
19,170046,Albons,2004,574,304,270,77,380,117
20,430043,Alcanar,2004,8868,4518,4350,1162,6004,1702
21,250100,Alcanó,2004,254,128,126,27,145,82
22,250117,Alcarràs,2004,5027,2515,2512,711,3319,997
23,250122,Alcoletge,2004,1973,1043,930,283,1365,325
24,430056,Alcover,2004,4315,2206,2109,678,2914,723
25,439044,"Aldea, l'",2004,3473,1775,1698,388,2275,810
26,430069,Aldover,2004,822,396,426,65,525,232
27,430075,"Aleixar, l'",2004,755,380,375,115,461,179
28,080039,Alella,2004,8831,4371,4460,1320,6436,1075
29,430081,Alfara de Carles,2004,385,201,184,31,241,113
30,250138,Alfarràs,2004,3137,1598,1539,425,2034,678
31,250143,Alfés,2004,317,168,149,31,198,88
32,430094,Alforja,2004,1446,751,695,183,924,339
33,250156,Algerri,2004,495,249,246,39,298,158
34,250169,Alguaire,2004,2928,1514,1414,370,1944,614
35,250175,Alins,2004,256,130,126,18,150,88
36,430108,Alió,2004,391,195,196,38,255,98
37,250194,Almacelles,2004,5819,2980,2839,735,3899,1185
38,250208,Almatret,2004,452,233,219,36,240,176
39,250215,Almenar,2004,3515,1821,1694,429,2296,790
40,430115,Almoster,2004,1050,541,509,203,720,127
41,250220,Alòs de Balaguer,2004,166,98,68,9,106,51
42,170062,Alp,2004,1315,691,624,155,1002,158
43,080044,Alpens,2004,290,156,134,50,176,64
44,250236,Alpicat,2004,4852,2445,2407,829,3383,640
45,250241,Alt Àneu,2004,427,245,182,52,283,92
46,430120,Altafulla,2004,3828,1949,1879,654,2743,431
47,170078,Amer,2004,2184,1077,1107,243,1410,531
48,430136,"Ametlla de Mar, l'",2004,6032,3148,2884,770,4119,1143
49,080057,"Ametlla del Vallès, l'",2004,7111,3558,3553,1406,4914,791
50,439060,"Ampolla, l'",2004,2294,1144,1150,263,1509,522
51,430141,Amposta,2004,18238,9152,9086,2530,12504,3204
52,170084,Anglès,2004,5096,2625,2471,683,3370,1043
53,250273,Anglesola,2004,1293,653,640,124,838,331
54,250292,Arbeca,2004,2159,1074,1085,216,1330,613
55,430167,"Arboç, l'",2004,4164,2211,1953,620,2877,667
56,430154,Arbolí,2004,116,63,53,2,87,27
57,170097,Arbúcies,2004,5775,3056,2719,867,3907,1001
58,080060,Arenys de Mar,2004,13428,6544,6884,1909,9074,2445
59,080076,Arenys de Munt,2004,7190,3622,3568,1181,4968,1041
60,170101,Argelaguer,2004,385,204,181,60,226,99
61,080082,Argençola,2004,209,118,91,24,142,43
62,430173,"Argentera, l'",2004,159,91,68,15,112,32
63,080095,Argentona,2004,10403,5143,5260,1699,7252,1452
64,170118,"Armentera, l'",2004,738,364,374,59,482,197
65,430189,Arnes,2004,511,261,250,34,282,195
66,250313,Arres,2004,67,40,27,8,46,13
67,250328,Arsèguel,2004,89,45,44,10,59,20
68,080109,Artés,2004,4830,2435,2395,681,3255,894
69,250334,Artesa de Lleida,2004,1379,715,664,181,871,327
70,250349,Artesa de Segre,2004,3540,1852,1688,455,2273,812
71,430192,Ascó,2004,1629,827,802,177,1059,393
72,250365,Aspa,2004,271,133,138,28,152,91
73,250371,"Avellanes i Santa Linya, les",2004,476,266,210,29,293,154
74,080116,Avià,2004,1956,982,974,249,1274,433
75,080121,Avinyó,2004,2073,1037,1036,318,1309,446
76,170123,Avinyonet de Puigventós,2004,983,495,488,148,720,115
77,080137,Avinyonet del Penedès,2004,1414,760,654,184,951,279
78,080155,Badalona,2004,214874,107327,107547,29971,153740,31163
79,089045,Badia del Vallès,2004,14313,7124,7189,2140,10269,1904
80,080168,Bagà,2004,2122,1032,1090,251,1340,531
81,250390,Baix Pallars,2004,372,213,159,26,235,111
82,250404,Balaguer,2004,14540,7223,7317,2166,9699,2675
83,080174,Balenyà,2004,3413,1700,1713,533,2373,507
84,080180,Balsareny,2004,3241,1607,1634,394,2133,714
85,430206,Banyeres del Penedès,2004,2003,1067,936,273,1464,266
86,170157,Banyoles,2004,16423,8175,8248,2759,10752,2912
87,250411,Barbens,2004,818,432,386,75,504,239
88,430213,Barberà de la Conca,2004,446,234,212,46,285,115
89,082520,Barberà del Vallès,2004,27202,13624,13578,4256,19956,2990
90,080193,Barcelona,2004,1578546,746045,832501,184285,1061467,332794
91,250426,"Baronia de Rialb, la",2004,279,149,130,40,160,79
92,170160,Bàscara,2004,870,454,416,91,585,194
93,250447,Bassella,2004,263,137,126,32,152,79
94,430228,Batea,2004,2073,1051,1022,229,1301,543
95,250450,Bausen,2004,51,31,20,0,22,29
96,080207,Begues,2004,5284,2644,2640,1144,3640,500
97,170139,Begur,2004,3861,1986,1875,590,2652,619
98,250463,Belianes,2004,608,309,299,86,336,186
99,251706,Bellaguarda,2004,348,176,172,36,181,131
100,170182,Bellcaire d'Empordà,2004,645,338,307,87,417,141
101,250479,Bellcaire d'Urgell,2004,1218,580,638,112,722,384
102,250485,Bell-lloc d'Urgell,2004,2126,1045,1081,280,1364,482
103,250498,Bellmunt d'Urgell,2004,226,107,119,31,136,59
104,430234,Bellmunt del Priorat,2004,308,151,157,19,176,113
105,080214,Bellprat,2004,90,49,41,9,56,25
106,250501,Bellpuig,2004,4243,2149,2094,566,2806,871
107,430249,Bellvei,2004,1541,822,719,231,1054,256
108,250518,Bellver de Cerdanya,2004,1738,915,823,182,1206,350
109,250523,Bellvís,2004,2207,1127,1080,244,1339,624
110,250539,Benavent de Segrià,2004,1178,607,571,179,838,161
111,430252,Benifallet,2004,821,406,415,83,460,278
112,430265,Benissanet,2004,1130,594,536,120,728,282
113,080229,Berga,2004,15753,7742,8011,1970,10240,3543
114,170195,Besalú,2004,2165,1057,1108,251,1395,519
115,170209,Bescanó,2004,3648,1827,1821,611,2422,615
116,170216,Beuda,2004,146,78,68,20,104,22
117,080235,Bigues i Riells del Fai,2004,6636,3459,3177,1133,4786,717
118,250557,Biosca,2004,238,124,114,27,139,72
119,170221,"Bisbal d'Empordà, la",2004,8885,4426,4459,1287,6003,1595
120,430271,"Bisbal de Falset, la",2004,244,125,119,24,143,77
121,430287,"Bisbal del Penedès, la",2004,2483,1310,1173,350,1707,426
122,172348,Biure,2004,234,120,114,30,157,47
123,430290,Blancafort,2004,409,216,193,47,238,124
124,170237,Blanes,2004,35577,17940,17637,5474,25068,5035
125,170293,Boadella i les Escaules,2004,234,113,121,29,153,52
126,170242,Bolvir,2004,276,141,135,24,199,53
127,430304,Bonastre,2004,440,236,204,61,297,82
128,250576,"Bòrdes, Es",2004,217,109,108,20,162,35
129,170255,Bordils,2004,1425,723,702,219,943,263
130,250582,"Borges Blanques, les",2004,5425,2731,2694,705,3503,1217
131,430311,"Borges del Camp, les",2004,1769,890,879,229,1203,337
132,170268,Borrassà,2004,557,292,265,45,374,138
133,080240,Borredà,2004,508,258,250,70,331,107
134,250595,Bossòst,2004,1015,525,490,138,710,167
135,430326,Bot,2004,780,399,381,62,447,271
136,430332,Botarell,2004,881,461,420,134,638,109
137,250560,Bovera,2004,383,193,190,22,214,147
138,430347,Bràfim,2004,610,310,300,59,407,144
139,170274,Breda,2004,3566,1821,1745,529,2369,668
140,080253,"Bruc, el",2004,1454,771,683,215,1028,211
141,080266,"Brull, el",2004,201,110,91,21,137,43
142,170280,Brunyola i Sant Martí Sapresa,2004,348,173,175,36,204,108
143,430350,Cabacés,2004,339,179,160,32,206,101
144,250609,Cabanabona,2004,116,54,62,10,59,47
145,170314,Cabanelles,2004,244,141,103,28,153,63
146,170307,Cabanes,2004,852,447,405,125,557,170
147,080272,"Cabanyes, les",2004,647,326,321,117,435,95
148,250616,Cabó,2004,114,63,51,8,65,41
149,430363,Cabra del Camp,2004,768,405,363,102,522,144
150,080288,Cabrera d'Anoia,2004,818,442,376,115,585,118
151,080291,Cabrera de Mar,2004,3991,2046,1945,659,2842,490
152,080305,Cabrils,2004,6003,2933,3070,1238,4186,579
153,170329,Cadaqués,2004,2730,1322,1408,399,1908,423
154,080312,Calaf,2004,3214,1671,1543,399,2196,619
155,430379,Calafell,2004,17277,8757,8520,2357,12482,2438
156,080348,Calders,2004,803,407,396,132,514,157
157,080327,Caldes d'Estrac,2004,2448,1208,1240,340,1652,456
158,170335,Caldes de Malavella,2004,4925,2469,2456,734,3363,828
159,080333,Caldes de Montbui,2004,15096,7575,7521,2235,10567,2294
160,080351,Calella,2004,16008,7896,8112,2234,11057,2717
161,080370,Calldetenes,2004,2143,1113,1030,334,1504,305
162,080386,Callús,2004,1427,705,722,178,939,310
163,080364,Calonge de Segarra,2004,200,104,96,27,109,64
164,170340,Calonge i Sant Antoni,2004,8757,4440,4317,1368,6042,1347
165,250621,Camarasa,2004,903,460,443,61,554,288
166,439039,Camarles,2004,3101,1585,1516,413,2023,665
167,430385,Cambrils,2004,24604,12327,12277,4005,17653,2946
168,170353,Camós,2004,659,339,320,78,430,151
169,170366,Campdevànol,2004,3361,1668,1693,367,2164,830
170,170372,Campelles,2004,122,67,55,7,84,31
171,080399,Campins,2004,334,171,163,62,233,39
172,170388,Campllong,2004,352,180,172,71,209,72
173,170391,Camprodon,2004,2390,1175,1215,240,1567,583
174,250637,Canejan,2004,108,55,53,11,62,35
175,170405,Canet d'Adri,2004,538,280,258,63,377,98
176,080403,Canet de Mar,2004,12047,5943,6104,1717,8207,2123
177,080410,Canovelles,2004,14001,7210,6791,2099,10102,1800
178,080425,Cànoves i Samalús,2004,2297,1197,1100,371,1628,298
179,170412,Cantallops,2004,267,131,136,29,158,80
180,080431,Canyelles,2004,2808,1488,1320,453,2061,294
181,430398,Capafonts,2004,109,58,51,1,71,37
182,430402,Capçanes,2004,402,189,213,33,260,109
183,080446,Capellades,2004,5143,2513,2630,732,3487,924
184,170427,Capmany,2004,485,254,231,54,311,120
185,080459,Capolat,2004,80,42,38,5,54,21
186,080462,Cardedeu,2004,14514,7232,7282,2499,10215,1800
187,080478,Cardona,2004,5272,2563,2709,570,3368,1334
188,080484,Carme,2004,721,373,348,80,466,175
189,430419,Caseres,2004,319,153,166,35,184,100
190,170448,Cassà de la Selva,2004,8325,4226,4099,1264,5477,1584
191,080497,Casserres,2004,1524,734,790,135,961,428
192,080575,Castell de l'Areny,2004,65,37,28,8,45,12
193,259046,Castell de Mur,2004,167,86,81,19,96,52
194,250642,Castellar de la Ribera,2004,155,77,78,18,95,42
195,080522,Castellar de n'Hug,2004,191,104,87,12,132,47
196,080500,Castellar del Riu,2004,136,79,57,18,92,26
197,080517,Castellar del Vallès,2004,19475,9743,9732,3371,13633,2471
198,080538,Castellbell i el Vilar,2004,3171,1621,1550,395,2156,620
199,080543,Castellbisbal,2004,10352,5329,5023,1974,7381,997
200,080556,Castellcir,2004,500,265,235,81,328,91
201,250674,Castelldans,2004,955,503,452,95,584,276
202,080569,Castelldefels,2004,53964,26909,27055,8797,39800,5367
203,080581,Castellet i la Gornal,2004,1684,854,830,253,1104,327
204,170464,Castellfollit de la Roca,2004,979,498,481,107,618,254
205,080608,Castellfollit de Riubregós,2004,219,112,107,27,140,52
206,080594,Castellfollit del Boix,2004,405,201,204,64,248,93
207,080615,Castellgalí,2004,1145,599,546,167,781,197
208,080620,Castellnou de Bages,2004,742,394,348,129,545,68
209,250680,Castellnou de Seana,2004,710,372,338,76,436,198
210,170470,Castelló d'Empúries,2004,7777,4031,3746,1290,5349,1138
211,250693,Castelló de Farfanya,2004,588,299,289,54,357,177
212,080636,Castellolí,2004,452,221,231,65,305,82
213,170486,Castell-Platja d'Aro,2004,8470,4328,4142,1140,6255,1075
214,250707,Castellserà,2004,1117,569,548,120,679,318
215,080641,Castellterçol,2004,2178,1068,1110,296,1405,477
216,430424,Castellvell del Camp,2004,1981,959,1022,372,1406,203
217,080654,Castellví de la Marca,2004,1522,774,748,211,985,326
218,080667,Castellví de Rosanes,2004,1297,660,637,221,909,167
219,430430,"Catllar, el",2004,3070,1587,1483,510,2210,350
220,250714,Cava,2004,58,35,23,3,36,19
221,171899,"Cellera de Ter, la",2004,2038,1035,1003,266,1355,417
222,170499,Celrà,2004,3218,1606,1612,588,2202,428
223,080673,Centelles,2004,6304,3093,3211,899,4219,1186
224,082687,Cercs,2004,1338,688,650,143,825,370
225,082665,Cerdanyola del Vallès,2004,56065,27997,28068,8285,41388,6392
226,080689,Cervelló,2004,6980,3571,3409,1094,5088,798
227,250729,Cervera,2004,8564,4425,4139,1338,5762,1464
228,250735,Cervià de les Garrigues,2004,844,440,404,68,524,252
229,170502,Cervià de Ter,2004,730,359,371,112,450,168
230,170519,Cistella,2004,233,118,115,26,147,60
231,250740,Ciutadilla,2004,245,129,116,28,152,65
232,250753,Clariana de Cardener,2004,153,80,73,24,111,18
233,250766,"Cogul, el",2004,218,115,103,17,127,74
234,170545,Colera,2004,655,331,324,62,431,162
235,250772,Coll de Nargó,2004,591,303,288,57,368,166
236,080692,Collbató,2004,3024,1593,1431,554,2181,289
237,430458,Colldejou,2004,194,109,85,15,142,37
238,080706,Collsuspina,2004,296,157,139,43,212,41
239,170558,Colomers,2004,202,101,101,8,129,65
240,251636,"Coma i la Pedra, la",2004,254,152,102,23,173,58
241,251615,Conca de Dalt,2004,437,224,213,38,257,142
242,430461,Conesa,2004,128,70,58,13,81,34
243,430477,Constantí,2004,5462,2892,2570,834,3832,796
244,080713,Copons,2004,282,137,145,30,178,74
245,430483,Corbera d'Ebre,2004,1069,563,506,114,660,295
246,080728,Corbera de Llobregat,2004,11278,5787,5491,1988,8068,1222
247,250788,Corbins,2004,1149,594,555,148,753,248
248,170577,Corçà,2004,1201,606,595,127,848,226
249,080734,Cornellà de Llobregat,2004,83327,41341,41986,11079,58356,13892
250,170561,Cornellà del Terri,2004,1992,1004,988,256,1352,384
251,430496,Cornudella de Montsant,2004,912,465,447,84,585,243
252,430509,Creixell,2004,2411,1262,1149,330,1634,447
253,170583,Crespià,2004,227,112,115,28,139,60
254,179011,"Cruïlles, Monells i Sant Sadurní de l'Heura",2004,1201,594,607,164,833,204
255,080749,Cubelles,2004,9549,4944,4605,1423,6845,1281
256,250791,Cubells,2004,384,197,187,46,202,136
257,430516,Cunit,2004,8086,4186,3900,1158,5680,1248
258,170600,Darnius,2004,516,260,256,46,323,147
259,170617,Das,2004,165,89,76,14,120,31
260,439018,Deltebre,2004,10757,5447,5310,1334,7276,2147
261,080752,Dosrius,2004,3762,1895,1867,607,2792,363
262,430537,Duesaigües,2004,191,114,77,11,121,59
263,170622,"Escala, l'",2004,7455,3785,3670,733,5369,1353
264,080765,Esparreguera,2004,20163,10314,9849,3326,14393,2444
265,170638,Espinelves,2004,189,100,89,18,115,56
266,250812,"Espluga Calba, l'",2004,425,228,197,28,274,123
267,430542,"Espluga de Francolí, l'",2004,3687,1848,1839,495,2329,863
268,080771,Esplugues de Llobregat,2004,45915,22598,23317,5682,33310,6923
269,170643,Espolla,2004,380,189,191,39,230,111
270,170656,Esponellà,2004,426,207,219,58,288,80
271,250827,Espot,2004,364,201,163,46,256,62
272,080787,"Espunyola, l'",2004,273,138,135,35,166,72
273,082541,"Esquirol, l'",2004,2199,1086,1113,314,1395,490
274,250886,Estamariu,2004,122,68,54,7,77,38
275,080790,"Estany, l'",2004,405,189,216,42,243,120
276,250851,Estaràs,2004,186,103,83,24,109,53
277,250864,Esterri d'Àneu,2004,754,379,375,96,501,157
278,250870,Esterri de Cardós,2004,72,34,38,7,46,19
279,430555,Falset,2004,2627,1320,1307,375,1689,563
280,170059,"Far d'Empordà, el",2004,440,226,214,70,287,83
281,250899,Farrera,2004,105,61,44,8,79,18
282,430568,"Fatarella, la",2004,1173,592,581,110,709,354
283,430574,"Febró, la",2004,58,37,21,2,46,10
284,081347,Figaró-Montmany,2004,993,507,486,142,639,212
285,080804,Fígols,2004,47,26,21,4,27,16
286,259084,Fígols i Alinyà,2004,271,147,124,13,160,98
287,430580,"Figuera, la",2004,220,110,110,19,153,48
288,170669,Figueres,2004,37032,18034,18998,5719,25114,6199
289,430593,Figuerola del Camp,2004,301,144,157,47,189,65
290,170675,Flaçà,2004,932,478,454,107,624,201
291,430607,Flix,2004,4001,2015,1986,420,2645,936
292,250925,"Floresta, la",2004,180,99,81,18,103,59
293,080826,Fogars de la Selva,2004,1045,545,500,174,726,145
294,080811,Fogars de Montclús,2004,395,213,182,58,262,75
295,170681,Foixà,2004,321,158,163,50,188,83
296,080832,Folgueroles,2004,1833,911,922,326,1234,273
297,250931,Fondarella,2004,741,374,367,103,523,115
298,080847,Fonollosa,2004,1173,601,572,178,818,177
299,170694,Fontanals de Cerdanya,2004,428,208,220,46,301,81
300,170708,Fontanilles,2004,159,91,68,16,112,31
301,170715,Fontcoberta,2004,1145,556,589,180,811,154
302,080850,Font-rubí,2004,1340,708,632,184,837,319
303,250946,Foradada,2004,231,132,99,17,151,63
304,179026,Forallac,2004,1746,857,889,207,1227,312
305,430614,Forès,2004,59,32,27,0,34,25
306,170736,Fornells de la Selva,2004,1760,854,906,328,1219,213
307,170741,Fortià,2004,547,267,280,68,357,122
308,080863,"Franqueses del Vallès, les",2004,14754,7519,7235,2296,10747,1711
309,430629,Freginals,2004,394,207,187,35,249,110
310,250962,"Fuliola, la",2004,1234,620,614,143,766,325
311,250978,Fulleda,2004,114,61,53,11,67,36
312,080902,Gaià,2004,154,77,77,25,104,25
313,430635,"Galera, la",2004,774,394,380,73,486,215
314,080879,Gallifa,2004,209,106,103,38,144,27
315,430640,Gandesa,2004,2882,1484,1398,334,1897,651
316,430653,Garcia,2004,501,261,240,38,301,162
317,430666,"Garidells, els",2004,187,100,87,26,126,35
318,080885,"Garriga, la",2004,12923,6295,6628,2202,8859,1862
319,170754,Garrigàs,2004,321,174,147,32,203,86
320,170767,Garrigoles,2004,141,77,64,13,88,40
321,170773,Garriguella,2004,717,376,341,87,461,169
322,080898,Gavà,2004,43242,21610,21632,6609,30930,5703
323,250984,Gavet de la Conca,2004,311,148,163,28,174,109
324,080919,Gelida,2004,5358,2741,2617,820,3708,830
325,170789,Ger,2004,409,207,202,46,289,74
326,259123,Gimenells i el Pla de la Font,2004,1093,563,530,132,693,268
327,430672,Ginestar,2004,929,489,440,93,570,266
328,170792,Girona,2004,83531,40340,43191,13499,57954,12078
329,080924,Gironella,2004,4884,2377,2507,457,3138,1289
330,080930,Gisclareny,2004,33,18,15,1,29,3
331,430688,Godall,2004,732,379,353,63,441,228
332,250997,Golmés,2004,1443,713,730,184,979,280
333,170806,Gombrèn,2004,236,111,125,22,160,54
334,251001,Gósol,2004,223,118,105,14,154,55
335,080945,"Granada, la",2004,1525,763,762,235,1032,258
336,251018,"Granadella, la",2004,786,397,389,80,444,262
337,080958,Granera,2004,78,54,24,1,61,16
338,251023,"Granja d'Escarp, la",2004,1045,557,488,112,670,263
339,080961,Granollers,2004,56456,27988,28468,8418,39962,8076
340,251039,Granyanella,2004,140,75,65,8,91,41
341,251057,Granyena de les Garrigues,2004,169,94,75,11,98,60
342,251044,Granyena de Segarra,2004,144,76,68,3,81,60
343,430691,Gratallops,2004,222,122,100,25,144,53
344,080977,Gualba,2004,950,498,452,141,674,135
345,170813,Gualta,2004,330,183,147,56,211,63
346,080996,Guardiola de Berguedà,2004,945,489,456,102,585,258
347,430705,"Guiamets, els",2004,315,166,149,30,194,91
348,170828,Guils de Cerdanya,2004,368,186,182,41,268,59
349,251095,Guimerà,2004,361,184,177,27,194,140
350,259031,"Guingueta d'Àneu, la",2004,347,183,164,48,218,81
351,251109,Guissona,2004,4439,2389,2050,715,3163,561
352,251116,Guixers,2004,145,88,57,4,105,36
353,081000,Gurb,2004,2126,1078,1048,377,1462,287
354,430712,Horta de Sant Joan,2004,1219,650,569,138,749,332
355,081017,"Hospitalet de Llobregat, l'",2004,250536,122898,127638,29598,176466,44472
356,081629,"Hostalets de Pierola, els",2004,1716,896,820,241,1205,270
357,170834,Hostalric,2004,3247,1622,1625,467,2284,496
358,081022,Igualada,2004,35195,17347,17848,5068,23862,6265
359,251155,Isona i Conca Dellà,2004,1189,648,541,110,713,366
360,170849,Isòvol,2004,202,114,88,10,139,53
361,251137,Ivars d'Urgell,2004,1806,941,865,204,1140,462
362,251121,Ivars de Noguera,2004,345,177,168,30,221,94
363,251142,Ivorra,2004,151,72,79,14,87,50
364,170852,Jafre,2004,359,194,165,30,224,105
365,170865,"Jonquera, la",2004,2920,1487,1433,414,2121,385
366,081038,Jorba,2004,636,300,336,131,368,137
367,259101,Josa i Tuixén,2004,176,94,82,15,119,42
368,170871,Juià,2004,287,150,137,34,186,67
369,251180,Juncosa,2004,558,310,248,60,329,169
370,251193,Juneda,2004,3023,1545,1478,322,1978,723
371,251214,Les,2004,721,358,363,80,512,129
372,251229,Linyola,2004,2529,1289,1240,319,1685,525
373,081043,"Llacuna, la",2004,875,467,408,114,560,201
374,170887,Lladó,2004,561,282,279,75,354,132
375,251235,Lladorre,2004,212,112,100,17,140,55
376,251240,Lladurs,2004,221,114,107,30,144,47
377,081056,"Llagosta, la",2004,12944,6501,6443,1860,9398,1686
378,170890,Llagostera,2004,6461,3319,3142,995,4284,1182
379,170904,Llambilles,2004,522,264,258,67,362,93
380,170911,Llanars,2004,527,278,249,51,362,114
381,170926,Llançà,2004,4205,2097,2108,537,2832,836
382,251253,Llardecans,2004,583,303,280,62,339,182
383,251266,Llavorsí,2004,330,164,166,34,217,79
384,251207,Lleida,2004,119935,58757,61178,17591,82444,19900
385,170932,Llers,2004,1097,554,543,161,742,194
386,251272,Lles de Cerdanya,2004,246,143,103,21,157,68
387,081075,Lliçà d'Amunt,2004,12009,6166,5843,2165,8534,1310
388,081081,Lliçà de Vall,2004,5696,2969,2727,924,4152,620
389,251288,Llimiana,2004,168,88,80,7,107,54
390,081069,Llinars del Vallès,2004,7834,3917,3917,1305,5484,1045
391,170947,Llívia,2004,1173,619,554,127,857,189
392,430727,"Lloar, el",2004,122,64,58,5,76,41
393,251291,Llobera,2004,223,118,105,18,140,65
394,430733,Llorac,2004,124,58,66,13,73,38
395,430748,Llorenç del Penedès,2004,1904,919,985,328,1260,316
396,170950,Lloret de Mar,2004,26557,13703,12854,4122,19567,2868
397,170963,"Llosses, les",2004,262,145,117,25,185,52
398,081094,Lluçà,2004,261,141,120,41,168,52
399,171024,Maçanet de Cabrenys,2004,721,372,349,69,457,195
400,171030,Maçanet de la Selva,2004,4913,2532,2381,782,3422,709
401,170979,Madremanya,2004,208,92,116,27,138,43
402,170985,Maià de Montcal,2004,365,193,172,39,244,82
403,251333,Maials,2004,950,478,472,85,552,313
404,251305,Maldà,2004,283,151,132,26,166,91
405,081108,Malgrat de Mar,2004,16162,8136,8026,2280,11216,2666
406,081115,Malla,2004,262,122,140,30,189,43
407,081120,Manlleu,2004,18748,9479,9269,2972,12609,3167
408,081136,Manresa,2004,68505,33548,34957,9071,45102,14332
409,430764,Marçà,2004,587,296,291,54,349,184
410,430751,Margalef,2004,127,67,60,9,74,44
411,082423,Marganell,2004,243,108,135,32,148,63
412,081141,Martorell,2004,25010,12880,12130,4012,17632,3366
413,081154,Martorelles,2004,4912,2472,2440,676,3467,769
414,430770,Mas de Barberans,2004,682,346,336,63,424,195
415,171002,Masarac,2004,258,122,136,33,156,69
416,430786,Masdenverge,2004,1007,528,479,117,654,236
417,081167,"Masies de Roda, les",2004,703,349,354,92,478,133
418,081173,"Masies de Voltregà, les",2004,3006,1468,1538,476,2067,463
419,430799,Masllorenç,2004,467,237,230,60,287,120
420,081189,"Masnou, el",2004,21196,10274,10922,3099,14949,3148
421,430803,"Masó, la",2004,287,143,144,27,193,67
422,430810,Maspujols,2004,513,261,252,77,313,123
423,081192,Masquefa,2004,6680,3424,3256,1219,4716,745
424,430825,"Masroig, el",2004,522,257,265,51,302,169
425,251312,Massalcoreig,2004,610,307,303,76,358,176
426,171019,Massanes,2004,588,315,273,70,404,114
427,251327,Massoteres,2004,200,106,94,20,128,52
428,081206,Matadepera,2004,7711,3875,3836,1602,5253,856
429,081213,Mataró,2004,114114,56921,57193,16730,80545,16839
430,081228,Mediona,2004,1757,919,838,213,1178,366
431,251348,Menàrguens,2004,834,435,399,94,502,238
432,170998,Meranges,2004,85,54,31,1,60,24
433,171058,Mieres,2004,356,184,172,60,217,79
434,430831,"Milà, el",2004,178,81,97,26,112,40
435,251351,Miralcamp,2004,1280,641,639,150,860,270
436,430846,Miravet,2004,790,418,372,81,502,207
437,081385,Moià,2004,4872,2442,2430,813,3231,828
438,430859,"Molar, el",2004,284,152,132,26,168,90
439,081234,Molins de Rei,2004,22496,11079,11417,3290,15895,3311
440,251370,Mollerussa,2004,11087,5655,5432,1782,7666,1639
441,171061,Mollet de Peralada,2004,174,90,84,14,103,57
442,081249,Mollet del Vallès,2004,50691,25696,24995,8082,37006,5603
443,171077,Molló,2004,343,174,169,22,225,96
444,251364,"Molsosa, la",2004,130,63,67,14,87,29
445,081287,Monistrol de Calders,2004,657,326,331,99,430,128
446,081271,Monistrol de Montserrat,2004,2654,1377,1277,296,1804,554
447,171096,Montagut i Oix,2004,858,445,413,114,534,210
448,430862,Montblanc,2004,6479,3232,3247,883,4394,1202
449,430884,Montbrió del Camp,2004,1574,788,786,220,992,362
450,081252,Montcada i Reixac,2004,30953,15337,15616,4731,21801,4421
451,081304,Montclar,2004,126,62,64,22,75,29
452,251399,Montellà i Martinet,2004,535,285,250,48,333,154
453,081311,Montesquiu,2004,863,439,424,95,545,223
454,251403,Montferrer i Castellbò,2004,817,441,376,80,578,159
455,430897,Montferri,2004,202,112,90,23,124,55
456,251386,Montgai,2004,793,401,392,94,458,241
457,081265,Montgat,2004,8844,4384,4460,1256,6397,1191
458,081326,Montmajor,2004,459,239,220,48,307,104
459,081332,Montmaneu,2004,196,105,91,17,128,51
460,430901,"Montmell, el",2004,904,495,409,136,630,138
461,081350,Montmeló,2004,8724,4387,4337,1303,6264,1157
462,251425,Montoliu de Lleida,2004,477,243,234,30,325,122
463,251410,Montoliu de Segarra,2004,190,106,84,9,118,63
464,251431,Montornès de Segarra,2004,100,46,54,3,58,39
465,081363,Montornès del Vallès,2004,14065,7189,6876,2222,10215,1628
466,430918,Mont-ral,2004,177,97,80,15,143,19
467,171100,Mont-ras,2004,1761,913,848,270,1254,237
468,430923,Mont-roig del Camp,2004,8209,4228,3981,1106,5881,1222
469,081379,Montseny,2004,313,167,146,27,219,67
470,430939,Móra d'Ebre,2004,4960,2464,2496,722,3251,987
471,430944,Móra la Nova,2004,3113,1594,1519,450,2078,585
472,430957,"Morell, el",2004,2530,1301,1229,424,1728,378
473,430960,"Morera de Montsant, la",2004,178,104,74,21,117,40
474,081290,Muntanyola,2004,397,217,180,66,284,47
475,081398,Mura,2004,212,111,101,21,143,48
476,251459,Nalec,2004,92,46,46,7,51,34
477,250254,Naut Aran,2004,1649,878,771,224,1228,197
478,081402,Navarcles,2004,5498,2731,2767,735,3745,1018
479,081419,Navàs,2004,5658,2814,2844,752,3677,1229
480,171117,Navata,2004,826,409,417,129,522,175
481,251462,Navès,2004,272,133,139,31,170,71
482,081424,"Nou de Berguedà, la",2004,157,81,76,26,91,40
483,430976,"Nou de Gaià, la",2004,409,213,196,52,262,95
484,430982,Nulles,2004,364,179,185,30,242,92
485,251484,Odèn,2004,272,155,117,19,172,81
486,081430,Òdena,2004,2832,1415,1417,449,1917,466
487,171122,Ogassa,2004,260,148,112,26,180,54
488,081458,Olèrdola,2004,2632,1363,1269,441,1817,374
489,081461,Olesa de Bonesvalls,2004,1287,671,616,195,920,172
490,081477,Olesa de Montserrat,2004,20294,10273,10021,3196,14140,2958
491,251497,Oliana,2004,1870,956,914,195,1212,463
492,251500,Oliola,2004,270,148,122,22,187,61
493,251517,Olius,2004,610,304,306,106,405,99
494,081483,Olivella,2004,2011,1072,939,353,1479,179
495,081496,Olost,2004,1187,588,599,148,739,300
496,171143,Olot,2004,30306,15049,15257,4093,19673,6540
497,251522,"Oluges, les",2004,181,95,86,9,118,54
498,081445,Olvan,2004,895,438,457,86,568,241
499,251538,"Omellons, els",2004,253,129,124,23,157,73
500,251543,"Omells de na Gaia, els",2004,156,87,69,13,93,50
501,171156,Ordis,2004,335,179,156,45,231,59
502,251556,Organyà,2004,935,471,464,77,584,274
503,081509,Orís,2004,252,126,126,35,165,52
504,081516,Oristà,2004,603,291,312,58,378,167
505,081521,Orpí,2004,175,93,82,13,124,38
506,081537,Òrrius,2004,330,171,159,28,236,66
507,251569,Os de Balaguer,2004,800,426,374,95,473,232
508,171169,Osor,2004,429,220,209,39,261,129
509,251575,Ossó de Sió,2004,230,117,113,20,148,62
510,081542,Pacs del Penedès,2004,739,377,362,116,532,91
511,081555,Palafolls,2004,6631,3345,3286,1214,4686,731
512,171175,Palafrugell,2004,19813,10094,9719,2881,13583,3349
513,171181,Palamós,2004,16231,8047,8184,2387,11152,2692
514,251581,"Palau d'Anglesola, el",2004,1775,894,881,247,1162,366
515,171194,Palau de Santa Eulàlia,2004,84,50,34,5,62,17
516,171215,Palau-sator,2004,284,147,137,21,186,77
517,171208,Palau-saverdera,2004,1031,514,517,118,675,238
518,081568,Palau-solità i Plegamans,2004,12499,6347,6152,2192,9040,1267
519,431009,"Pallaresos, els",2004,3000,1540,1460,651,2158,191
520,081574,Pallejà,2004,9746,4941,4805,1572,7115,1059
521,430995,"Palma d'Ebre, la",2004,403,192,211,36,234,133
522,089058,"Palma de Cervelló, la",2004,2881,1441,1440,503,2055,323
523,171236,Palol de Revardit,2004,420,222,198,60,282,78
524,171241,Pals,2004,2261,1152,1109,257,1486,518
525,081580,"Papiol, el",2004,3628,1839,1789,553,2543,532
526,171254,Pardines,2004,154,81,73,20,92,42
527,081593,Parets del Vallès,2004,15912,8078,7834,2648,11451,1813
528,171267,Parlavà,2004,349,183,166,33,235,81
529,431016,Passanant i Belltall,2004,209,115,94,3,128,78
530,171289,Pau,2004,454,230,224,55,308,91
531,431021,Paüls,2004,615,307,308,51,386,178
532,171292,Pedret i Marzà,2004,144,74,70,22,91,31
533,251641,Penelles,2004,523,282,241,49,314,160
534,171306,"Pera, la",2004,424,213,211,57,266,101
535,081607,Perafita,2004,371,180,191,45,229,97
536,431037,Perafort,2004,741,384,357,100,536,105
537,171328,Peralada,2004,1491,768,723,216,976,299
538,251654,Peramola,2004,382,206,176,40,225,117
539,431042,"Perelló, el",2004,2282,1222,1060,209,1490,583
540,081614,Piera,2004,11452,5900,5552,1868,7716,1868
541,431055,"Piles, les",2004,188,106,82,23,129,36
542,081635,Pineda de Mar,2004,23539,11936,11603,3483,16710,3346
543,431068,"Pinell de Brai, el",2004,1083,557,526,107,677,299
544,251667,Pinell de Solsonès,2004,215,117,98,24,141,50
545,251673,Pinós,2004,311,169,142,28,201,82
546,431074,Pira,2004,451,218,233,68,287,96
547,431080,"Pla de Santa Maria, el",2004,1820,945,875,268,1217,335
548,081640,"Pla del Penedès, el",2004,891,459,432,103,572,216
549,171334,"Planes d'Hostoles, les",2004,1720,860,860,185,1063,472
550,171349,Planoles,2004,304,164,140,26,200,78
551,259118,"Plans de Sió, els",2004,563,291,272,49,328,186
552,251689,"Poal, el",2004,645,342,303,79,388,178
553,251692,"Pobla de Cérvoles, la",2004,238,127,111,28,133,77
554,081653,"Pobla de Claramunt, la",2004,1942,1018,924,293,1313,336
555,081666,"Pobla de Lillet, la",2004,1357,655,702,100,832,425
556,431093,"Pobla de Mafumet, la",2004,1340,671,669,230,927,183
557,431107,"Pobla de Massaluca, la",2004,433,229,204,24,258,151
558,431114,"Pobla de Montornès, la",2004,1882,1008,874,232,1329,321
559,251713,"Pobla de Segur, la",2004,2961,1464,1497,294,1804,863
560,431129,Poboleda,2004,334,176,158,18,206,110
561,081672,Polinyà,2004,5855,2992,2863,1020,4373,462
562,431135,"Pont d'Armentera, el",2004,571,297,274,51,361,159
563,250306,"Pont de Bar, el",2004,153,83,70,11,91,51
564,171352,Pont de Molins,2004,450,236,214,56,311,83
565,251734,"Pont de Suert, el",2004,2212,1114,1098,264,1452,496
566,081825,"Pont de Vilomara i Rocafort, el",2004,2992,1534,1458,450,2083,459
567,431418,Pontils,2004,138,71,67,8,95,35
568,081688,Pontons,2004,467,256,211,50,330,87
569,171365,Pontós,2004,212,115,97,20,137,55
570,251728,Ponts,2004,2365,1173,1192,313,1505,547
571,171371,Porqueres,2004,3919,1928,1991,649,2708,562
572,431140,Porrera,2004,488,264,224,69,296,123
573,171404,"Port de la Selva, el",2004,922,464,458,122,601,199
574,171387,Portbou,2004,1365,676,689,120,835,410
575,251749,"Portella, la",2004,713,400,313,72,501,140
576,431153,Pradell de la Teixeta,2004,199,100,99,15,132,52
577,431166,Prades,2004,591,312,279,59,369,163
578,431172,Prat de Comte,2004,189,93,96,21,105,63
579,081691,"Prat de Llobregat, el",2004,63148,31708,31440,8915,45860,8373
580,431188,Pratdip,2004,655,345,310,56,425,174
581,081712,Prats de Lluçanès,2004,2700,1350,1350,384,1705,611
582,081705,"Prats de Rei, els",2004,540,273,267,57,350,133
583,251752,Prats i Sansor,2004,217,126,91,31,155,31
584,251765,Preixana,2004,413,208,205,33,233,147
585,251771,Preixens,2004,509,253,256,48,289,172
586,082303,Premià de Dalt,2004,9703,4850,4853,1585,7007,1111
587,081727,Premià de Mar,2004,27464,13739,13725,4130,19626,3708
588,171390,"Preses, les",2004,1644,798,846,249,1105,290
589,251790,Prullans,2004,233,121,112,30,144,59
590,171411,Puigcerdà,2004,8370,4374,3996,1289,5885,1196
591,081748,Puigdàlber,2004,389,184,205,67,260,62
592,251804,Puiggròs,2004,254,129,125,25,161,68
593,431191,Puigpelat,2004,734,381,353,144,494,96
594,081751,Puig-reig,2004,4171,2026,2145,434,2580,1157
595,251811,Puigverd d'Agramunt,2004,244,131,113,24,154,66
596,251826,Puigverd de Lleida,2004,1141,574,567,152,728,261
597,081764,Pujalt,2004,194,101,93,21,126,47
598,081770,"Quar, la",2004,73,42,31,5,52,16
599,171426,Quart,2004,2609,1322,1287,407,1892,310
600,170433,Queralbs,2004,198,113,85,23,118,57
601,431205,Querol,2004,322,179,143,33,242,47
602,171432,Rabós,2004,167,83,84,16,113,38
603,081786,Rajadell,2004,455,239,216,44,320,91
604,431212,Rasquera,2004,842,428,414,86,516,240
605,171447,Regencós,2004,303,165,138,43,195,65
606,081799,Rellinars,2004,572,290,282,82,389,101
607,431227,Renau,2004,91,45,46,18,60,13
608,431233,Reus,2004,96642,47777,48865,15063,66868,14711
609,251832,Rialp,2004,612,312,300,80,437,95
610,431248,"Riba, la",2004,676,363,313,70,436,170
611,431251,Riba-roja d'Ebre,2004,1350,698,652,128,857,365
612,259059,Ribera d'Ondara,2004,462,240,222,43,277,142
613,251850,Ribera d'Urgellet,2004,857,449,408,89,564,204
614,171450,Ribes de Freser,2004,2040,1012,1028,198,1278,564
615,171463,Riells i Viabrea,2004,2818,1481,1337,526,2014,278
616,431264,"Riera de Gaià, la",2004,1203,619,584,168,826,209
617,251863,Riner,2004,273,138,135,32,172,69
618,171479,Ripoll,2004,10717,5259,5458,1233,7072,2412
619,081803,Ripollet,2004,33605,16943,16662,5216,24319,4070
620,259139,Riu de Cerdanya,2004,99,51,48,7,75,17
621,171485,Riudarenes,2004,1581,814,767,215,1072,294
622,171498,Riudaura,2004,406,207,199,39,288,79
623,431270,Riudecanyes,2004,764,390,374,100,485,179
624,431286,Riudecols,2004,1064,555,509,138,715,211
625,171501,Riudellots de la Selva,2004,1735,886,849,258,1173,304
626,431299,Riudoms,2004,5573,2841,2732,856,3767,950
627,171518,Riumors,2004,163,81,82,12,93,58
628,081810,"Roca del Vallès, la",2004,8685,4392,4293,1416,6271,998
629,431303,Rocafort de Queralt,2004,262,138,124,21,149,92
630,431310,Roda de Berà,2004,4281,2267,2014,541,3154,586
631,081831,Roda de Ter,2004,5365,2609,2756,834,3509,1022
632,431325,Rodonyà,2004,455,235,220,70,267,118
633,431331,Roquetes,2004,7017,3621,3396,1004,4745,1268
634,171523,Roses,2004,14687,7376,7311,2462,10220,2005
635,251898,Rosselló,2004,2086,1041,1045,320,1410,356
636,431346,"Rourell, el",2004,309,154,155,40,190,79
637,081846,Rubí,2004,66425,33499,32926,10428,48117,7880
638,081859,Rubió,2004,134,76,58,25,77,32
639,171539,Rupià,2004,196,104,92,17,124,55
640,089019,Rupit i Pruit,2004,344,173,171,27,239,78
641,081878,Sabadell,2004,193338,94421,98917,27813,132644,32881
642,081884,Sagàs,2004,140,71,69,21,86,33
643,251902,Salàs de Pallars,2004,332,169,163,13,199,120
644,081901,Saldes,2004,338,190,148,38,238,62
645,171544,Sales de Llierca,2004,108,56,52,23,75,10
646,081918,Sallent,2004,7103,3439,3664,826,4524,1753
647,431359,Salomó,2004,351,179,172,30,201,120
648,439057,Salou,2004,18238,9528,8710,2720,13829,1689
649,171557,Salt,2004,25912,13559,12353,4165,18299,3448
650,251919,Sanaüja,2004,476,243,233,64,270,142
651,081944,Sant Adrià de Besòs,2004,32921,16267,16654,5142,22569,5210
652,081957,Sant Agustí de Lluçanès,2004,103,54,49,15,66,22
653,081960,Sant Andreu de la Barca,2004,23675,12149,11526,3922,17650,2103
654,081976,Sant Andreu de Llavaneres,2004,8707,4389,4318,1563,6083,1061
655,171576,Sant Andreu Salou,2004,152,71,81,28,84,40
656,171833,Sant Aniol de Finestres,2004,291,157,134,40,198,53
657,081982,Sant Antoni de Vilamajor,2004,4437,2242,2195,740,3104,593
658,081995,Sant Bartomeu del Grau,2004,1084,568,516,195,723,166
659,082009,Sant Boi de Llobregat,2004,80636,40096,40540,11586,57932,11118
660,082016,Sant Boi de Lluçanès,2004,572,291,281,48,364,160
661,431362,Sant Carles de la Ràpita,2004,12594,6305,6289,1733,8435,2426
662,082037,Sant Cebrià de Vallalta,2004,2343,1280,1063,351,1747,245
663,082021,Sant Celoni,2004,14278,7136,7142,2217,9713,2348
664,082042,Sant Climent de Llobregat,2004,3366,1706,1660,561,2427,378
665,171582,Sant Climent Sescebes,2004,453,229,224,60,268,125
666,082055,Sant Cugat del Vallès,2004,65061,32063,32998,12741,45692,6628
667,082068,Sant Cugat Sesgarrigues,2004,843,444,399,134,551,158
668,251961,Sant Esteve de la Sarga,2004,114,72,42,3,76,35
669,082074,Sant Esteve de Palautordera,2004,1798,874,924,348,1229,221
670,082080,Sant Esteve Sesrovires,2004,5978,3083,2895,1022,4307,649
671,171595,Sant Feliu de Buixalleu,2004,752,405,347,103,491,158
672,082107,Sant Feliu de Codines,2004,5027,2590,2437,759,3427,841
673,171609,Sant Feliu de Guíxols,2004,19693,9739,9954,2964,13327,3402
674,082114,Sant Feliu de Llobregat,2004,41954,20674,21280,6172,30512,5270
675,171616,Sant Feliu de Pallerols,2004,1202,595,607,148,764,290
676,082129,Sant Feliu Sasserra,2004,653,326,327,77,432,144
677,171621,Sant Ferriol,2004,198,107,91,29,128,41
678,082093,Sant Fost de Campsentelles,2004,7039,3589,3450,1037,5124,878
679,082135,Sant Fruitós de Bages,2004,6696,3392,3304,1066,4742,888
680,171637,Sant Gregori,2004,2705,1390,1315,410,1893,402
681,251924,Sant Guim de Freixenet,2004,1071,540,531,112,707,252
682,251977,Sant Guim de la Plana,2004,185,95,90,22,109,54
683,171642,Sant Hilari Sacalm,2004,5466,2855,2611,696,3775,995
684,082153,Sant Hipòlit de Voltregà,2004,3150,1568,1582,472,1981,697
685,081939,Sant Iscle de Vallalta,2004,1016,532,484,173,693,150
686,439023,Sant Jaume d'Enveja,2004,3292,1673,1619,419,2153,720
687,082166,Sant Jaume de Frontanyà,2004,27,14,13,0,24,3
688,171655,Sant Jaume de Llierca,2004,778,398,380,105,451,222
689,431378,Sant Jaume dels Domenys,2004,1725,904,821,228,1151,346
690,171674,Sant Joan de les Abadesses,2004,3597,1794,1803,373,2310,914
691,171680,Sant Joan de Mollet,2004,437,211,226,69,267,101
692,082188,Sant Joan de Vilatorrada,2004,9854,4943,4911,1408,6954,1492
693,082172,Sant Joan Despí,2004,30242,14917,15325,4819,21941,3482
694,171851,Sant Joan les Fonts,2004,2660,1328,1332,252,1807,601
695,171668,Sant Jordi Desvalls,2004,647,326,321,71,418,158
696,089030,Sant Julià de Cerdanyola,2004,260,141,119,35,161,64
697,171693,Sant Julià de Ramis,2004,2340,1191,1149,381,1612,347
698,082205,Sant Julià de Vilatorta,2004,2622,1280,1342,462,1790,370
699,179032,Sant Julià del Llor i Bonmatí,2004,991,507,484,131,659,201
700,082212,Sant Just Desvern,2004,14910,7119,7791,2392,10411,2107
701,082227,Sant Llorenç d'Hortons,2004,1939,969,970,313,1292,334
702,171714,Sant Llorenç de la Muga,2004,192,92,100,17,121,54
703,251930,Sant Llorenç de Morunys,2004,936,482,454,89,602,245
704,082233,Sant Llorenç Savall,2004,2210,1112,1098,311,1413,486
705,082251,Sant Martí d'Albars,2004,122,63,59,13,78,31
706,082248,Sant Martí de Centelles,2004,851,436,415,151,563,137
707,171729,Sant Martí de Llémena,2004,509,267,242,89,331,89
708,259025,Sant Martí de Riucorb,2004,697,366,331,47,437,213
709,082264,Sant Martí de Tous,2004,1053,535,518,166,658,229
710,082270,Sant Martí Sarroca,2004,2650,1335,1315,369,1730,551
711,082286,Sant Martí Sesgueioles,2004,341,175,166,52,205,84
712,171735,Sant Martí Vell,2004,185,103,82,28,114,43
713,082299,Sant Mateu de Bages,2004,664,327,337,56,396,212
714,171740,Sant Miquel de Campmajor,2004,199,110,89,24,136,39
715,171753,Sant Miquel de Fluvià,2004,654,340,314,103,431,120
716,171766,Sant Mori,2004,160,79,81,11,113,36
717,171772,Sant Pau de Segúries,2004,656,328,328,73,406,177
718,082310,Sant Pere de Ribes,2004,25280,12755,12525,4431,18121,2728
719,082325,Sant Pere de Riudebitlles,2004,2112,1049,1063,281,1418,413
720,082331,Sant Pere de Torelló,2004,2244,1126,1118,266,1539,439
721,082346,Sant Pere de Vilamajor,2004,3270,1687,1583,604,2243,423
722,171788,Sant Pere Pescador,2004,1618,882,736,217,1111,290
723,081897,Sant Pere Sallavinera,2004,156,79,77,17,89,50
724,082359,Sant Pol de Mar,2004,4464,2283,2181,671,3185,608
725,082362,Sant Quintí de Mediona,2004,1970,1040,930,267,1319,384
726,082378,Sant Quirze de Besora,2004,1985,976,1009,219,1236,530
727,082384,Sant Quirze del Vallès,2004,15729,7804,7925,2968,11366,1395
728,082397,Sant Quirze Safaja,2004,529,282,247,91,387,51
729,251945,Sant Ramon,2004,560,290,270,52,348,160
730,082401,Sant Sadurní d'Anoia,2004,11034,5505,5529,1810,7450,1774
731,082418,Sant Sadurní d'Osormort,2004,91,48,43,13,61,17
732,080983,Sant Salvador de Guardiola,2004,2622,1362,1260,407,1864,351
733,082628,Sant Vicenç de Castellet,2004,7532,3641,3891,927,5005,1600
734,082649,Sant Vicenç de Montalt,2004,4549,2309,2240,892,3165,492
735,082652,Sant Vicenç de Torelló,2004,1877,910,967,309,1161,407
736,082634,Sant Vicenç dels Horts,2004,26477,13373,13104,4419,18817,3241
737,431384,Santa Bàrbara,2004,3617,1854,1763,476,2294,847
738,082439,Santa Cecília de Voltregà,2004,203,110,93,29,139,35
739,082444,Santa Coloma de Cervelló,2004,6652,3324,3328,1246,4705,701
740,171805,Santa Coloma de Farners,2004,10036,5143,4893,1574,6844,1618
741,082457,Santa Coloma de Gramenet,2004,116503,58522,57981,14493,84360,17650
742,431397,Santa Coloma de Queralt,2004,2934,1474,1460,438,1880,616
743,171812,Santa Cristina d'Aro,2004,3735,1949,1786,626,2572,537
744,082460,Santa Eugènia de Berga,2004,2016,1048,968,295,1430,291
745,082476,Santa Eulàlia de Riuprimer,2004,864,443,421,116,582,166
746,082482,Santa Eulàlia de Ronçana,2004,5468,2780,2688,800,3860,808
747,082495,Santa Fe del Penedès,2004,336,165,171,65,221,50
748,171827,Santa Llogaia d'Àlguema,2004,294,156,138,44,205,45
749,082508,Santa Margarida de Montbui,2004,9298,4676,4622,1391,6645,1262
750,082515,Santa Margarida i els Monjos,2004,5701,2995,2706,894,4139,668
751,082589,Santa Maria d'Oló,2004,1047,532,515,108,710,229
752,082536,Santa Maria de Besora,2004,175,90,85,19,109,47
753,082567,Santa Maria de Martorelles,2004,736,378,358,121,506,109
754,082554,Santa Maria de Merlès,2004,153,80,73,21,99,33
755,082573,Santa Maria de Miralles,2004,115,56,59,13,75,27
756,082592,Santa Maria de Palautordera,2004,7499,3879,3620,1222,5224,1053
757,431401,Santa Oliva,2004,2598,1344,1254,421,1763,414
758,171848,Santa Pau,2004,1516,772,744,173,1030,313
759,082606,Santa Perpètua de Mogoda,2004,20844,10547,10297,3129,15476,2239
760,082613,Santa Susanna,2004,2681,1368,1313,479,1861,341
761,081923,Santpedor,2004,5828,2907,2921,878,4068,882
762,431423,Sarral,2004,1492,783,709,185,975,332
763,171864,Sarrià de Ter,2004,3930,1956,1974,527,2708,695
764,252017,Sarroca de Bellera,2004,147,81,66,9,83,55
765,252000,Sarroca de Lleida,2004,437,217,220,33,277,127
766,171870,"Saus, Camallera i Llampaies",2004,713,348,365,83,477,153
767,431439,Savallà del Comtat,2004,72,35,37,11,37,24
768,431444,"Secuita, la",2004,1165,597,568,158,810,197
769,171886,"Selva de Mar, la",2004,207,106,101,22,138,47
770,431457,"Selva del Camp, la",2004,4628,2340,2288,843,3011,774
771,431460,Senan,2004,33,23,10,5,21,7
772,430445,"Sénia, la",2004,5735,2999,2736,773,3950,1012
773,252022,Senterada,2004,93,45,48,6,64,23
774,250352,"Sentiu de Sió, la",2004,466,227,239,33,295,138
775,082671,Sentmenat,2004,6628,3317,3311,1046,4728,854
776,171903,Serinyà,2004,962,502,460,144,639,179
777,252043,Seròs,2004,1827,1011,816,185,1165,477
778,171910,Serra de Daró,2004,178,97,81,22,97,59
779,171925,Setcases,2004,185,95,90,21,124,40
780,252038,"Seu d'Urgell, la",2004,11921,5851,6070,1711,8055,2155
781,082690,Seva,2004,2846,1457,1389,450,1951,445
782,252056,Sidamon,2004,642,329,313,86,438,118
783,171931,Sils,2004,3693,1856,1837,615,2509,569
784,082704,Sitges,2004,23172,11401,11771,3339,16537,3296
785,170524,Siurana,2004,180,92,88,17,115,48
786,082711,Sobremunt,2004,87,40,47,19,53,15
787,252069,"Soleràs, el",2004,407,220,187,29,248,130
788,431476,Solivella,2004,588,288,300,50,348,190
789,252075,Solsona,2004,8127,4117,4010,1219,5404,1504
790,082726,Sora,2004,205,105,100,36,128,41
791,252081,Soriguera,2004,327,178,149,36,205,86
792,252094,Sort,2004,2003,1013,990,263,1333,407
793,252108,Soses,2004,1565,830,735,195,1051,319
794,082732,Subirats,2004,2736,1363,1373,423,1722,591
795,252115,Sudanell,2004,774,418,356,69,527,178
796,252120,Sunyer,2004,287,146,141,30,180,77
797,082747,Súria,2004,6193,3044,3149,823,3885,1485
798,171946,Susqueda,2004,111,62,49,8,77,26
799,082763,Tagamanent,2004,247,128,119,37,173,37
800,082779,Talamanca,2004,114,59,55,10,84,20
801,252154,Talarn,2004,338,169,169,35,214,89
802,252167,Talavera,2004,286,153,133,17,186,83
803,171959,"Tallada d'Empordà, la",2004,338,183,155,32,214,92
804,082785,Taradell,2004,5519,2820,2699,859,3744,916
805,431482,Tarragona,2004,123584,60558,63026,18233,86213,19138
806,252173,Tàrrega,2004,13999,7008,6991,2157,9446,2396
807,252189,Tarrés,2004,121,59,62,9,77,35
808,252192,Tarroja de Segarra,2004,164,82,82,15,92,57
809,082750,Tavèrnoles,2004,285,148,137,37,205,43
810,082802,Tavertet,2004,149,81,68,14,99,36
811,082819,Teià,2004,5751,2881,2870,968,4115,668
812,252206,Térmens,2004,1467,755,712,175,957,335
813,171962,Terrades,2004,167,81,86,10,97,60
814,082798,Terrassa,2004,189212,93865,95347,28495,131301,29416
815,082824,Tiana,2004,6789,3346,3443,1179,4837,773
816,252213,Tírvia,2004,131,66,65,13,85,33
817,252228,Tiurana,2004,37,23,14,3,23,11
818,431495,Tivenys,2004,886,442,444,79,539,268
819,431508,Tivissa,2004,1794,906,888,212,1107,475
820,082830,Tona,2004,6725,3413,3312,1043,4624,1058
821,252234,Torà,2004,1231,635,596,155,787,289
822,082845,Tordera,2004,11719,5970,5749,1692,8121,1906
823,082858,Torelló,2004,12768,6314,6454,1744,8763,2261
824,252249,"Torms, els",2004,184,104,80,17,105,62
825,252252,Tornabous,2004,824,433,391,74,515,235
826,252271,"Torre de Cabdella, la",2004,698,346,352,37,440,221
827,082861,"Torre de Claramunt, la",2004,2936,1506,1430,482,2122,332
828,431515,"Torre de Fontaubella, la",2004,130,62,68,8,81,41
829,431520,"Torre de l'Espanyol, la",2004,731,388,343,64,472,195
830,252265,Torrebesses,2004,298,152,146,31,164,103
831,431536,Torredembarra,2004,12478,6266,6212,1909,8672,1897
832,252287,Torrefarrera,2004,2203,1165,1038,293,1540,370
833,259078,Torrefeta i Florejacs,2004,635,316,319,73,368,194
834,252304,Torregrossa,2004,2285,1152,1133,275,1414,596
835,252311,Torrelameu,2004,583,321,262,44,388,151
836,082877,Torrelavit,2004,1148,609,539,127,763,258
837,082883,Torrelles de Foix,2004,1944,1041,903,281,1287,376
838,082896,Torrelles de Llobregat,2004,4324,2182,2142,786,3101,437
839,171978,Torrent,2004,173,93,80,15,120,38
840,252326,Torres de Segre,2004,1935,998,937,260,1251,424
841,252332,Torre-serona,2004,339,176,163,31,240,68
842,171984,Torroella de Fluvià,2004,418,239,179,43,274,101
843,171997,Torroella de Montgrí,2004,9714,4953,4761,1542,6649,1523
844,431541,Torroja del Priorat,2004,149,89,60,7,105,37
845,172001,Tortellà,2004,728,364,364,80,434,214
846,431554,Tortosa,2004,31979,16016,15963,4257,21396,6326
847,172018,Toses,2004,161,98,63,23,100,38
848,172023,Tossa de Mar,2004,5001,2531,2470,680,3559,762
849,252347,Tremp,2004,5570,2753,2817,712,3394,1464
850,172044,Ullà,2004,917,494,423,140,636,141
851,082900,Ullastrell,2004,1405,716,689,236,977,192
852,172057,Ullastret,2004,221,109,112,29,147,45
853,431567,Ulldecona,2004,6056,3123,2933,789,4011,1256
854,431573,Ulldemolins,2004,484,254,230,35,284,165
855,172039,Ultramort,2004,196,112,84,17,117,62
856,172060,Urús,2004,206,107,99,29,134,43
857,082917,Vacarisses,2004,3931,2064,1867,644,2841,446
858,170144,"Vajol, la",2004,103,59,44,12,68,23
859,172076,"Vall d'en Bas, la",2004,2591,1314,1277,316,1635,640
860,172082,"Vall de Bianya, la",2004,1214,602,612,191,784,239
861,250432,"Vall de Boí, la",2004,1007,549,458,116,723,168
862,259010,Vall de Cardós,2004,354,184,170,41,215,98
863,082922,Vallbona d'Anoia,2004,1190,605,585,170,800,220
864,252385,Vallbona de les Monges,2004,264,130,134,13,154,97
865,082938,Vallcebre,2004,281,146,135,26,176,79
866,431589,Vallclara,2004,114,65,49,8,65,41
867,252402,Vallfogona de Balaguer,2004,1526,765,761,169,1028,329
868,171707,Vallfogona de Ripollès,2004,224,118,106,27,144,53
869,431592,Vallfogona de Riucorb,2004,164,82,82,7,76,81
870,082943,Vallgorguina,2004,1713,885,828,265,1241,207
871,082956,Vallirana,2004,11678,5883,5795,1924,8278,1476
872,172095,Vall-llobrega,2004,597,274,323,104,441,52
873,431606,Vallmoll,2004,1378,722,656,189,978,211
874,082969,Vallromanes,2004,1807,928,879,379,1254,174
875,431613,Valls,2004,22237,11083,11154,3318,15142,3777
876,259062,"Valls d'Aguilar, les",2004,321,177,144,30,203,88
877,252398,"Valls de Valira, les",2004,780,409,371,79,515,186
878,431628,Vandellòs i l'Hospitalet de l'Infant,2004,4839,2457,2382,670,3387,782
879,259097,"Vansa i Fórnols, la",2004,192,101,91,17,117,58
880,082975,Veciana,2004,169,89,80,25,96,48
881,431634,"Vendrell, el",2004,28147,14141,14006,4642,19822,3683
882,172109,Ventalló,2004,669,344,325,65,447,157
883,252424,Verdú,2004,1074,504,570,111,634,329
884,172116,Verges,2004,1155,568,587,136,735,284
885,431649,Vespella de Gaià,2004,241,140,101,22,176,43
886,082981,Vic,2004,36571,18443,18128,5483,24921,6167
887,172121,Vidrà,2004,162,81,81,23,108,31
888,172137,Vidreres,2004,5762,3017,2745,878,4001,883
889,252430,Vielha e Mijaran,2004,4838,2525,2313,755,3605,478
890,431652,Vilabella,2004,782,395,387,88,509,185
891,172142,Vilabertran,2004,822,420,402,112,521,189
892,172155,Vilablareix,2004,2146,1080,1066,363,1587,196
893,082994,Vilada,2004,514,258,256,40,323,151
894,172174,Viladamat,2004,404,207,197,42,261,101
895,172168,Viladasens,2004,172,89,83,23,99,50
896,083015,Viladecans,2004,60033,30282,29751,9495,43977,6561
897,083008,Viladecavalls,2004,6838,3440,3398,1363,4843,632
898,172180,Vilademuls,2004,769,398,371,88,494,187
899,172207,Viladrau,2004,959,499,460,129,650,180
900,172214,Vilafant,2004,4657,2324,2333,796,3336,525
901,083054,Vilafranca del Penedès,2004,34409,17094,17315,5110,24055,5244
902,252445,Vilagrassa,2004,449,231,218,51,282,116
903,172235,Vilajuïga,2004,1035,512,523,162,702,171
904,431750,Vilalba dels Arcs,2004,733,381,352,65,433,235
905,083067,Vilalba Sasserra,2004,544,285,259,78,402,64
906,252458,Vilaller,2004,577,306,271,57,394,126
907,172240,Vilallonga de Ter,2004,425,229,196,29,275,121
908,431665,Vilallonga del Camp,2004,1359,675,684,184,933,242
909,172253,Vilamacolum,2004,294,152,142,40,192,62
910,172266,Vilamalla,2004,878,463,415,135,641,102
911,172272,Vilamaniscle,2004,160,89,71,32,91,37
912,252477,Vilamòs,2004,166,91,75,31,112,23
913,172288,Vilanant,2004,327,164,163,30,227,70
914,431671,Vilanova d'Escornalbou,2004,469,240,229,54,337,78
915,252483,Vilanova de Bellpuig,2004,1116,549,567,103,678,335
916,252496,Vilanova de l'Aguda,2004,248,124,124,28,132,88
917,252542,Vilanova de la Barca,2004,939,472,467,110,592,237
918,252509,Vilanova de Meià,2004,433,226,207,31,277,125
919,431687,Vilanova de Prades,2004,157,83,74,13,96,48
920,083036,Vilanova de Sau,2004,339,157,182,42,232,65
921,252516,Vilanova de Segrià,2004,765,388,377,78,541,146
922,083020,Vilanova del Camí,2004,11121,5634,5487,1864,7998,1259
923,089024,Vilanova del Vallès,2004,2932,1496,1436,524,2037,371
924,083073,Vilanova i la Geltrú,2004,59409,29328,30081,8688,41197,9524
925,431690,Vilaplana,2004,550,281,269,62,337,151
926,431704,Vila-rodona,2004,1070,585,485,100,716,254
927,172305,Vila-sacra,2004,483,244,239,50,356,77
928,252521,Vila-sana,2004,547,267,280,67,331,149
929,431711,Vila-seca,2004,14998,7551,7447,2299,10946,1753
930,082140,Vilassar de Dalt,2004,7902,3949,3953,996,5637,1269
931,082191,Vilassar de Mar,2004,18558,9069,9489,3055,13001,2502
932,172229,Vilaür,2004,136,67,69,19,95,22
933,431726,Vilaverd,2004,416,211,205,46,252,118
934,431732,"Vilella Alta, la",2004,137,72,65,16,82,39
935,431747,"Vilella Baixa, la",2004,191,103,88,18,118,55
936,172333,Vilobí d'Onyar,2004,2504,1359,1145,355,1742,407
937,083041,Vilobí del Penedès,2004,970,500,470,130,655,185
938,172327,Vilopriu,2004,175,87,88,21,104,50
939,252537,"Vilosell, el",2004,242,120,122,16,157,69
940,431763,Vimbodí i Poblet,2004,1039,568,471,97,633,309
941,252555,Vinaixa,2004,586,292,294,50,378,158
942,431779,Vinebre,2004,459,235,224,29,312,118
943,431785,Vinyols i els Arcs,2004,1418,753,665,192,986,240
944,083089,Viver i Serrateix,2004,195,101,94,20,131,44
945,430521,Xerta,2004,1244,632,612,146,762,336
946,000000,Catalunya,2004,6813319,3366329,3446990,950482,4710344,1152493
0,250019,Abella de la Conca,2005,183,99,84,27,115,41
1,080018,Abrera,2005,9839,5088,4751,1588,7344,907
2,250024,Àger,2005,485,268,217,30,284,171
3,250030,Agramunt,2005,5355,2833,2522,741,3598,1016
4,080023,Aguilar de Segarra,2005,235,123,112,28,146,61
5,170010,Agullana,2005,759,393,366,92,484,183
6,080142,Aiguafreda,2005,2308,1122,1186,314,1549,445
7,430017,Aiguamúrcia,2005,719,392,327,71,507,141
8,170025,Aiguaviva,2005,601,304,297,105,415,81
9,250387,Aitona,2005,2322,1211,1111,253,1514,555
10,250045,"Alamús, els",2005,734,384,350,77,494,163
11,250058,Alàs i Cerc,2005,406,225,181,43,261,102
12,250061,"Albagés, l'",2005,491,263,228,63,295,133
13,170031,Albanyà,2005,131,72,59,23,87,21
14,250077,Albatàrrec,2005,1444,776,668,228,976,240
15,250083,Albesa,2005,1561,785,776,199,1011,351
16,250096,"Albi, l'",2005,837,433,404,93,548,196
17,430022,Albinyana,2005,2036,1041,995,307,1395,334
18,430038,"Albiol, l'",2005,333,173,160,73,223,37
19,170046,Albons,2005,589,308,281,78,399,112
20,430043,Alcanar,2005,9311,4793,4518,1194,6397,1720
21,250100,Alcanó,2005,251,127,124,24,148,79
22,250117,Alcarràs,2005,5241,2641,2600,735,3504,1002
23,250122,Alcoletge,2005,2093,1112,981,291,1488,314
24,430056,Alcover,2005,4405,2273,2132,707,2979,719
25,439044,"Aldea, l'",2005,3693,1916,1777,435,2460,798
26,430069,Aldover,2005,833,405,428,63,542,228
27,430075,"Aleixar, l'",2005,767,390,377,119,477,171
28,080039,Alella,2005,8940,4427,4513,1330,6551,1059
29,430081,Alfara de Carles,2005,360,189,171,27,227,106
30,250138,Alfarràs,2005,3260,1705,1555,448,2137,675
31,250143,Alfés,2005,318,171,147,31,200,87
32,430094,Alforja,2005,1488,770,718,182,978,328
33,250156,Algerri,2005,482,241,241,35,293,154
34,250169,Alguaire,2005,3023,1580,1443,387,2030,606
35,250175,Alins,2005,248,126,122,17,146,85
36,430108,Alió,2005,384,194,190,36,258,90
37,250194,Almacelles,2005,6056,3173,2883,799,4085,1172
38,250208,Almatret,2005,450,239,211,34,244,172
39,250215,Almenar,2005,3599,1890,1709,438,2371,790
40,430115,Almoster,2005,1140,586,554,241,771,128
41,250220,Alòs de Balaguer,2005,179,103,76,13,111,55
42,170062,Alp,2005,1389,726,663,177,1054,158
43,080044,Alpens,2005,288,153,135,47,182,59
44,250236,Alpicat,2005,4984,2486,2498,799,3533,652
45,250241,Alt Àneu,2005,454,258,196,53,306,95
46,430120,Altafulla,2005,3993,2011,1982,689,2844,460
47,170078,Amer,2005,2237,1111,1126,253,1462,522
48,430136,"Ametlla de Mar, l'",2005,6438,3318,3120,847,4393,1198
49,080057,"Ametlla del Vallès, l'",2005,7319,3652,3667,1442,5103,774
50,439060,"Ampolla, l'",2005,2518,1278,1240,291,1701,526
51,430141,Amposta,2005,18719,9463,9256,2646,12947,3126
52,170084,Anglès,2005,5191,2687,2504,707,3464,1020
53,250273,Anglesola,2005,1290,656,634,137,841,312
54,250292,Arbeca,2005,2484,1265,1219,312,1554,618
55,430167,"Arboç, l'",2005,4562,2464,2098,734,3132,696
56,430154,Arbolí,2005,112,61,51,1,83,28
57,170097,Arbúcies,2005,6002,3208,2794,907,4106,989
58,080060,Arenys de Mar,2005,13860,6760,7100,1983,9453,2424
59,080076,Arenys de Munt,2005,7369,3682,3687,1230,5094,1045
60,170101,Argelaguer,2005,408,218,190,68,246,94
61,080082,Argençola,2005,210,117,93,24,142,44
62,430173,"Argentera, l'",2005,161,94,67,13,117,31
63,080095,Argentona,2005,10868,5374,5494,1859,7524,1485
64,170118,"Armentera, l'",2005,765,379,386,75,497,193
65,430189,Arnes,2005,514,268,246,45,280,189
66,250313,Arres,2005,67,39,28,7,48,12
67,250328,Arsèguel,2005,92,46,46,8,64,20
68,080109,Artés,2005,4949,2499,2450,718,3341,890
69,250334,Artesa de Lleida,2005,1414,744,670,191,900,323
70,250349,Artesa de Segre,2005,3696,1940,1756,477,2433,786
71,430192,Ascó,2005,1601,806,795,172,1052,377
72,250365,Aspa,2005,263,130,133,23,151,89
73,250371,"Avellanes i Santa Linya, les",2005,467,260,207,30,295,142
74,080116,Avià,2005,2015,1016,999,269,1325,421
75,080121,Avinyó,2005,2067,1038,1029,315,1315,437
76,170123,Avinyonet de Puigventós,2005,1101,557,544,193,793,115
77,080137,Avinyonet del Penedès,2005,1529,822,707,208,1045,276
78,080155,Badalona,2005,218553,109979,108574,30487,156897,31169
79,089045,Badia del Vallès,2005,14230,7091,7139,2142,10159,1929
80,080168,Bagà,2005,2160,1056,1104,238,1396,526
81,250390,Baix Pallars,2005,380,213,167,32,240,108
82,250404,Balaguer,2005,15281,7686,7595,2335,10266,2680
83,080174,Balenyà,2005,3421,1699,1722,532,2401,488
84,080180,Balsareny,2005,3277,1620,1657,401,2179,697
85,430206,Banyeres del Penedès,2005,2303,1211,1092,352,1660,291
86,170157,Banyoles,2005,16938,8499,8439,2868,11228,2842
87,250411,Barbens,2005,832,458,374,77,530,225
88,430213,Barberà de la Conca,2005,488,252,236,64,314,110
89,082520,Barberà del Vallès,2005,27827,13916,13911,4369,20428,3030
90,080193,Barcelona,2005,1593075,754463,838612,186473,1077380,329222
91,250426,"Baronia de Rialb, la",2005,277,150,127,40,163,74
92,170160,Bàscara,2005,877,464,413,96,583,198
93,250447,Bassella,2005,261,134,127,37,150,74
94,430228,Batea,2005,2094,1068,1026,231,1329,534
95,250450,Bausen,2005,52,33,19,0,24,28
96,080207,Begues,2005,5470,2741,2729,1186,3783,501
97,170139,Begur,2005,3986,2051,1935,607,2768,611
98,250463,Belianes,2005,615,319,296,85,350,180
99,251706,Bellaguarda,2005,360,189,171,32,195,133
100,170182,Bellcaire d'Empordà,2005,668,346,322,95,437,136
101,250479,Bellcaire d'Urgell,2005,1274,611,663,125,770,379
102,250485,Bell-lloc d'Urgell,2005,2255,1120,1135,310,1449,496
103,250498,Bellmunt d'Urgell,2005,228,108,120,30,138,60
104,430234,Bellmunt del Priorat,2005,320,162,158,22,188,110
105,080214,Bellprat,2005,89,50,39,7,60,22
106,250501,Bellpuig,2005,4376,2259,2117,578,2947,851
107,430249,Bellvei,2005,1643,883,760,237,1150,256
108,250518,Bellver de Cerdanya,2005,1809,953,856,201,1260,348
109,250523,Bellvís,2005,2294,1184,1110,247,1437,610
110,250539,Benavent de Segrià,2005,1217,629,588,205,854,158
111,430252,Benifallet,2005,810,401,409,76,461,273
112,430265,Benissanet,2005,1169,617,552,116,777,276
113,080229,Berga,2005,16175,7977,8198,2042,10637,3496
114,170195,Besalú,2005,2211,1088,1123,262,1437,512
115,170209,Bescanó,2005,3762,1893,1869,645,2512,605
116,170216,Beuda,2005,147,75,72,21,107,19
117,080235,Bigues i Riells del Fai,2005,7155,3708,3447,1245,5162,748
118,250557,Biosca,2005,235,120,115,27,136,72
119,170221,"Bisbal d'Empordà, la",2005,9196,4594,4602,1379,6234,1583
120,430271,"Bisbal de Falset, la",2005,254,136,118,25,157,72
121,430287,"Bisbal del Penedès, la",2005,2680,1427,1253,382,1858,440
122,172348,Biure,2005,237,120,117,30,160,47
123,430290,Blancafort,2005,421,222,199,51,258,112
124,170237,Blanes,2005,36711,18503,18208,5621,25939,5151
125,170293,Boadella i les Escaules,2005,240,116,124,29,163,48
126,170242,Bolvir,2005,287,148,139,23,211,53
127,430304,Bonastre,2005,494,265,229,65,345,84
128,250576,"Bòrdes, Es",2005,235,117,118,22,176,37
129,170255,Bordils,2005,1501,776,725,228,1016,257
130,250582,"Borges Blanques, les",2005,5519,2799,2720,706,3622,1191
131,430311,"Borges del Camp, les",2005,1855,932,923,258,1256,341
132,170268,Borrassà,2005,586,308,278,58,392,136
133,080240,Borredà,2005,518,266,252,69,338,111
134,250595,Bossòst,2005,1021,533,488,136,718,167
135,430326,Bot,2005,783,396,387,64,453,266
136,430332,Botarell,2005,933,497,436,156,672,105
137,250560,Bovera,2005,377,191,186,19,214,144
138,430347,Bràfim,2005,636,331,305,63,438,135
139,170274,Breda,2005,3625,1853,1772,532,2402,691
140,080253,"Bruc, el",2005,1543,830,713,240,1091,212
141,080266,"Brull, el",2005,202,108,94,23,138,41
142,170280,Brunyola i Sant Martí Sapresa,2005,353,178,175,31,216,106
143,430350,Cabacés,2005,340,180,160,32,212,96
144,250609,Cabanabona,2005,122,57,65,10,60,52
145,170314,Cabanelles,2005,249,141,108,23,168,58
146,170307,Cabanes,2005,911,475,436,145,593,173
147,080272,"Cabanyes, les",2005,682,350,332,126,467,89
148,250616,Cabó,2005,108,61,47,7,64,37
149,430363,Cabra del Camp,2005,859,461,398,122,595,142
150,080288,Cabrera d'Anoia,2005,944,509,435,136,690,118
151,080291,Cabrera de Mar,2005,4119,2102,2017,697,2924,498
152,080305,Cabrils,2005,6238,3067,3171,1316,4344,578
153,170329,Cadaqués,2005,2623,1266,1357,375,1854,394
154,080312,Calaf,2005,3271,1711,1560,399,2257,615
155,430379,Calafell,2005,18905,9628,9277,2578,13717,2610
156,080348,Calders,2005,810,411,399,128,523,159
157,080327,Caldes d'Estrac,2005,2508,1219,1289,347,1715,446
158,170335,Caldes de Malavella,2005,5280,2664,2616,840,3596,844
159,080333,Caldes de Montbui,2005,15536,7771,7765,2387,10827,2322
160,080351,Calella,2005,16927,8413,8514,2358,11787,2782
161,080370,Calldetenes,2005,2183,1140,1043,342,1545,296
162,080386,Callús,2005,1477,722,755,193,982,302
163,080364,Calonge de Segarra,2005,206,107,99,30,114,62
164,170340,Calonge i Sant Antoni,2005,9162,4671,4491,1387,6386,1389
165,250621,Camarasa,2005,926,474,452,70,569,287
166,439039,Camarles,2005,3279,1685,1594,443,2176,660
167,430385,Cambrils,2005,26209,13123,13086,4294,18833,3082
168,170353,Camós,2005,673,350,323,79,448,146
169,170366,Campdevànol,2005,3432,1711,1721,383,2211,838
170,170372,Campelles,2005,114,60,54,4,82,28
171,080399,Campins,2005,354,180,174,64,249,41
172,170388,Campllong,2005,368,188,180,72,224,72
173,170391,Camprodon,2005,2446,1208,1238,262,1623,561
174,250637,Canejan,2005,107,56,51,12,63,32
175,170405,Canet d'Adri,2005,564,292,272,69,395,100
176,080403,Canet de Mar,2005,12429,6149,6280,1784,8517,2128
177,080410,Canovelles,2005,14668,7675,6993,2209,10681,1778
178,080425,Cànoves i Samalús,2005,2375,1236,1139,400,1658,317
179,170412,Cantallops,2005,271,137,134,29,163,79
180,080431,Canyelles,2005,3127,1650,1477,536,2283,308
181,430398,Capafonts,2005,110,60,50,1,72,37
182,430402,Capçanes,2005,400,195,205,35,266,99
183,080446,Capellades,2005,5302,2592,2710,785,3591,926
184,170427,Capmany,2005,500,264,236,55,321,124
185,080459,Capolat,2005,79,41,38,6,54,19
186,080462,Cardedeu,2005,15018,7456,7562,2629,10548,1841
187,080478,Cardona,2005,5232,2538,2694,574,3378,1280
188,080484,Carme,2005,726,372,354,81,473,172
189,430419,Caseres,2005,318,154,164,34,182,102
190,170448,Cassà de la Selva,2005,8612,4422,4190,1315,5726,1571
191,080497,Casserres,2005,1548,751,797,147,980,421
192,080575,Castell de l'Areny,2005,60,35,25,8,40,12
193,259046,Castell de Mur,2005,173,91,82,21,98,54
194,250642,Castellar de la Ribera,2005,158,76,82,23,94,41
195,080522,Castellar de n'Hug,2005,184,94,90,12,128,44
196,080500,Castellar del Riu,2005,152,84,68,23,103,26
197,080517,Castellar del Vallès,2005,20437,10196,10241,3611,14329,2497
198,080538,Castellbell i el Vilar,2005,3307,1688,1619,438,2265,604
199,080543,Castellbisbal,2005,10842,5591,5251,2070,7724,1048
200,080556,Castellcir,2005,528,281,247,93,346,89
201,250674,Castelldans,2005,991,533,458,90,632,269
202,080569,Castelldefels,2005,56718,28317,28401,9354,41787,5577
203,080581,Castellet i la Gornal,2005,1798,922,876,285,1187,326
204,170464,Castellfollit de la Roca,2005,964,490,474,102,618,244
205,080608,Castellfollit de Riubregós,2005,202,102,100,19,131,52
206,080594,Castellfollit del Boix,2005,403,201,202,65,250,88
207,080615,Castellgalí,2005,1282,681,601,200,880,202
208,080620,Castellnou de Bages,2005,791,423,368,138,580,73
209,250680,Castellnou de Seana,2005,737,385,352,83,458,196
210,170470,Castelló d'Empúries,2005,9167,4743,4424,1458,6361,1348
211,250693,Castelló de Farfanya,2005,583,300,283,50,363,170
212,080636,Castellolí,2005,459,223,236,68,310,81
213,170486,Castell-Platja d'Aro,2005,9239,4781,4458,1207,6868,1164
214,250707,Castellserà,2005,1128,577,551,114,699,315
215,080641,Castellterçol,2005,2195,1077,1118,299,1424,472
216,430424,Castellvell del Camp,2005,2340,1166,1174,459,1673,208
217,080654,Castellví de la Marca,2005,1563,792,771,225,1019,319
218,080667,Castellví de Rosanes,2005,1370,701,669,242,964,164
219,430430,"Catllar, el",2005,3221,1664,1557,516,2356,349
220,250714,Cava,2005,60,36,24,3,39,18
221,171899,"Cellera de Ter, la",2005,2064,1054,1010,277,1370,417
222,170499,Celrà,2005,3510,1774,1736,664,2416,430
223,080673,Centelles,2005,6493,3176,3317,930,4390,1173
224,082687,Cercs,2005,1342,688,654,140,833,369
225,082665,Cerdanyola del Vallès,2005,57114,28408,28706,8545,42035,6534
226,080689,Cervelló,2005,7350,3760,3590,1103,5427,820
227,250729,Cervera,2005,8942,4659,4283,1404,6112,1426
228,250735,Cervià de les Garrigues,2005,864,450,414,76,536,252
229,170502,Cervià de Ter,2005,796,396,400,127,504,165
230,170519,Cistella,2005,239,120,119,31,152,56
231,250740,Ciutadilla,2005,235,129,106,24,148,63
232,250753,Clariana de Cardener,2005,149,78,71,21,110,18
233,250766,"Cogul, el",2005,220,117,103,16,132,72
234,170545,Colera,2005,606,312,294,50,404,152
235,250772,Coll de Nargó,2005,600,315,285,51,383,166
236,080692,Collbató,2005,3337,1747,1590,637,2387,313
237,430458,Colldejou,2005,193,108,85,15,143,35
238,080706,Collsuspina,2005,306,162,144,46,216,44
239,170558,Colomers,2005,207,104,103,13,130,64
240,251636,"Coma i la Pedra, la",2005,270,160,110,23,187,60
241,251615,Conca de Dalt,2005,439,227,212,38,260,141
242,430461,Conesa,2005,133,75,58,14,84,35
243,430477,Constantí,2005,5608,2981,2627,866,3956,786
244,080713,Copons,2005,289,142,147,30,190,69
245,430483,Corbera d'Ebre,2005,1117,598,519,121,706,290
246,080728,Corbera de Llobregat,2005,12025,6174,5851,2145,8621,1259
247,250788,Corbins,2005,1311,710,601,163,900,248
248,170577,Corçà,2005,1232,622,610,129,878,225
249,080734,Cornellà de Llobregat,2005,84131,41815,42316,11395,58769,13967
250,170561,Cornellà del Terri,2005,2017,1012,1005,260,1364,393
251,430496,Cornudella de Montsant,2005,948,488,460,91,616,241
252,430509,Creixell,2005,2441,1258,1183,333,1664,444
253,170583,Crespià,2005,241,123,118,34,144,63
254,179011,"Cruïlles, Monells i Sant Sadurní de l'Heura",2005,1233,614,619,163,872,198
255,080749,Cubelles,2005,10617,5511,5106,1624,7648,1345
256,250791,Cubells,2005,395,201,194,54,209,132
257,430516,Cunit,2005,9017,4660,4357,1290,6369,1358
258,170600,Darnius,2005,543,279,264,52,348,143
259,170617,Das,2005,171,92,79,17,122,32
260,439018,Deltebre,2005,10943,5548,5395,1358,7464,2121
261,080752,Dosrius,2005,4093,2045,2048,681,3024,388
262,430537,Duesaigües,2005,205,126,79,15,128,62
263,170622,"Escala, l'",2005,8311,4283,4028,1092,5810,1409
264,080765,Esparreguera,2005,20740,10631,10109,3467,14834,2439
265,170638,Espinelves,2005,193,104,89,20,117,56
266,250812,"Espluga Calba, l'",2005,448,238,210,31,290,127
267,430542,"Espluga de Francolí, l'",2005,3814,1906,1908,495,2463,856
268,080771,Esplugues de Llobregat,2005,46550,22878,23672,5934,33569,7047
269,170643,Espolla,2005,395,199,196,39,252,104
270,170656,Esponellà,2005,432,212,220,58,297,77
271,250827,Espot,2005,374,207,167,47,268,59
272,080787,"Espunyola, l'",2005,270,133,137,33,167,70
273,082541,"Esquirol, l'",2005,2200,1082,1118,320,1416,464
274,250886,Estamariu,2005,119,64,55,9,74,36
275,080790,"Estany, l'",2005,393,186,207,41,243,109
276,250851,Estaràs,2005,181,100,81,22,108,51
277,250864,Esterri d'Àneu,2005,773,379,394,95,519,159
278,250870,Esterri de Cardós,2005,70,33,37,6,46,18
279,430555,Falset,2005,2658,1335,1323,370,1737,551
280,170059,"Far d'Empordà, el",2005,448,231,217,73,292,83
281,250899,Farrera,2005,105,60,45,8,78,19
282,430568,"Fatarella, la",2005,1180,599,581,110,726,344
283,430574,"Febró, la",2005,58,35,23,1,46,11
284,081347,Figaró-Montmany,2005,1020,523,497,143,663,214
285,080804,Fígols,2005,48,27,21,4,27,17
286,259084,Fígols i Alinyà,2005,273,151,122,12,162,99
287,430580,"Figuera, la",2005,190,100,90,13,133,44
288,170669,Figueres,2005,38884,19160,19724,6049,26642,6193
289,430593,Figuerola del Camp,2005,318,148,170,52,195,71
290,170675,Flaçà,2005,983,496,487,121,660,202
291,430607,Flix,2005,4029,2061,1968,427,2704,898
292,250925,"Floresta, la",2005,184,100,84,20,107,57
293,080826,Fogars de la Selva,2005,1171,611,560,215,809,147
294,080811,Fogars de Montclús,2005,417,224,193,64,279,74
295,170681,Foixà,2005,329,169,160,44,204,81
296,080832,Folgueroles,2005,1905,953,952,355,1276,274
297,250931,Fondarella,2005,786,392,394,109,560,117
298,080847,Fonollosa,2005,1208,616,592,182,842,184
299,170694,Fontanals de Cerdanya,2005,436,219,217,43,315,78
300,170708,Fontanilles,2005,164,93,71,15,116,33
301,170715,Fontcoberta,2005,1137,553,584,166,830,141
302,080850,Font-rubí,2005,1382,735,647,193,878,311
303,250946,Foradada,2005,213,126,87,16,138,59
304,179026,Forallac,2005,1745,863,882,224,1214,307
305,430614,Forès,2005,62,34,28,0,37,25
306,170736,Fornells de la Selva,2005,1884,912,972,359,1305,220
307,170741,Fortià,2005,572,291,281,74,379,119
308,080863,"Franqueses del Vallès, les",2005,15196,7792,7404,2398,11071,1727
309,430629,Freginals,2005,406,209,197,37,257,112
310,250962,"Fuliola, la",2005,1204,606,598,135,751,318
311,250978,Fulleda,2005,121,63,58,9,77,35
312,080902,Gaià,2005,157,79,78,25,107,25
313,430635,"Galera, la",2005,818,411,407,88,516,214
314,080879,Gallifa,2005,210,106,104,36,148,26
315,430640,Gandesa,2005,3028,1567,1461,375,2002,651
316,430653,Garcia,2005,498,260,238,38,301,159
317,430666,"Garidells, els",2005,189,101,88,25,129,35
318,080885,"Garriga, la",2005,13472,6539,6933,2337,9261,1874
319,170754,Garrigàs,2005,332,181,151,35,214,83
320,170767,Garrigoles,2005,156,84,72,15,98,43
321,170773,Garriguella,2005,735,390,345,96,485,154
322,080898,Gavà,2005,44210,22092,22118,6869,31559,5782
323,250984,Gavet de la Conca,2005,313,147,166,25,175,113
324,080919,Gelida,2005,5650,2895,2755,914,3916,820
325,170789,Ger,2005,433,225,208,51,312,70
326,259123,Gimenells i el Pla de la Font,2005,1110,581,529,125,721,264
327,430672,Ginestar,2005,950,502,448,96,605,249
328,170792,Girona,2005,86672,41998,44674,14047,60485,12140
329,080924,Gironella,2005,4853,2364,2489,469,3149,1235
330,080930,Gisclareny,2005,36,20,16,1,30,5
331,430688,Godall,2005,749,391,358,73,442,234
332,250997,Golmés,2005,1508,749,759,207,1022,279
333,170806,Gombrèn,2005,229,110,119,20,155,54
334,251001,Gósol,2005,223,118,105,12,154,57
335,080945,"Granada, la",2005,1594,804,790,241,1090,263
336,251018,"Granadella, la",2005,790,408,382,84,448,258
337,080958,Granera,2005,79,54,25,1,62,16
338,251023,"Granja d'Escarp, la",2005,1056,565,491,106,689,261
339,080961,Granollers,2005,57796,28744,29052,8720,40982,8094
340,251039,Granyanella,2005,139,75,64,8,89,42
341,251057,Granyena de les Garrigues,2005,170,95,75,9,103,58
342,251044,Granyena de Segarra,2005,138,73,65,3,77,58
343,430691,Gratallops,2005,223,122,101,29,142,52
344,080977,Gualba,2005,988,528,460,145,713,130
345,170813,Gualta,2005,359,212,147,54,244,61
346,080996,Guardiola de Berguedà,2005,926,474,452,112,566,248
347,430705,"Guiamets, els",2005,327,177,150,34,197,96
348,170828,Guils de Cerdanya,2005,392,206,186,39,290,63
349,251095,Guimerà,2005,360,184,176,22,201,137
350,259031,"Guingueta d'Àneu, la",2005,354,187,167,50,225,79
351,251109,Guissona,2005,4874,2650,2224,776,3546,552
352,251116,Guixers,2005,144,86,58,5,103,36
353,081000,Gurb,2005,2189,1111,1078,401,1505,283
354,430712,Horta de Sant Joan,2005,1241,670,571,135,787,319
355,081017,"Hospitalet de Llobregat, l'",2005,252884,124300,128584,30103,178383,44398
356,081629,"Hostalets de Pierola, els",2005,1879,988,891,291,1319,269
357,170834,Hostalric,2005,3459,1768,1691,511,2451,497
358,081022,Igualada,2005,35933,17764,18169,5250,24456,6227
359,251155,Isona i Conca Dellà,2005,1149,630,519,102,696,351
360,170849,Isòvol,2005,231,134,97,14,166,51
361,251137,Ivars d'Urgell,2005,1848,986,862,194,1208,446
362,251121,Ivars de Noguera,2005,353,187,166,27,233,93
363,251142,Ivorra,2005,148,69,79,15,85,48
364,170852,Jafre,2005,377,211,166,30,244,103
365,170865,"Jonquera, la",2005,3016,1556,1460,413,2228,375
366,081038,Jorba,2005,665,324,341,128,401,136
367,259101,Josa i Tuixén,2005,170,87,83,12,117,41
368,170871,Juià,2005,298,161,137,38,196,64
369,251180,Juncosa,2005,551,306,245,61,327,163
370,251193,Juneda,2005,3222,1674,1548,398,2119,705
371,251214,Les,2005,829,411,418,92,606,131
372,251229,Linyola,2005,2587,1330,1257,346,1721,520
373,081043,"Llacuna, la",2005,869,463,406,103,570,196
374,170887,Lladó,2005,562,285,277,75,361,126
375,251235,Lladorre,2005,224,114,110,18,153,53
376,251240,Lladurs,2005,215,112,103,26,140,49
377,081056,"Llagosta, la",2005,13455,6747,6708,1938,9758,1759
378,170890,Llagostera,2005,6764,3497,3267,1046,4535,1183
379,170904,Llambilles,2005,585,294,291,86,403,96
380,170911,Llanars,2005,546,290,256,53,381,112
381,170926,Llançà,2005,4371,2173,2198,543,2969,859
382,251253,Llardecans,2005,570,295,275,56,341,173
383,251266,Llavorsí,2005,334,170,164,37,218,79
384,251207,Lleida,2005,124709,61796,62913,18093,86836,19780
385,170932,Llers,2005,1145,581,564,166,783,196
386,251272,Lles de Cerdanya,2005,237,139,98,19,152,66
387,081075,Lliçà d'Amunt,2005,12439,6413,6026,2275,8766,1398
388,081081,Lliçà de Vall,2005,5821,3013,2808,966,4215,640
389,251288,Llimiana,2005,168,92,76,9,105,54
390,081069,Llinars del Vallès,2005,8166,4076,4090,1379,5705,1082
391,170947,Llívia,2005,1252,670,582,136,932,184
392,430727,"Lloar, el",2005,126,70,56,8,77,41
393,251291,Llobera,2005,224,118,106,19,142,63
394,430733,Llorac,2005,114,56,58,14,66,34
395,430748,Llorenç del Penedès,2005,1997,975,1022,343,1340,314
396,170950,Lloret de Mar,2005,29445,15374,14071,4523,21913,3009
397,170963,"Llosses, les",2005,261,140,121,24,185,52
398,081094,Lluçà,2005,249,134,115,37,166,46
399,171024,Maçanet de Cabrenys,2005,734,381,353,68,472,194
400,171030,Maçanet de la Selva,2005,5354,2765,2589,851,3753,750
401,170979,Madremanya,2005,222,101,121,27,151,44
402,170985,Maià de Montcal,2005,374,193,181,40,251,83
403,251333,Maials,2005,961,480,481,88,567,306
404,251305,Maldà,2005,293,156,137,34,174,85
405,081108,Malgrat de Mar,2005,16833,8511,8322,2379,11739,2715
406,081115,Malla,2005,258,120,138,28,189,41
407,081120,Manlleu,2005,19488,9887,9601,3177,13138,3173
408,081136,Manresa,2005,70343,34565,35778,9484,46721,14138
409,430764,Marçà,2005,621,306,315,66,379,176
410,430751,Margalef,2005,125,69,56,13,71,41
411,082423,Marganell,2005,275,122,153,35,179,61
412,081141,Martorell,2005,25766,13312,12454,4170,18176,3420
413,081154,Martorelles,2005,4903,2492,2411,659,3480,764
414,430770,Mas de Barberans,2005,683,343,340,67,430,186
415,171002,Masarac,2005,263,130,133,35,161,67
416,430786,Masdenverge,2005,1052,550,502,130,689,233
417,081167,"Masies de Roda, les",2005,719,358,361,94,494,131
418,081173,"Masies de Voltregà, les",2005,3067,1505,1562,497,2101,469
419,430799,Masllorenç,2005,463,239,224,54,291,118
420,081189,"Masnou, el",2005,21464,10405,11059,3164,15109,3191
421,430803,"Masó, la",2005,285,140,145,25,194,66
422,430810,Maspujols,2005,520,267,253,84,316,120
423,081192,Masquefa,2005,7070,3617,3453,1311,5002,757
424,430825,"Masroig, el",2005,539,275,264,58,325,156
425,251312,Massalcoreig,2005,625,337,288,71,395,159
426,171019,Massanes,2005,624,329,295,88,420,116
427,251327,Massoteres,2005,205,113,92,20,134,51
428,081206,Matadepera,2005,7966,4017,3949,1662,5433,871
429,081213,Mataró,2005,116698,58468,58230,17150,82722,16826
430,081228,Mediona,2005,1943,1023,920,247,1296,400
431,251348,Menàrguens,2005,845,438,407,100,505,240
432,170998,Meranges,2005,88,54,34,3,62,23
433,171058,Mieres,2005,352,183,169,58,217,77
434,430831,"Milà, el",2005,177,82,95,24,113,40
435,251351,Miralcamp,2005,1275,635,640,146,860,269
436,430846,Miravet,2005,799,419,380,83,514,202
437,081385,Moià,2005,5142,2618,2524,851,3453,838
438,430859,"Molar, el",2005,286,155,131,29,167,90
439,081234,Molins de Rei,2005,23069,11382,11687,3503,16290,3276
440,251370,Mollerussa,2005,11829,6130,5699,1895,8291,1643
441,171061,Mollet de Peralada,2005,175,87,88,13,103,59
442,081249,Mollet del Vallès,2005,51218,25978,25240,8216,37343,5659
443,171077,Molló,2005,336,174,162,20,223,93
444,251364,"Molsosa, la",2005,130,63,67,15,87,28
445,081287,Monistrol de Calders,2005,665,332,333,93,443,129
446,081271,Monistrol de Montserrat,2005,2723,1420,1303,311,1868,544
447,171096,Montagut i Oix,2005,875,455,420,118,548,209
448,430862,Montblanc,2005,6632,3314,3318,917,4509,1206
449,430884,Montbrió del Camp,2005,1683,864,819,240,1091,352
450,081252,Montcada i Reixac,2005,31725,15807,15918,5002,22328,4395
451,081304,Montclar,2005,121,59,62,21,71,29
452,251399,Montellà i Martinet,2005,541,284,257,53,347,141
453,081311,Montesquiu,2005,858,438,420,92,548,218
454,251403,Montferrer i Castellbò,2005,856,457,399,85,615,156
455,430897,Montferri,2005,225,121,104,34,139,52
456,251386,Montgai,2005,780,395,385,88,458,234
457,081265,Montgat,2005,9112,4499,4613,1294,6626,1192
458,081326,Montmajor,2005,460,240,220,44,313,103
459,081332,Montmaneu,2005,203,106,97,21,131,51
460,430901,"Montmell, el",2005,1065,574,491,142,768,155
461,081350,Montmeló,2005,8804,4424,4380,1364,6269,1171
462,251425,Montoliu de Lleida,2005,491,248,243,49,328,114
463,251410,Montoliu de Segarra,2005,188,107,81,7,119,62
464,251431,Montornès de Segarra,2005,107,50,57,5,59,43
465,081363,Montornès del Vallès,2005,14190,7282,6908,2271,10268,1651
466,430918,Mont-ral,2005,180,99,81,14,147,19
467,171100,Mont-ras,2005,1826,961,865,289,1298,239
468,430923,Mont-roig del Camp,2005,8896,4585,4311,1217,6368,1311
469,081379,Montseny,2005,306,165,141,28,213,65
470,430939,Móra d'Ebre,2005,5012,2484,2528,749,3293,970
471,430944,Móra la Nova,2005,3214,1674,1540,442,2193,579
472,430957,"Morell, el",2005,2606,1350,1256,434,1804,368
473,430960,"Morera de Montsant, la",2005,168,96,72,21,109,38
474,081290,Muntanyola,2005,427,230,197,78,301,48
475,081398,Mura,2005,220,115,105,25,150,45
476,251459,Nalec,2005,90,45,45,6,51,33
477,250254,Naut Aran,2005,1713,913,800,239,1277,197
478,081402,Navarcles,2005,5638,2799,2839,781,3840,1017
479,081419,Navàs,2005,5731,2844,2887,781,3738,1212
480,171117,Navata,2005,882,433,449,155,557,170
481,251462,Navès,2005,263,126,137,29,169,65
482,081424,"Nou de Berguedà, la",2005,159,80,79,28,91,40
483,430976,"Nou de Gaià, la",2005,440,223,217,76,270,94
484,430982,Nulles,2005,369,185,184,30,252,87
485,251484,Odèn,2005,265,150,115,15,170,80
486,081430,Òdena,2005,2936,1487,1449,463,2012,461
487,171122,Ogassa,2005,262,150,112,28,182,52
488,081458,Olèrdola,2005,2864,1482,1382,500,1992,372
489,081461,Olesa de Bonesvalls,2005,1383,717,666,211,997,175
490,081477,Olesa de Montserrat,2005,21114,10699,10415,3382,14772,2960
491,251497,Oliana,2005,1932,985,947,203,1285,444
492,251500,Oliola,2005,254,143,111,19,178,57
493,251517,Olius,2005,615,314,301,102,416,97
494,081483,Olivella,2005,2179,1163,1016,379,1612,188
495,081496,Olost,2005,1193,593,600,149,755,289
496,171143,Olot,2005,31271,15605,15666,4318,20469,6484
497,251522,"Oluges, les",2005,178,94,84,8,117,53
498,081445,Olvan,2005,897,437,460,89,577,231
499,251538,"Omellons, els",2005,260,135,125,23,167,70
500,251543,"Omells de na Gaia, els",2005,161,97,64,14,97,50
501,171156,Ordis,2005,347,181,166,55,237,55
502,251556,Organyà,2005,960,477,483,83,611,266
503,081509,Orís,2005,278,139,139,37,189,52
504,081516,Oristà,2005,601,291,310,54,388,159
505,081521,Orpí,2005,184,99,85,19,128,37
506,081537,Òrrius,2005,315,163,152,19,232,64
507,251569,Os de Balaguer,2005,885,474,411,111,543,231
508,171169,Osor,2005,409,210,199,37,247,125
509,251575,Ossó de Sió,2005,225,113,112,19,144,62
510,081542,Pacs del Penedès,2005,745,374,371,111,537,97
511,081555,Palafolls,2005,7098,3561,3537,1281,5063,754
512,171175,Palafrugell,2005,20509,10501,10008,3009,14169,3331
513,171181,Palamós,2005,16817,8312,8505,2548,11565,2704
514,251581,"Palau d'Anglesola, el",2005,1816,925,891,252,1201,363
515,171194,Palau de Santa Eulàlia,2005,88,52,36,7,65,16
516,171215,Palau-sator,2005,283,152,131,21,193,69
517,171208,Palau-saverdera,2005,1178,581,597,129,780,269
518,081568,Palau-solità i Plegamans,2005,12836,6537,6299,2262,9310,1264
519,431009,"Pallaresos, els",2005,3144,1628,1516,666,2274,204
520,081574,Pallejà,2005,10192,5178,5014,1705,7405,1082
521,430995,"Palma d'Ebre, la",2005,403,194,209,36,234,133
522,089058,"Palma de Cervelló, la",2005,2923,1469,1454,484,2118,321
523,171236,Palol de Revardit,2005,425,224,201,67,279,79
524,171241,Pals,2005,2335,1187,1148,258,1540,537
525,081580,"Papiol, el",2005,3686,1863,1823,568,2596,522
526,171254,Pardines,2005,162,85,77,24,98,40
527,081593,Parets del Vallès,2005,16202,8265,7937,2716,11649,1837
528,171267,Parlavà,2005,341,182,159,29,233,79
529,431016,Passanant i Belltall,2005,205,110,95,5,127,73
530,171289,Pau,2005,473,247,226,61,322,90
531,431021,Paüls,2005,609,303,306,53,380,176
532,171292,Pedret i Marzà,2005,158,77,81,27,101,30
533,251641,Penelles,2005,523,290,233,50,320,153
534,171306,"Pera, la",2005,427,216,211,54,272,101
535,081607,Perafita,2005,378,184,194,45,238,95
536,431037,Perafort,2005,802,425,377,122,582,98
537,171328,Peralada,2005,1558,799,759,227,1038,293
538,251654,Peramola,2005,373,207,166,34,229,110
539,431042,"Perelló, el",2005,2355,1261,1094,215,1566,574
540,081614,Piera,2005,12230,6289,5941,2068,8263,1899
541,431055,"Piles, les",2005,191,109,82,25,129,37
542,081635,Pineda de Mar,2005,24702,12601,12101,3602,17601,3499
543,431068,"Pinell de Brai, el",2005,1099,564,535,117,694,288
544,251667,Pinell de Solsonès,2005,205,110,95,23,131,51
545,251673,Pinós,2005,313,172,141,30,206,77
546,431074,Pira,2005,478,235,243,80,305,93
547,431080,"Pla de Santa Maria, el",2005,1903,1006,897,295,1277,331
548,081640,"Pla del Penedès, el",2005,906,468,438,112,585,209
549,171334,"Planes d'Hostoles, les",2005,1754,885,869,192,1095,467
550,171349,Planoles,2005,313,167,146,25,213,75
551,259118,"Plans de Sió, els",2005,547,284,263,41,321,185
552,251689,"Poal, el",2005,657,349,308,69,411,177
553,251692,"Pobla de Cérvoles, la",2005,250,136,114,28,148,74
554,081653,"Pobla de Claramunt, la",2005,2060,1077,983,321,1406,333
555,081666,"Pobla de Lillet, la",2005,1348,654,694,97,847,404
556,431093,"Pobla de Mafumet, la",2005,1389,694,695,229,985,175
557,431107,"Pobla de Massaluca, la",2005,433,231,202,29,260,144
558,431114,"Pobla de Montornès, la",2005,2123,1134,989,279,1508,336
559,251713,"Pobla de Segur, la",2005,3043,1537,1506,311,1894,838
560,431129,Poboleda,2005,353,191,162,21,228,104
561,081672,Polinyà,2005,6428,3290,3138,1122,4829,477
562,431135,"Pont d'Armentera, el",2005,596,309,287,63,382,151
563,250306,"Pont de Bar, el",2005,158,83,75,11,95,52
564,171352,Pont de Molins,2005,450,240,210,52,319,79
565,251734,"Pont de Suert, el",2005,2307,1191,1116,275,1547,485
566,081825,"Pont de Vilomara i Rocafort, el",2005,3154,1615,1539,485,2197,472
567,431418,Pontils,2005,142,74,68,9,98,35
568,081688,Pontons,2005,482,260,222,51,343,88
569,171365,Pontós,2005,229,124,105,24,150,55
570,251728,Ponts,2005,2378,1179,1199,323,1510,545
571,171371,Porqueres,2005,4060,1995,2065,686,2807,567
572,431140,Porrera,2005,498,272,226,67,313,118
573,171404,"Port de la Selva, el",2005,921,461,460,115,609,197
574,171387,Portbou,2005,1374,678,696,116,846,412
575,251749,"Portella, la",2005,815,460,355,72,602,141
576,431153,Pradell de la Teixeta,2005,192,93,99,16,125,51
577,431166,Prades,2005,612,316,296,59,392,161
578,431172,Prat de Comte,2005,191,95,96,23,106,62
579,081691,"Prat de Llobregat, el",2005,63190,31672,31518,8932,45797,8461
580,431188,Pratdip,2005,692,368,324,61,449,182
581,081712,Prats de Lluçanès,2005,2691,1352,1339,390,1702,599
582,081705,"Prats de Rei, els",2005,537,273,264,53,360,124
583,251752,Prats i Sansor,2005,219,129,90,26,162,31
584,251765,Preixana,2005,427,218,209,39,243,145
585,251771,Preixens,2005,498,249,249,47,283,168
586,082303,Premià de Dalt,2005,9768,4869,4899,1614,7008,1146
587,081727,Premià de Mar,2005,27653,13843,13810,4247,19692,3714
588,171390,"Preses, les",2005,1657,812,845,255,1120,282
589,251790,Prullans,2005,231,119,112,23,147,61
590,171411,Puigcerdà,2005,8845,4670,4175,1379,6274,1192
591,081748,Puigdàlber,2005,388,186,202,62,268,58
592,251804,Puiggròs,2005,300,159,141,50,177,73
593,431191,Puigpelat,2005,789,409,380,143,550,96
594,081751,Puig-reig,2005,4197,2042,2155,441,2620,1136
595,251811,Puigverd d'Agramunt,2005,260,139,121,27,168,65
596,251826,Puigverd de Lleida,2005,1195,609,586,161,777,257
597,081764,Pujalt,2005,199,102,97,19,131,49
598,081770,"Quar, la",2005,68,39,29,5,49,14
599,171426,Quart,2005,2629,1349,1280,402,1916,311
600,170433,Queralbs,2005,202,117,85,25,119,58
601,431205,Querol,2005,359,196,163,41,265,53
602,171432,Rabós,2005,177,85,92,19,126,32
603,081786,Rajadell,2005,451,240,211,46,318,87
604,431212,Rasquera,2005,898,460,438,94,555,249
605,171447,Regencós,2005,297,164,133,42,191,64
606,081799,Rellinars,2005,605,312,293,96,415,94
607,431227,Renau,2005,88,44,44,13,62,13
608,431233,Reus,2005,99505,49434,50071,15591,69345,14569
609,251832,Rialp,2005,631,321,310,73,466,92
610,431248,"Riba, la",2005,679,371,308,71,444,164
611,431251,Riba-roja d'Ebre,2005,1357,704,653,123,877,357
612,259059,Ribera d'Ondara,2005,465,245,220,35,287,143
613,251850,Ribera d'Urgellet,2005,935,499,436,102,626,207
614,171450,Ribes de Freser,2005,2044,1011,1033,201,1294,549
615,171463,Riells i Viabrea,2005,3035,1594,1441,575,2177,283
616,431264,"Riera de Gaià, la",2005,1277,657,620,192,880,205
617,251863,Riner,2005,273,137,136,31,175,67
618,171479,Ripoll,2005,10762,5303,5459,1262,7116,2384
619,081803,Ripollet,2005,34735,17600,17135,5512,25101,4122
620,259139,Riu de Cerdanya,2005,96,49,47,7,71,18
621,171485,Riudarenes,2005,1679,876,803,223,1168,288
622,171498,Riudaura,2005,426,215,211,41,310,75
623,431270,Riudecanyes,2005,845,434,411,122,548,175
624,431286,Riudecols,2005,1097,569,528,142,748,207
625,171501,Riudellots de la Selva,2005,1775,923,852,267,1213,295
626,431299,Riudoms,2005,5763,2955,2808,894,3907,962
627,171518,Riumors,2005,154,78,76,9,88,57
628,081810,"Roca del Vallès, la",2005,8946,4513,4433,1464,6466,1016
629,431303,Rocafort de Queralt,2005,264,140,124,18,160,86
630,431310,Roda de Berà,2005,4547,2410,2137,583,3344,620
631,081831,Roda de Ter,2005,5450,2651,2799,828,3607,1015
632,431325,Rodonyà,2005,462,244,218,72,281,109
633,431331,Roquetes,2005,7232,3758,3474,1051,4933,1248
634,171523,Roses,2005,15535,7820,7715,2558,10857,2120
635,251898,Rosselló,2005,2268,1162,1106,349,1538,381
636,431346,"Rourell, el",2005,313,159,154,44,196,73
637,081846,Rubí,2005,68102,34368,33734,10744,49382,7976
638,081859,Rubió,2005,135,76,59,25,79,31
639,171539,Rupià,2005,201,109,92,20,129,52
640,089019,Rupit i Pruit,2005,345,171,174,24,239,82
641,081878,Sabadell,2005,196971,96418,100553,28524,135712,32735
642,081884,Sagàs,2005,140,71,69,19,87,34
643,251902,Salàs de Pallars,2005,334,172,162,15,201,118
644,081901,Saldes,2005,346,196,150,36,250,60
645,171544,Sales de Llierca,2005,117,58,59,24,85,8
646,081918,Sallent,2005,7088,3405,3683,845,4539,1704
647,431359,Salomó,2005,432,220,212,56,255,121
648,439057,Salou,2005,20139,10668,9471,2899,15481,1759
649,171557,Salt,2005,27370,14527,12843,4498,19461,3411
650,251919,Sanaüja,2005,464,239,225,66,262,136
651,081944,Sant Adrià de Besòs,2005,32940,16247,16693,5173,22574,5193
652,081957,Sant Agustí de Lluçanès,2005,111,58,53,16,72,23
653,081960,Sant Andreu de la Barca,2005,24863,12806,12057,4274,18424,2165
654,081976,Sant Andreu de Llavaneres,2005,9180,4716,4464,1698,6405,1077
655,171576,Sant Andreu Salou,2005,154,72,82,31,85,38
656,171833,Sant Aniol de Finestres,2005,286,155,131,38,195,53
657,081982,Sant Antoni de Vilamajor,2005,4627,2339,2288,781,3247,599
658,081995,Sant Bartomeu del Grau,2005,1032,539,493,180,701,151
659,082009,Sant Boi de Llobregat,2005,81181,40415,40766,11853,58144,11184
660,082016,Sant Boi de Lluçanès,2005,569,291,278,48,361,160
661,431362,Sant Carles de la Ràpita,2005,13181,6589,6592,1820,8918,2443
662,082037,Sant Cebrià de Vallalta,2005,2575,1387,1188,400,1920,255
663,082021,Sant Celoni,2005,15081,7577,7504,2365,10328,2388
664,082042,Sant Climent de Llobregat,2005,3443,1729,1714,565,2495,383
665,171582,Sant Climent Sescebes,2005,474,244,230,68,284,122
666,082055,Sant Cugat del Vallès,2005,70514,34660,35854,14487,49117,6910
667,082068,Sant Cugat Sesgarrigues,2005,871,459,412,141,574,156
668,251961,Sant Esteve de la Sarga,2005,144,92,52,6,94,44
669,082074,Sant Esteve de Palautordera,2005,1961,970,991,390,1359,212
670,082080,Sant Esteve Sesrovires,2005,6310,3252,3058,1091,4542,677
671,171595,Sant Feliu de Buixalleu,2005,769,414,355,106,503,160
672,082107,Sant Feliu de Codines,2005,5282,2741,2541,815,3621,846
673,171609,Sant Feliu de Guíxols,2005,20318,10059,10259,3073,13835,3410
674,082114,Sant Feliu de Llobregat,2005,42267,20821,21446,6365,30563,5339
675,171616,Sant Feliu de Pallerols,2005,1223,608,615,162,776,285
676,082129,Sant Feliu Sasserra,2005,638,320,318,73,425,140
677,171621,Sant Ferriol,2005,206,111,95,33,131,42
678,082093,Sant Fost de Campsentelles,2005,7265,3702,3563,1069,5258,938
679,082135,Sant Fruitós de Bages,2005,6839,3495,3344,1114,4835,890
680,171637,Sant Gregori,2005,2844,1461,1383,445,1997,402
681,251924,Sant Guim de Freixenet,2005,1063,534,529,113,705,245
682,251977,Sant Guim de la Plana,2005,198,106,92,28,116,54
683,171642,Sant Hilari Sacalm,2005,5474,2862,2612,669,3802,1003
684,082153,Sant Hipòlit de Voltregà,2005,3222,1615,1607,487,2055,680
685,081939,Sant Iscle de Vallalta,2005,1095,571,524,208,742,145
686,439023,Sant Jaume d'Enveja,2005,3355,1698,1657,429,2195,731
687,082166,Sant Jaume de Frontanyà,2005,28,14,14,0,23,5
688,171655,Sant Jaume de Llierca,2005,785,397,388,94,470,221
689,431378,Sant Jaume dels Domenys,2005,1877,986,891,274,1248,355
690,171674,Sant Joan de les Abadesses,2005,3621,1810,1811,388,2334,899
691,171680,Sant Joan de Mollet,2005,475,237,238,83,298,94
692,082188,Sant Joan de Vilatorrada,2005,10064,5079,4985,1468,7112,1484
693,082172,Sant Joan Despí,2005,31162,15401,15761,5174,22439,3549
694,171851,Sant Joan les Fonts,2005,2631,1317,1314,254,1790,587
695,171668,Sant Jordi Desvalls,2005,631,318,313,72,403,156
696,089030,Sant Julià de Cerdanyola,2005,258,138,120,36,163,59
697,171693,Sant Julià de Ramis,2005,2495,1275,1220,410,1735,350
698,082205,Sant Julià de Vilatorta,2005,2729,1339,1390,485,1873,371
699,179032,Sant Julià del Llor i Bonmatí,2005,1007,514,493,128,686,193
700,082212,Sant Just Desvern,2005,15282,7274,8008,2505,10641,2136
701,082227,Sant Llorenç d'Hortons,2005,2022,1021,1001,332,1363,327
702,171714,Sant Llorenç de la Muga,2005,202,101,101,21,130,51
703,251930,Sant Llorenç de Morunys,2005,969,503,466,102,625,242
704,082233,Sant Llorenç Savall,2005,2229,1126,1103,322,1433,474
705,082251,Sant Martí d'Albars,2005,116,60,56,11,77,28
706,082248,Sant Martí de Centelles,2005,898,465,433,162,601,135
707,171729,Sant Martí de Llémena,2005,526,276,250,92,348,86
708,259025,Sant Martí de Riucorb,2005,704,372,332,53,442,209
709,082264,Sant Martí de Tous,2005,1093,556,537,187,678,228
710,082270,Sant Martí Sarroca,2005,2721,1391,1330,392,1786,543
711,082286,Sant Martí Sesgueioles,2005,340,174,166,53,206,81
712,171735,Sant Martí Vell,2005,185,101,84,26,116,43
713,082299,Sant Mateu de Bages,2005,665,339,326,59,401,205
714,171740,Sant Miquel de Campmajor,2005,197,110,87,22,136,39
715,171753,Sant Miquel de Fluvià,2005,671,350,321,104,447,120
716,171766,Sant Mori,2005,167,80,87,15,119,33
717,171772,Sant Pau de Segúries,2005,669,338,331,72,424,173
718,082310,Sant Pere de Ribes,2005,26108,13238,12870,4500,18828,2780
719,082325,Sant Pere de Riudebitlles,2005,2176,1097,1079,296,1472,408
720,082331,Sant Pere de Torelló,2005,2265,1126,1139,287,1546,432
721,082346,Sant Pere de Vilamajor,2005,3444,1760,1684,652,2369,423
722,171788,Sant Pere Pescador,2005,1775,989,786,239,1240,296
723,081897,Sant Pere Sallavinera,2005,163,83,80,16,97,50
724,082359,Sant Pol de Mar,2005,4597,2365,2232,700,3271,626
725,082362,Sant Quintí de Mediona,2005,1998,1052,946,266,1351,381
726,082378,Sant Quirze de Besora,2005,2007,992,1015,231,1248,528
727,082384,Sant Quirze del Vallès,2005,16581,8213,8368,3175,11985,1421
728,082397,Sant Quirze Safaja,2005,543,288,255,89,402,52
729,251945,Sant Ramon,2005,561,293,268,55,348,158
730,082401,Sant Sadurní d'Anoia,2005,11359,5645,5714,1892,7700,1767
731,082418,Sant Sadurní d'Osormort,2005,82,47,35,8,56,18
732,080983,Sant Salvador de Guardiola,2005,2753,1416,1337,444,1962,347
733,082628,Sant Vicenç de Castellet,2005,7737,3763,3974,1011,5157,1569
734,082649,Sant Vicenç de Montalt,2005,4771,2442,2329,952,3307,512
735,082652,Sant Vicenç de Torelló,2005,1927,932,995,324,1199,404
736,082634,Sant Vicenç dels Horts,2005,26676,13435,13241,4409,19017,3250
737,431384,Santa Bàrbara,2005,3613,1838,1775,485,2305,823
738,082439,Santa Cecília de Voltregà,2005,206,113,93,27,143,36
739,082444,Santa Coloma de Cervelló,2005,6964,3497,3467,1318,4943,703
740,171805,Santa Coloma de Farners,2005,10557,5443,5114,1672,7246,1639
741,082457,Santa Coloma de Gramenet,2005,118129,59720,58409,15105,85308,17716
742,431397,Santa Coloma de Queralt,2005,2991,1498,1493,473,1933,585
743,171812,Santa Cristina d'Aro,2005,3983,2063,1920,670,2755,558
744,082460,Santa Eugènia de Berga,2005,2046,1066,980,280,1460,306
745,082476,Santa Eulàlia de Riuprimer,2005,885,449,436,124,592,169
746,082482,Santa Eulàlia de Ronçana,2005,5814,2933,2881,923,4071,820
747,082495,Santa Fe del Penedès,2005,338,174,164,64,223,51
748,171827,Santa Llogaia d'Àlguema,2005,311,168,143,45,223,43
749,082508,Santa Margarida de Montbui,2005,9485,4774,4711,1474,6731,1280
750,082515,Santa Margarida i els Monjos,2005,5933,3108,2825,930,4335,668
751,082589,Santa Maria d'Oló,2005,1044,524,520,108,711,225
752,082536,Santa Maria de Besora,2005,187,95,92,24,114,49
753,082567,Santa Maria de Martorelles,2005,763,392,371,127,535,101
754,082554,Santa Maria de Merlès,2005,151,80,71,20,103,28
755,082573,Santa Maria de Miralles,2005,123,60,63,15,79,29
756,082592,Santa Maria de Palautordera,2005,7762,4018,3744,1294,5432,1036
757,431401,Santa Oliva,2005,2700,1425,1275,433,1835,432
758,171848,Santa Pau,2005,1541,787,754,176,1065,300
759,082606,Santa Perpètua de Mogoda,2005,21409,10873,10536,3192,15916,2301
760,082613,Santa Susanna,2005,2868,1468,1400,523,2000,345
761,081923,Santpedor,2005,6037,3025,3012,925,4228,884
762,431423,Sarral,2005,1503,787,716,178,997,328
763,171864,Sarrià de Ter,2005,4036,1997,2039,570,2772,694
764,252017,Sarroca de Bellera,2005,145,80,65,6,85,54
765,252000,Sarroca de Lleida,2005,430,218,212,34,277,119
766,171870,"Saus, Camallera i Llampaies",2005,733,360,373,84,504,145
767,431439,Savallà del Comtat,2005,73,39,34,10,41,22
768,431444,"Secuita, la",2005,1240,634,606,164,879,197
769,171886,"Selva de Mar, la",2005,216,111,105,26,142,48
770,431457,"Selva del Camp, la",2005,4821,2447,2374,891,3179,751
771,431460,Senan,2005,39,28,11,6,25,8
772,430445,"Sénia, la",2005,5969,3139,2830,770,4200,999
773,252022,Senterada,2005,113,62,51,8,82,23
774,250352,"Sentiu de Sió, la",2005,486,234,252,39,314,133
775,082671,Sentmenat,2005,6988,3512,3476,1124,5013,851
776,171903,Serinyà,2005,998,517,481,152,669,177
777,252043,Seròs,2005,1900,1080,820,186,1256,458
778,171910,Serra de Daró,2005,177,99,78,20,100,57
779,171925,Setcases,2005,180,94,86,20,121,39
780,252038,"Seu d'Urgell, la",2005,12317,6042,6275,1766,8402,2149
781,082690,Seva,2005,2956,1517,1439,466,2036,454
782,252056,Sidamon,2005,690,356,334,92,473,125
783,171931,Sils,2005,3947,1981,1966,668,2708,571
784,082704,Sitges,2005,24470,12030,12440,3595,17516,3359
785,170524,Siurana,2005,175,89,86,18,112,45
786,082711,Sobremunt,2005,92,44,48,18,57,17
787,252069,"Soleràs, el",2005,403,220,183,31,249,123
788,431476,Solivella,2005,567,276,291,46,343,178
789,252075,Solsona,2005,8571,4387,4184,1318,5758,1495
790,082726,Sora,2005,213,107,106,39,138,36
791,252081,Soriguera,2005,336,185,151,30,222,84
792,252094,Sort,2005,2113,1080,1033,288,1421,404
793,252108,Soses,2005,1635,891,744,202,1125,308
794,082732,Subirats,2005,2820,1411,1409,438,1812,570
795,252115,Sudanell,2005,762,408,354,65,524,173
796,252120,Sunyer,2005,284,147,137,30,178,76
797,082747,Súria,2005,6202,3040,3162,802,3960,1440
798,171946,Susqueda,2005,113,64,49,9,81,23
799,082763,Tagamanent,2005,265,140,125,43,179,43
800,082779,Talamanca,2005,117,61,56,10,89,18
801,252154,Talarn,2005,344,171,173,41,216,87
802,252167,Talavera,2005,282,150,132,16,185,81
803,171959,"Tallada d'Empordà, la",2005,346,190,156,34,223,89
804,082785,Taradell,2005,5613,2877,2736,867,3839,907
805,431482,Tarragona,2005,128152,63091,65061,19404,89600,19148
806,252173,Tàrrega,2005,14810,7495,7315,2365,10068,2377
807,252189,Tarrés,2005,116,56,60,9,74,33
808,252192,Tarroja de Segarra,2005,169,86,83,18,97,54
809,082750,Tavèrnoles,2005,301,152,149,38,217,46
810,082802,Tavertet,2005,151,84,67,14,98,39
811,082819,Teià,2005,5835,2957,2878,968,4188,679
812,252206,Térmens,2005,1503,746,757,168,1004,331
813,171962,Terrades,2005,155,77,78,10,92,53
814,082798,Terrassa,2005,194947,96960,97987,29838,135725,29384
815,082824,Tiana,2005,7079,3483,3596,1240,5061,778
816,252213,Tírvia,2005,124,65,59,9,82,33
817,252228,Tiurana,2005,46,27,19,5,27,14
818,431495,Tivenys,2005,912,464,448,97,549,266
819,431508,Tivissa,2005,1789,900,889,200,1125,464
820,082830,Tona,2005,7030,3565,3465,1118,4877,1035
821,252234,Torà,2005,1274,658,616,173,818,283
822,082845,Tordera,2005,12597,6415,6182,1901,8739,1957
823,082858,Torelló,2005,13008,6452,6556,1804,8974,2230
824,252249,"Torms, els",2005,193,106,87,19,111,63
825,252252,Tornabous,2005,793,422,371,69,501,223
826,252271,"Torre de Cabdella, la",2005,732,368,364,43,466,223
827,082861,"Torre de Claramunt, la",2005,3063,1591,1472,507,2227,329
828,431515,"Torre de Fontaubella, la",2005,135,67,68,10,84,41
829,431520,"Torre de l'Espanyol, la",2005,740,391,349,80,472,188
830,252265,Torrebesses,2005,297,150,147,30,169,98
831,431536,Torredembarra,2005,13280,6709,6571,2059,9276,1945
832,252287,Torrefarrera,2005,2650,1364,1286,411,1873,366
833,259078,Torrefeta i Florejacs,2005,638,323,315,79,368,191
834,252304,Torregrossa,2005,2311,1168,1143,275,1451,585
835,252311,Torrelameu,2005,590,326,264,42,403,145
836,082877,Torrelavit,2005,1209,647,562,129,834,246
837,082883,Torrelles de Foix,2005,2175,1181,994,321,1466,388
838,082896,Torrelles de Llobregat,2005,4604,2329,2275,847,3315,442
839,171978,Torrent,2005,188,101,87,23,127,38
840,252326,Torres de Segre,2005,2007,1041,966,256,1337,414
841,252332,Torre-serona,2005,353,186,167,34,253,66
842,171984,Torroella de Fluvià,2005,437,251,186,46,295,96
843,171997,Torroella de Montgrí,2005,10228,5270,4958,1591,7104,1533
844,431541,Torroja del Priorat,2005,150,89,61,8,107,35
845,172001,Tortellà,2005,714,358,356,86,421,207
846,431554,Tortosa,2005,33705,17139,16566,4551,22936,6218
847,172018,Toses,2005,163,99,64,26,100,37
848,172023,Tossa de Mar,2005,5260,2678,2582,697,3761,802
849,252347,Tremp,2005,5286,2601,2685,641,3233,1412
850,172044,Ullà,2005,946,516,430,147,655,144
851,082900,Ullastrell,2005,1450,751,699,256,1000,194
852,172057,Ullastret,2005,226,113,113,30,150,46
853,431567,Ulldecona,2005,6325,3281,3044,827,4265,1233
854,431573,Ulldemolins,2005,490,264,226,34,289,167
855,172039,Ultramort,2005,203,117,86,19,123,61
856,172060,Urús,2005,205,105,100,29,132,44
857,082917,Vacarisses,2005,4592,2379,2213,895,3211,486
858,170144,"Vajol, la",2005,96,53,43,10,65,21
859,172076,"Vall d'en Bas, la",2005,2616,1325,1291,316,1680,620
860,172082,"Vall de Bianya, la",2005,1228,618,610,181,813,234
861,250432,"Vall de Boí, la",2005,1053,577,476,115,766,172
862,259010,Vall de Cardós,2005,363,198,165,37,235,91
863,082922,Vallbona d'Anoia,2005,1254,642,612,176,860,218
864,252385,Vallbona de les Monges,2005,256,131,125,11,154,91
865,082938,Vallcebre,2005,284,151,133,29,183,72
866,431589,Vallclara,2005,117,66,51,11,66,40
867,252402,Vallfogona de Balaguer,2005,1577,791,786,185,1070,322
868,171707,Vallfogona de Ripollès,2005,221,116,105,28,144,49
869,431592,Vallfogona de Riucorb,2005,177,90,87,5,77,95
870,082943,Vallgorguina,2005,1881,968,913,309,1361,211
871,082956,Vallirana,2005,12339,6225,6114,2104,8709,1526
872,172095,Vall-llobrega,2005,655,319,336,135,459,61
873,431606,Vallmoll,2005,1413,743,670,174,1034,205
874,082969,Vallromanes,2005,1911,982,929,415,1327,169
875,431613,Valls,2005,22851,11445,11406,3445,15633,3773
876,259062,"Valls d'Aguilar, les",2005,315,173,142,29,200,86
877,252398,"Valls de Valira, les",2005,810,438,372,83,549,178
878,431628,Vandellòs i l'Hospitalet de l'Infant,2005,5008,2542,2466,659,3570,779
879,259097,"Vansa i Fórnols, la",2005,191,103,88,14,119,58
880,082975,Veciana,2005,159,84,75,20,94,45
881,431634,"Vendrell, el",2005,30225,15243,14982,4991,21404,3830
882,172109,Ventalló,2005,710,375,335,71,479,160
883,252424,Verdú,2005,1072,517,555,128,624,320
884,172116,Verges,2005,1173,574,599,146,749,278
885,431649,Vespella de Gaià,2005,298,169,129,34,221,43
886,082981,Vic,2005,37825,19197,18628,5817,25968,6040
887,172121,Vidrà,2005,172,85,87,27,116,29
888,172137,Vidreres,2005,6215,3258,2957,976,4322,917
889,252430,Vielha e Mijaran,2005,5020,2659,2361,764,3782,474
890,431652,Vilabella,2005,789,405,384,88,531,170
891,172142,Vilabertran,2005,831,423,408,109,542,180
892,172155,Vilablareix,2005,2189,1101,1088,372,1624,193
893,082994,Vilada,2005,507,252,255,39,324,144
894,172174,Viladamat,2005,422,214,208,45,279,98
895,172168,Viladasens,2005,182,92,90,20,112,50
896,083015,Viladecans,2005,61043,30763,30280,9712,44634,6697
897,083008,Viladecavalls,2005,6890,3482,3408,1372,4887,631
898,172180,Vilademuls,2005,787,409,378,98,509,180
899,172207,Viladrau,2005,982,512,470,127,681,174
900,172214,Vilafant,2005,4852,2423,2429,835,3478,539
901,083054,Vilafranca del Penedès,2005,35864,17968,17896,5400,25189,5275
902,252445,Vilagrassa,2005,463,235,228,58,289,116
903,172235,Vilajuïga,2005,1059,517,542,174,708,177
904,431750,Vilalba dels Arcs,2005,726,378,348,60,441,225
905,083067,Vilalba Sasserra,2005,564,286,278,85,410,69
906,252458,Vilaller,2005,644,365,279,56,462,126
907,172240,Vilallonga de Ter,2005,437,241,196,31,288,118
908,431665,Vilallonga del Camp,2005,1425,709,716,177,1015,233
909,172253,Vilamacolum,2005,292,153,139,41,189,62
910,172266,Vilamalla,2005,947,499,448,142,700,105
911,172272,Vilamaniscle,2005,168,93,75,32,97,39
912,252477,Vilamòs,2005,175,94,81,25,128,22
913,172288,Vilanant,2005,336,166,170,34,233,69
914,431671,Vilanova d'Escornalbou,2005,477,254,223,57,342,78
915,252483,Vilanova de Bellpuig,2005,1112,560,552,103,685,324
916,252496,Vilanova de l'Aguda,2005,242,120,122,26,132,84
917,252542,Vilanova de la Barca,2005,1050,535,515,129,696,225
918,252509,Vilanova de Meià,2005,436,226,210,36,278,122
919,431687,Vilanova de Prades,2005,155,83,72,13,96,46
920,083036,Vilanova de Sau,2005,330,153,177,39,228,63
921,252516,Vilanova de Segrià,2005,806,416,390,81,577,148
922,083020,Vilanova del Camí,2005,11555,5861,5694,1990,8271,1294
923,089024,Vilanova del Vallès,2005,3282,1679,1603,606,2297,379
924,083073,Vilanova i la Geltrú,2005,61427,30333,31094,9204,42616,9607
925,431690,Vilaplana,2005,568,293,275,60,361,147
926,431704,Vila-rodona,2005,1117,611,506,112,765,240
927,172305,Vila-sacra,2005,509,253,256,56,370,83
928,252521,Vila-sana,2005,568,276,292,78,347,143
929,431711,Vila-seca,2005,15875,8007,7868,2466,11628,1781
930,082140,Vilassar de Dalt,2005,8011,3992,4019,1057,5678,1276
931,082191,Vilassar de Mar,2005,18900,9269,9631,3132,13210,2558
932,172229,Vilaür,2005,140,69,71,19,99,22
933,431726,Vilaverd,2005,437,224,213,51,268,118
934,431732,"Vilella Alta, la",2005,132,70,62,16,79,37
935,431747,"Vilella Baixa, la",2005,190,103,87,21,121,48
936,172333,Vilobí d'Onyar,2005,2664,1444,1220,376,1887,401
937,083041,Vilobí del Penedès,2005,1013,520,493,149,683,181
938,172327,Vilopriu,2005,181,94,87,23,113,45
939,252537,"Vilosell, el",2005,216,107,109,13,137,66
940,431763,Vimbodí i Poblet,2005,1054,587,467,112,646,296
941,252555,Vinaixa,2005,607,310,297,60,396,151
942,431779,Vinebre,2005,466,243,223,36,320,110
943,431785,Vinyols i els Arcs,2005,1498,784,714,213,1043,242
944,083089,Viver i Serrateix,2005,193,100,93,27,128,38
945,430521,Xerta,2005,1275,639,636,155,784,336
946,000000,Catalunya,2005,6995206,3468235,3526971,988016,4856466,1150724
0,250019,Abella de la Conca,2006,186,102,84,23,124,39
1,080018,Abrera,2006,10244,5277,4967,1685,7571,988
2,250024,Àger,2006,491,270,221,27,295,169
3,250030,Agramunt,2006,5459,2900,2559,762,3687,1010
4,080023,Aguilar de Segarra,2006,250,133,117,33,158,59
5,170010,Agullana,2006,756,394,362,93,478,185
6,080142,Aiguafreda,2006,2373,1151,1222,334,1568,471
7,430017,Aiguamúrcia,2006,797,429,368,97,543,157
8,170025,Aiguaviva,2006,594,292,302,108,401,85
9,250387,Aitona,2006,2370,1241,1129,263,1556,551
10,250045,"Alamús, els",2006,701,362,339,69,471,161
11,250058,Alàs i Cerc,2006,404,217,187,48,256,100
12,250061,"Albagés, l'",2006,492,263,229,61,295,136
13,170031,Albanyà,2006,137,72,65,19,96,22
14,250077,Albatàrrec,2006,1519,814,705,241,1041,237
15,250083,Albesa,2006,1587,799,788,205,1035,347
16,250096,"Albi, l'",2006,811,416,395,88,526,197
17,430022,Albinyana,2006,2140,1104,1036,342,1441,357
18,430038,"Albiol, l'",2006,348,184,164,78,236,34
19,170046,Albons,2006,620,329,291,79,425,116
20,430043,Alcanar,2006,9620,4975,4645,1240,6605,1775
21,250100,Alcanó,2006,253,123,130,24,150,79
22,250117,Alcarràs,2006,5970,3082,2888,864,4068,1038
23,250122,Alcoletge,2006,2239,1202,1037,328,1589,322
24,430056,Alcover,2006,4500,2323,2177,715,3051,734
25,439044,"Aldea, l'",2006,3795,1995,1800,466,2507,822
26,430069,Aldover,2006,893,441,452,86,569,238
27,430075,"Aleixar, l'",2006,815,409,406,141,498,176
28,080039,Alella,2006,9013,4444,4569,1385,6516,1112
29,430081,Alfara de Carles,2006,341,183,158,23,215,103
30,250138,Alfarràs,2006,3274,1714,1560,459,2144,671
31,250143,Alfés,2006,321,170,151,27,201,93
32,430094,Alforja,2006,1584,821,763,222,1040,322
33,250156,Algerri,2006,467,238,229,30,277,160
34,250169,Alguaire,2006,3088,1607,1481,407,2064,617
35,250175,Alins,2006,251,130,121,19,146,86
36,430108,Alió,2006,376,197,179,36,259,81
37,250194,Almacelles,2006,6088,3227,2861,790,4105,1193
38,250208,Almatret,2006,443,232,211,31,241,171
39,250215,Almenar,2006,3576,1874,1702,428,2365,783
40,430115,Almoster,2006,1241,631,610,265,835,141
41,250220,Alòs de Balaguer,2006,174,100,74,14,102,58
42,170062,Alp,2006,1467,771,696,189,1113,165
43,080044,Alpens,2006,307,165,142,51,193,63
44,250236,Alpicat,2006,5362,2695,2667,876,3810,676
45,250241,Alt Àneu,2006,457,261,196,57,304,96
46,430120,Altafulla,2006,4274,2142,2132,743,3034,497
47,170078,Amer,2006,2258,1127,1131,245,1487,526
48,430136,"Ametlla de Mar, l'",2006,6744,3453,3291,905,4595,1244
49,080057,"Ametlla del Vallès, l'",2006,7517,3756,3761,1487,5230,800
50,439060,"Ampolla, l'",2006,2613,1333,1280,281,1785,547
51,430141,Amposta,2006,19142,9721,9421,2788,13158,3196
52,170084,Anglès,2006,5211,2679,2532,732,3433,1046
53,250273,Anglesola,2006,1303,659,644,143,842,318
54,250292,Arbeca,2006,2512,1292,1220,305,1581,626
55,430167,"Arboç, l'",2006,4802,2586,2216,804,3289,709
56,430154,Arbolí,2006,105,57,48,1,78,26
57,170097,Arbúcies,2006,6232,3368,2864,958,4265,1009
58,080060,Arenys de Mar,2006,14016,6855,7161,1970,9528,2518
59,080076,Arenys de Munt,2006,7721,3859,3862,1340,5295,1086
60,170101,Argelaguer,2006,418,225,193,71,255,92
61,080082,Argençola,2006,209,115,94,26,140,43
62,430173,"Argentera, l'",2006,155,89,66,11,111,33
63,080095,Argentona,2006,11161,5529,5632,1949,7682,1530
64,170118,"Armentera, l'",2006,770,382,388,81,490,199
65,430189,Arnes,2006,510,267,243,39,283,188
66,250313,Arres,2006,61,37,24,6,44,11
67,250328,Arsèguel,2006,100,49,51,6,73,21
68,080109,Artés,2006,5072,2568,2504,754,3428,890
69,250334,Artesa de Lleida,2006,1451,756,695,198,928,325
70,250349,Artesa de Segre,2006,3696,1917,1779,482,2442,772
71,430192,Ascó,2006,1602,812,790,171,1059,372
72,250365,Aspa,2006,269,135,134,28,151,90
73,250371,"Avellanes i Santa Linya, les",2006,469,264,205,33,295,141
74,080116,Avià,2006,2058,1025,1033,285,1350,423
75,080121,Avinyó,2006,2122,1064,1058,332,1359,431
76,170123,Avinyonet de Puigventós,2006,1241,646,595,244,874,123
77,080137,Avinyonet del Penedès,2006,1591,854,737,233,1075,283
78,080155,Badalona,2006,221520,112117,109403,31245,158472,31803
79,089045,Badia del Vallès,2006,14123,7004,7119,2127,9978,2018
80,080168,Bagà,2006,2178,1073,1105,243,1407,528
81,250390,Baix Pallars,2006,381,211,170,40,230,111
82,250404,Balaguer,2006,15769,7948,7821,2455,10640,2674
83,080174,Balenyà,2006,3479,1740,1739,559,2421,499
84,080180,Balsareny,2006,3310,1637,1673,408,2207,695
85,430206,Banyeres del Penedès,2006,2557,1333,1224,426,1830,301
86,170157,Banyoles,2006,17309,8705,8604,2977,11449,2883
87,250411,Barbens,2006,828,453,375,76,526,226
88,430213,Barberà de la Conca,2006,503,263,240,64,326,113
89,082520,Barberà del Vallès,2006,28633,14337,14296,4508,20903,3222
90,080193,Barcelona,2006,1605602,761870,843732,188382,1085359,331861
91,250426,"Baronia de Rialb, la",2006,281,152,129,34,173,74
92,170160,Bàscara,2006,900,478,422,102,591,207
93,250447,Bassella,2006,256,134,122,35,150,71
94,430228,Batea,2006,2106,1083,1023,231,1344,531
95,250450,Bausen,2006,52,33,19,0,25,27
96,080207,Begues,2006,5699,2860,2839,1235,3954,510
97,170139,Begur,2006,4076,2112,1964,599,2842,635
98,250463,Belianes,2006,592,306,286,77,339,176
99,251706,Bellaguarda,2006,352,184,168,29,193,130
100,170182,Bellcaire d'Empordà,2006,672,338,334,97,436,139
101,250479,Bellcaire d'Urgell,2006,1295,631,664,131,786,378
102,250485,Bell-lloc d'Urgell,2006,2326,1142,1184,321,1495,510
103,250498,Bellmunt d'Urgell,2006,225,108,117,32,132,61
104,430234,Bellmunt del Priorat,2006,324,163,161,26,200,98
105,080214,Bellprat,2006,99,54,45,9,66,24
106,250501,Bellpuig,2006,4454,2307,2147,616,3000,838
107,430249,Bellvei,2006,1748,931,817,259,1224,265
108,250518,Bellver de Cerdanya,2006,1906,1002,904,237,1319,350
109,250523,Bellvís,2006,2360,1228,1132,262,1494,604
110,250539,Benavent de Segrià,2006,1249,650,599,224,867,158
111,430252,Benifallet,2006,790,392,398,67,441,282
112,430265,Benissanet,2006,1205,634,571,126,799,280
113,080229,Berga,2006,16457,8178,8279,2086,10870,3501
114,170195,Besalú,2006,2257,1107,1150,288,1456,513
115,170209,Bescanó,2006,3859,1940,1919,668,2582,609
116,170216,Beuda,2006,164,80,84,21,122,21
117,080235,Bigues i Riells del Fai,2006,7564,3905,3659,1375,5397,792
118,250557,Biosca,2006,228,120,108,21,131,76
119,170221,"Bisbal d'Empordà, la",2006,9261,4608,4653,1421,6264,1576
120,430271,"Bisbal de Falset, la",2006,266,138,128,29,160,77
121,430287,"Bisbal del Penedès, la",2006,2815,1476,1339,415,1942,458
122,172348,Biure,2006,236,120,116,32,156,48
123,430290,Blancafort,2006,414,220,194,48,258,108
124,170237,Blanes,2006,37819,19190,18629,5746,26731,5342
125,170293,Boadella i les Escaules,2006,230,112,118,25,156,49
126,170242,Bolvir,2006,295,155,140,27,216,52
127,430304,Bonastre,2006,534,282,252,73,364,97
128,250576,"Bòrdes, Es",2006,247,131,116,28,182,37
129,170255,Bordils,2006,1554,795,759,244,1045,265
130,250582,"Borges Blanques, les",2006,5606,2835,2771,717,3685,1204
131,430311,"Borges del Camp, les",2006,1914,960,954,291,1277,346
132,170268,Borrassà,2006,614,327,287,57,421,136
133,080240,Borredà,2006,530,271,259,72,344,114
134,250595,Bossòst,2006,1043,539,504,135,743,165
135,430326,Bot,2006,736,379,357,57,431,248
136,430332,Botarell,2006,963,513,450,161,695,107
137,250560,Bovera,2006,371,188,183,18,210,143
138,430347,Bràfim,2006,650,341,309,67,451,132
139,170274,Breda,2006,3685,1878,1807,558,2413,714
140,080253,"Bruc, el",2006,1655,881,774,281,1155,219
141,080266,"Brull, el",2006,219,117,102,31,149,39
142,170280,Brunyola i Sant Martí Sapresa,2006,362,185,177,38,220,104
143,430350,Cabacés,2006,342,183,159,36,206,100
144,250609,Cabanabona,2006,115,55,60,8,59,48
145,170314,Cabanelles,2006,240,135,105,21,165,54
146,170307,Cabanes,2006,917,474,443,147,602,168
147,080272,"Cabanyes, les",2006,791,403,388,157,544,90
148,250616,Cabó,2006,104,60,44,7,61,36
149,430363,Cabra del Camp,2006,944,508,436,141,644,159
150,080288,Cabrera d'Anoia,2006,1059,564,495,159,772,128
151,080291,Cabrera de Mar,2006,4174,2139,2035,706,2950,518
152,080305,Cabrils,2006,6536,3204,3332,1410,4507,619
153,170329,Cadaqués,2006,2922,1431,1491,432,2069,421
154,080312,Calaf,2006,3352,1757,1595,442,2280,630
155,430379,Calafell,2006,20521,10488,10033,2915,14826,2780
156,080348,Calders,2006,833,424,409,134,539,160
157,080327,Caldes d'Estrac,2006,2607,1268,1339,354,1791,462
158,170335,Caldes de Malavella,2006,5674,2843,2831,936,3863,875
159,080333,Caldes de Montbui,2006,15941,7992,7949,2486,11076,2379
160,080351,Calella,2006,17673,8774,8899,2457,12346,2870
161,080370,Calldetenes,2006,2214,1145,1069,348,1570,296
162,080386,Callús,2006,1577,772,805,231,1038,308
163,080364,Calonge de Segarra,2006,205,106,99,29,115,61
164,170340,Calonge i Sant Antoni,2006,9458,4827,4631,1408,6556,1494
165,250621,Camarasa,2006,931,484,447,70,574,287
166,439039,Camarles,2006,3371,1735,1636,449,2240,682
167,430385,Cambrils,2006,27848,13915,13933,4545,19956,3347
168,170353,Camós,2006,677,341,336,84,444,149
169,170366,Campdevànol,2006,3499,1766,1733,405,2239,855
170,170372,Campelles,2006,106,56,50,4,81,21
171,080399,Campins,2006,363,185,178,71,250,42
172,170388,Campllong,2006,381,194,187,74,237,70
173,170391,Camprodon,2006,2438,1217,1221,270,1592,576
174,250637,Canejan,2006,104,54,50,8,63,33
175,170405,Canet d'Adri,2006,576,297,279,62,408,106
176,080403,Canet de Mar,2006,12766,6274,6492,1868,8689,2209
177,080410,Canovelles,2006,15012,7877,7135,2300,10897,1815
178,080425,Cànoves i Samalús,2006,2490,1295,1195,425,1730,335
179,170412,Cantallops,2006,287,148,139,33,170,84
180,080431,Canyelles,2006,3440,1794,1646,632,2469,339
181,430398,Capafonts,2006,114,60,54,2,74,38
182,430402,Capçanes,2006,408,199,209,37,271,100
183,080446,Capellades,2006,5383,2642,2741,784,3639,960
184,170427,Capmany,2006,494,254,240,56,313,125
185,080459,Capolat,2006,72,38,34,7,47,18
186,080462,Cardedeu,2006,15561,7709,7852,2773,10859,1929
187,080478,Cardona,2006,5226,2541,2685,583,3367,1276
188,080484,Carme,2006,752,397,355,98,475,179
189,430419,Caseres,2006,311,152,159,33,173,105
190,170448,Cassà de la Selva,2006,8780,4510,4270,1345,5871,1564
191,080497,Casserres,2006,1586,772,814,154,1013,419
192,080575,Castell de l'Areny,2006,68,39,29,8,46,14
193,259046,Castell de Mur,2006,163,83,80,20,91,52
194,250642,Castellar de la Ribera,2006,162,79,83,24,92,46
195,080522,Castellar de n'Hug,2006,198,103,95,16,143,39
196,080500,Castellar del Riu,2006,148,83,65,23,99,26
197,080517,Castellar del Vallès,2006,21335,10687,10648,3871,14855,2609
198,080538,Castellbell i el Vilar,2006,3369,1724,1645,450,2317,602
199,080543,Castellbisbal,2006,11272,5803,5469,2208,7933,1131
200,080556,Castellcir,2006,575,301,274,108,378,89
201,250674,Castelldans,2006,1004,548,456,96,648,260
202,080569,Castelldefels,2006,58663,29370,29293,9722,42977,5964
203,080581,Castellet i la Gornal,2006,1919,995,924,305,1278,336
204,170464,Castellfollit de la Roca,2006,993,513,480,114,635,244
205,080608,Castellfollit de Riubregós,2006,201,102,99,16,132,53
206,080594,Castellfollit del Boix,2006,407,197,210,62,261,84
207,080615,Castellgalí,2006,1436,772,664,242,977,217
208,080620,Castellnou de Bages,2006,837,448,389,151,606,80
209,250680,Castellnou de Seana,2006,750,398,352,83,464,203
210,170470,Castelló d'Empúries,2006,10021,5180,4841,1590,6940,1491
211,250693,Castelló de Farfanya,2006,564,293,271,46,355,163
212,080636,Castellolí,2006,460,221,239,70,309,81
213,170486,Castell-Platja d'Aro,2006,9768,5035,4733,1277,7217,1274
214,250707,Castellserà,2006,1128,579,549,108,702,318
215,080641,Castellterçol,2006,2202,1088,1114,297,1427,478
216,430424,Castellvell del Camp,2006,2474,1246,1228,494,1747,233
217,080654,Castellví de la Marca,2006,1603,803,800,236,1040,327
218,080667,Castellví de Rosanes,2006,1505,767,738,285,1041,179
219,430430,"Catllar, el",2006,3519,1833,1686,580,2564,375
220,250714,Cava,2006,56,34,22,1,39,16
221,171899,"Cellera de Ter, la",2006,2096,1065,1031,286,1393,417
222,170499,Celrà,2006,3783,1904,1879,740,2611,432
223,080673,Centelles,2006,6671,3250,3421,951,4509,1211
224,082687,Cercs,2006,1333,679,654,136,831,366
225,082665,Cerdanyola del Vallès,2006,57959,28747,29212,8718,42351,6890
226,080689,Cervelló,2006,7674,3921,3753,1179,5634,861
227,250729,Cervera,2006,9305,4853,4452,1516,6360,1429
228,250735,Cervià de les Garrigues,2006,873,456,417,85,534,254
229,170502,Cervià de Ter,2006,827,408,419,138,519,170
230,170519,Cistella,2006,232,118,114,26,152,54
231,250740,Ciutadilla,2006,223,128,95,23,140,60
232,250753,Clariana de Cardener,2006,146,79,67,22,107,17
233,250766,"Cogul, el",2006,211,117,94,14,132,65
234,170545,Colera,2006,601,310,291,51,410,140
235,250772,Coll de Nargó,2006,618,333,285,54,407,157
236,080692,Collbató,2006,3576,1859,1717,709,2529,338
237,430458,Colldejou,2006,190,105,85,14,143,33
238,080706,Collsuspina,2006,316,168,148,52,221,43
239,170558,Colomers,2006,213,109,104,20,129,64
240,251636,"Coma i la Pedra, la",2006,253,149,104,22,178,53
241,251615,Conca de Dalt,2006,428,221,207,34,262,132
242,430461,Conesa,2006,141,79,62,18,86,37
243,430477,Constantí,2006,5813,3119,2694,915,4113,785
244,080713,Copons,2006,289,140,149,37,194,58
245,430483,Corbera d'Ebre,2006,1128,603,525,131,718,279
246,080728,Corbera de Llobregat,2006,12805,6544,6261,2325,9125,1355
247,250788,Corbins,2006,1347,733,614,172,928,247
248,170577,Corçà,2006,1261,633,628,144,897,220
249,080734,Cornellà de Llobregat,2006,84289,41844,42445,11746,58132,14411
250,170561,Cornellà del Terri,2006,2079,1040,1039,286,1396,397
251,430496,Cornudella de Montsant,2006,979,513,466,107,633,239
252,430509,Creixell,2006,2758,1417,1341,383,1866,509
253,170583,Crespià,2006,242,127,115,32,152,58
254,179011,"Cruïlles, Monells i Sant Sadurní de l'Heura",2006,1271,641,630,185,880,206
255,080749,Cubelles,2006,11835,6316,5519,1825,8533,1477
256,250791,Cubells,2006,401,203,198,52,215,134
257,430516,Cunit,2006,10033,5195,4838,1500,7053,1480
258,170600,Darnius,2006,547,276,271,53,349,145
259,170617,Das,2006,176,98,78,22,122,32
260,439018,Deltebre,2006,10811,5457,5354,1376,7276,2159
261,080752,Dosrius,2006,4469,2236,2233,770,3278,421
262,430537,Duesaigües,2006,211,128,83,19,132,60
263,170622,"Escala, l'",2006,8795,4552,4243,1128,6116,1551
264,080765,Esparreguera,2006,21145,10869,10276,3528,15046,2571
265,170638,Espinelves,2006,199,108,91,23,121,55
266,250812,"Espluga Calba, l'",2006,452,243,209,31,300,121
267,430542,"Espluga de Francolí, l'",2006,3857,1915,1942,495,2499,863
268,080771,Esplugues de Llobregat,2006,46808,22940,23868,6050,33419,7339
269,170643,Espolla,2006,367,184,183,34,228,105
270,170656,Esponellà,2006,437,219,218,63,291,83
271,250827,Espot,2006,360,199,161,49,254,57
272,080787,"Espunyola, l'",2006,272,137,135,35,167,70
273,082541,"Esquirol, l'",2006,2239,1117,1122,333,1433,473
274,250886,Estamariu,2006,117,62,55,10,68,39
275,080790,"Estany, l'",2006,383,184,199,37,239,107
276,250851,Estaràs,2006,184,101,83,16,117,51
277,250864,Esterri d'Àneu,2006,803,404,399,103,545,155
278,250870,Esterri de Cardós,2006,69,32,37,5,47,17
279,430555,Falset,2006,2717,1373,1344,387,1783,547
280,170059,"Far d'Empordà, el",2006,483,247,236,83,313,87
281,250899,Farrera,2006,104,60,44,8,78,18
282,430568,"Fatarella, la",2006,1160,585,575,110,700,350
283,430574,"Febró, la",2006,58,35,23,1,45,12
284,081347,Figaró-Montmany,2006,1019,526,493,147,663,209
285,080804,Fígols,2006,42,24,18,3,22,17
286,259084,Fígols i Alinyà,2006,254,137,117,8,149,97
287,430580,"Figuera, la",2006,165,87,78,10,113,42
288,170669,Figueres,2006,39641,19636,20005,6274,27112,6255
289,430593,Figuerola del Camp,2006,336,153,183,62,203,71
290,170675,Flaçà,2006,997,494,503,122,671,204
291,430607,Flix,2006,3960,2024,1936,396,2662,902
292,250925,"Floresta, la",2006,185,98,87,21,107,57
293,080826,Fogars de la Selva,2006,1338,689,649,255,919,164
294,080811,Fogars de Montclús,2006,437,238,199,69,293,75
295,170681,Foixà,2006,325,168,157,44,198,83
296,080832,Folgueroles,2006,1983,991,992,381,1321,281
297,250931,Fondarella,2006,783,400,383,108,559,116
298,080847,Fonollosa,2006,1280,655,625,197,890,193
299,170694,Fontanals de Cerdanya,2006,425,212,213,39,309,77
300,170708,Fontanilles,2006,175,101,74,19,118,38
301,170715,Fontcoberta,2006,1181,574,607,181,858,142
302,080850,Font-rubí,2006,1394,736,658,206,869,319
303,250946,Foradada,2006,197,116,81,14,128,55
304,179026,Forallac,2006,1746,864,882,224,1213,309
305,430614,Forès,2006,57,32,25,0,31,26
306,170736,Fornells de la Selva,2006,1890,912,978,361,1303,226
307,170741,Fortià,2006,582,295,287,79,381,122
308,080863,"Franqueses del Vallès, les",2006,15817,8138,7679,2553,11478,1786
309,430629,Freginals,2006,444,236,208,44,283,117
310,250962,"Fuliola, la",2006,1235,621,614,135,783,317
311,250978,Fulleda,2006,115,61,54,5,78,32
312,080902,Gaià,2006,154,79,75,23,104,27
313,430635,"Galera, la",2006,824,411,413,94,517,213
314,080879,Gallifa,2006,216,114,102,38,152,26
315,430640,Gandesa,2006,3091,1604,1487,377,2057,657
316,430653,Garcia,2006,534,279,255,46,325,163
317,430666,"Garidells, els",2006,196,100,96,26,133,37
318,080885,"Garriga, la",2006,13942,6756,7186,2399,9591,1952
319,170754,Garrigàs,2006,346,192,154,44,216,86
320,170767,Garrigoles,2006,155,85,70,16,100,39
321,170773,Garriguella,2006,731,377,354,93,480,158
322,080898,Gavà,2006,44531,22218,22313,6918,31662,5951
323,250984,Gavet de la Conca,2006,309,145,164,22,175,112
324,080919,Gelida,2006,5976,3053,2923,996,4125,855
325,170789,Ger,2006,450,241,209,57,325,68
326,259123,Gimenells i el Pla de la Font,2006,1118,588,530,126,731,261
327,430672,Ginestar,2006,965,514,451,103,622,240
328,170792,Girona,2006,89890,43863,46027,14467,63069,12354
329,080924,Gironella,2006,4786,2301,2485,532,3035,1219
330,080930,Gisclareny,2006,33,18,15,0,30,3
331,430688,Godall,2006,771,399,372,81,455,235
332,250997,Golmés,2006,1560,785,775,234,1048,278
333,170806,Gombrèn,2006,222,111,111,22,148,52
334,251001,Gósol,2006,221,117,104,11,152,58
335,080945,"Granada, la",2006,1754,887,867,266,1220,268
336,251018,"Granadella, la",2006,774,404,370,74,449,251
337,080958,Granera,2006,75,52,23,1,58,16
338,251023,"Granja d'Escarp, la",2006,1042,552,490,101,693,248
339,080961,Granollers,2006,58940,29414,29526,8838,41765,8337
340,251039,Granyanella,2006,172,89,83,13,116,43
341,251057,Granyena de les Garrigues,2006,176,96,80,9,113,54
342,251044,Granyena de Segarra,2006,149,77,72,4,88,57
343,430691,Gratallops,2006,246,135,111,31,156,59
344,080977,Gualba,2006,1048,552,496,166,749,133
345,170813,Gualta,2006,358,210,148,54,240,64
346,080996,Guardiola de Berguedà,2006,931,484,447,116,581,234
347,430705,"Guiamets, els",2006,330,175,155,34,203,93
348,170828,Guils de Cerdanya,2006,438,226,212,51,324,63
349,251095,Guimerà,2006,344,180,164,16,187,141
350,259031,"Guingueta d'Àneu, la",2006,360,190,170,48,233,79
351,251109,Guissona,2006,5139,2783,2356,886,3690,563
352,251116,Guixers,2006,137,82,55,6,97,34
353,081000,Gurb,2006,2296,1164,1132,434,1568,294
354,430712,Horta de Sant Joan,2006,1238,667,571,143,770,325
355,081017,"Hospitalet de Llobregat, l'",2006,248150,121707,126443,29788,173062,45300
356,081629,"Hostalets de Pierola, els",2006,2003,1050,953,330,1407,266
357,170834,Hostalric,2006,3619,1852,1767,565,2524,530
358,081022,Igualada,2006,36817,18223,18594,5450,25002,6365
359,251155,Isona i Conca Dellà,2006,1139,613,526,117,672,350
360,170849,Isòvol,2006,265,152,113,21,195,49
361,251137,Ivars d'Urgell,2006,1858,983,875,210,1203,445
362,251121,Ivars de Noguera,2006,357,190,167,29,234,94
363,251142,Ivorra,2006,144,68,76,11,87,46
364,170852,Jafre,2006,386,213,173,30,255,101
365,170865,"Jonquera, la",2006,3020,1564,1456,402,2232,386
366,081038,Jorba,2006,714,348,366,144,437,133
367,259101,Josa i Tuixén,2006,176,91,85,16,119,41
368,170871,Juià,2006,318,174,144,49,204,65
369,251180,Juncosa,2006,546,301,245,56,331,159
370,251193,Juneda,2006,3264,1711,1553,415,2161,688
371,251214,Les,2006,903,445,458,119,657,127
372,251229,Linyola,2006,2583,1313,1270,341,1719,523
373,081043,"Llacuna, la",2006,860,465,395,99,568,193
374,170887,Lladó,2006,591,301,290,83,385,123
375,251235,Lladorre,2006,211,101,110,19,143,49
376,251240,Lladurs,2006,207,112,95,25,129,53
377,081056,"Llagosta, la",2006,13674,6918,6756,2004,9846,1824
378,170890,Llagostera,2006,7062,3661,3401,1097,4752,1213
379,170904,Llambilles,2006,612,313,299,91,420,101
380,170911,Llanars,2006,558,295,263,59,389,110
381,170926,Llançà,2006,4611,2287,2324,602,3120,889
382,251253,Llardecans,2006,562,291,271,52,339,171
383,251266,Llavorsí,2006,334,173,161,31,223,80
384,251207,Lleida,2006,125677,62347,63330,18182,87452,20043
385,170932,Llers,2006,1167,594,573,172,799,196
386,251272,Lles de Cerdanya,2006,227,134,93,15,149,63
387,081075,Lliçà d'Amunt,2006,12938,6629,6309,2406,9029,1503
388,081081,Lliçà de Vall,2006,6033,3138,2895,1024,4321,688
389,251288,Llimiana,2006,158,87,71,10,99,49
390,081069,Llinars del Vallès,2006,8425,4231,4194,1391,5890,1144
391,170947,Llívia,2006,1291,694,597,146,968,177
392,430727,"Lloar, el",2006,111,61,50,8,67,36
393,251291,Llobera,2006,222,118,104,19,142,61
394,430733,Llorac,2006,116,59,57,11,72,33
395,430748,Llorenç del Penedès,2006,2073,1016,1057,366,1387,320
396,170950,Lloret de Mar,2006,32728,17268,15460,4915,24554,3259
397,170963,"Llosses, les",2006,246,134,112,23,174,49
398,081094,Lluçà,2006,253,135,118,39,167,47
399,171024,Maçanet de Cabrenys,2006,700,366,334,58,445,197
400,171030,Maçanet de la Selva,2006,5712,2925,2787,894,4035,783
401,170979,Madremanya,2006,222,102,120,28,146,48
402,170985,Maià de Montcal,2006,379,197,182,47,250,82
403,251333,Maials,2006,973,494,479,100,572,301
404,251305,Maldà,2006,285,152,133,31,162,92
405,081108,Malgrat de Mar,2006,17531,8869,8662,2492,12175,2864
406,081115,Malla,2006,257,120,137,29,187,41
407,081120,Manlleu,2006,19979,10159,9820,3355,13396,3228
408,081136,Manresa,2006,71772,35280,36492,10013,47640,14119
409,430764,Marçà,2006,653,328,325,84,390,179
410,430751,Margalef,2006,128,70,58,12,75,41
411,082423,Marganell,2006,288,130,158,37,185,66
412,081141,Martorell,2006,26170,13582,12588,4310,18320,3540
413,081154,Martorelles,2006,4938,2511,2427,680,3463,795
414,430770,Mas de Barberans,2006,679,342,337,63,432,184
415,171002,Masarac,2006,265,133,132,32,168,65
416,430786,Masdenverge,2006,1077,569,508,134,706,237
417,081167,"Masies de Roda, les",2006,742,372,370,89,523,130
418,081173,"Masies de Voltregà, les",2006,3125,1530,1595,528,2122,475
419,430799,Masllorenç,2006,500,258,242,68,315,117
420,081189,"Masnou, el",2006,21833,10533,11300,3234,15299,3300
421,430803,"Masó, la",2006,280,135,145,23,188,69
422,430810,Maspujols,2006,529,271,258,92,316,121
423,081192,Masquefa,2006,7414,3767,3647,1420,5165,829
424,430825,"Masroig, el",2006,538,272,266,58,327,153
425,251312,Massalcoreig,2006,635,346,289,75,397,163
426,171019,Massanes,2006,660,348,312,86,461,113
427,251327,Massoteres,2006,225,123,102,33,145,47
428,081206,Matadepera,2006,8169,4125,4044,1731,5540,898
429,081213,Mataró,2006,118748,59683,59065,17474,83970,17304
430,081228,Mediona,2006,2083,1102,981,287,1385,411
431,251348,Menàrguens,2006,863,450,413,91,523,249
432,170998,Meranges,2006,86,53,33,5,55,26
433,171058,Mieres,2006,331,175,156,51,208,72
434,430831,"Milà, el",2006,180,84,96,24,115,41
435,251351,Miralcamp,2006,1310,659,651,159,880,271
436,430846,Miravet,2006,796,419,377,83,516,197
437,081385,Moià,2006,5399,2761,2638,918,3638,843
438,430859,"Molar, el",2006,302,166,136,30,179,93
439,081234,Molins de Rei,2006,23374,11511,11863,3631,16400,3343
440,251370,Mollerussa,2006,12569,6555,6014,2052,8842,1675
441,171061,Mollet de Peralada,2006,172,85,87,13,106,53
442,081249,Mollet del Vallès,2006,51713,26270,25443,8273,37512,5928
443,171077,Molló,2006,329,165,164,23,218,88
444,251364,"Molsosa, la",2006,127,60,67,11,87,29
445,081287,Monistrol de Calders,2006,691,348,343,95,461,135
446,081271,Monistrol de Montserrat,2006,2840,1490,1350,329,1968,543
447,171096,Montagut i Oix,2006,903,468,435,123,571,209
448,430862,Montblanc,2006,6767,3422,3345,931,4615,1221
449,430884,Montbrió del Camp,2006,1774,916,858,263,1162,349
450,081252,Montcada i Reixac,2006,32153,16038,16115,5169,22490,4494
451,081304,Montclar,2006,116,54,62,19,69,28
452,251399,Montellà i Martinet,2006,606,324,282,61,399,146
453,081311,Montesquiu,2006,875,448,427,99,574,202
454,251403,Montferrer i Castellbò,2006,944,512,432,111,680,153
455,430897,Montferri,2006,258,138,120,44,159,55
456,251386,Montgai,2006,772,387,385,87,453,232
457,081265,Montgat,2006,9427,4617,4810,1368,6828,1231
458,081326,Montmajor,2006,463,243,220,45,309,109
459,081332,Montmaneu,2006,201,109,92,18,130,53
460,430901,"Montmell, el",2006,1175,637,538,173,830,172
461,081350,Montmeló,2006,8921,4463,4458,1409,6300,1212
462,251425,Montoliu de Lleida,2006,498,258,240,52,328,118
463,251410,Montoliu de Segarra,2006,186,106,80,9,117,60
464,251431,Montornès de Segarra,2006,105,50,55,6,59,40
465,081363,Montornès del Vallès,2006,14516,7486,7030,2359,10426,1731
466,430918,Mont-ral,2006,179,99,80,14,145,20
467,171100,Mont-ras,2006,1841,967,874,288,1312,241
468,430923,Mont-roig del Camp,2006,9456,4884,4572,1317,6729,1410
469,081379,Montseny,2006,299,163,136,25,210,64
470,430939,Móra d'Ebre,2006,5098,2518,2580,782,3325,991
471,430944,Móra la Nova,2006,3216,1667,1549,450,2179,587
472,430957,"Morell, el",2006,2704,1415,1289,455,1868,381
473,430960,"Morera de Montsant, la",2006,165,95,70,19,112,34
474,081290,Muntanyola,2006,464,247,217,87,332,45
475,081398,Mura,2006,233,127,106,26,166,41
476,251459,Nalec,2006,102,49,53,8,63,31
477,250254,Naut Aran,2006,1732,918,814,241,1296,195
478,081402,Navarcles,2006,5723,2830,2893,803,3869,1051
479,081419,Navàs,2006,5810,2878,2932,800,3784,1226
480,171117,Navata,2006,980,488,492,177,621,182
481,251462,Navès,2006,262,127,135,32,166,64
482,081424,"Nou de Berguedà, la",2006,162,83,79,31,89,42
483,430976,"Nou de Gaià, la",2006,449,229,220,72,285,92
484,430982,Nulles,2006,382,192,190,35,262,85
485,251484,Odèn,2006,275,158,117,17,179,79
486,081430,Òdena,2006,3100,1565,1535,521,2112,467
487,171122,Ogassa,2006,265,152,113,29,183,53
488,081458,Olèrdola,2006,3084,1616,1468,548,2151,385
489,081461,Olesa de Bonesvalls,2006,1506,795,711,236,1083,187
490,081477,Olesa de Montserrat,2006,21714,10991,10723,3593,15085,3036
491,251497,Oliana,2006,1939,983,956,204,1300,435
492,251500,Oliola,2006,246,142,104,22,168,56
493,251517,Olius,2006,686,345,341,120,458,108
494,081483,Olivella,2006,2515,1341,1174,448,1859,208
495,081496,Olost,2006,1187,591,596,146,745,296
496,171143,Olot,2006,31932,16043,15889,4410,21054,6468
497,251522,"Oluges, les",2006,174,91,83,8,109,57
498,081445,Olvan,2006,922,454,468,101,584,237
499,251538,"Omellons, els",2006,252,131,121,21,159,72
500,251543,"Omells de na Gaia, els",2006,159,94,65,13,100,46
501,171156,Ordis,2006,353,185,168,55,237,61
502,251556,Organyà,2006,961,476,485,89,606,266
503,081509,Orís,2006,284,141,143,39,196,49
504,081516,Oristà,2006,593,292,301,46,388,159
505,081521,Orpí,2006,190,97,93,24,128,38
506,081537,Òrrius,2006,295,153,142,13,213,69
507,251569,Os de Balaguer,2006,924,494,430,126,569,229
508,171169,Osor,2006,390,198,192,33,226,131
509,251575,Ossó de Sió,2006,236,118,118,27,147,62
510,081542,Pacs del Penedès,2006,787,392,395,123,562,102
511,081555,Palafolls,2006,7583,3801,3782,1388,5398,797
512,171175,Palafrugell,2006,21307,10950,10357,3147,14720,3440
513,171181,Palamós,2006,17197,8522,8675,2581,11795,2821
514,251581,"Palau d'Anglesola, el",2006,1883,961,922,260,1244,379
515,171194,Palau de Santa Eulàlia,2006,91,53,38,7,67,17
516,171215,Palau-sator,2006,280,150,130,21,190,69
517,171208,Palau-saverdera,2006,1197,603,594,134,797,266
518,081568,Palau-solità i Plegamans,2006,13310,6786,6524,2353,9599,1358
519,431009,"Pallaresos, els",2006,3346,1727,1619,738,2388,220
520,081574,Pallejà,2006,10535,5326,5209,1846,7541,1148
521,430995,"Palma d'Ebre, la",2006,398,190,208,36,229,133
522,089058,"Palma de Cervelló, la",2006,2988,1501,1487,495,2166,327
523,171236,Palol de Revardit,2006,429,229,200,75,273,81
524,171241,Pals,2006,2400,1231,1169,260,1583,557
525,081580,"Papiol, el",2006,3733,1887,1846,570,2636,527
526,171254,Pardines,2006,149,80,69,18,89,42
527,081593,Parets del Vallès,2006,16413,8402,8011,2756,11763,1894
528,171267,Parlavà,2006,352,185,167,32,237,83
529,431016,Passanant i Belltall,2006,174,93,81,5,100,69
530,171289,Pau,2006,501,260,241,65,342,94
531,431021,Paüls,2006,602,301,301,58,369,175
532,171292,Pedret i Marzà,2006,154,80,74,22,104,28
533,251641,Penelles,2006,525,297,228,49,320,156
534,171306,"Pera, la",2006,436,224,212,55,283,98
535,081607,Perafita,2006,379,187,192,47,239,93
536,431037,Perafort,2006,901,480,421,136,663,102
537,171328,Peralada,2006,1625,836,789,235,1099,291
538,251654,Peramola,2006,377,203,174,40,228,109
539,431042,"Perelló, el",2006,2504,1327,1177,264,1635,605
540,081614,Piera,2006,12951,6668,6283,2237,8764,1950
541,431055,"Piles, les",2006,196,112,84,26,134,36
542,081635,Pineda de Mar,2006,25504,13083,12421,3740,18097,3667
543,431068,"Pinell de Brai, el",2006,1112,571,541,127,688,297
544,251667,Pinell de Solsonès,2006,204,110,94,22,133,49
545,251673,Pinós,2006,322,179,143,33,212,77
546,431074,Pira,2006,475,236,239,82,299,94
547,431080,"Pla de Santa Maria, el",2006,2009,1061,948,298,1355,356
548,081640,"Pla del Penedès, el",2006,931,476,455,118,594,219
549,171334,"Planes d'Hostoles, les",2006,1798,913,885,217,1094,487
550,171349,Planoles,2006,281,151,130,23,188,70
551,259118,"Plans de Sió, els",2006,570,297,273,54,330,186
552,251689,"Poal, el",2006,660,353,307,68,417,175
553,251692,"Pobla de Cérvoles, la",2006,250,138,112,30,152,68
554,081653,"Pobla de Claramunt, la",2006,2112,1114,998,345,1425,342
555,081666,"Pobla de Lillet, la",2006,1327,640,687,94,842,391
556,431093,"Pobla de Mafumet, la",2006,1465,724,741,258,1034,173
557,431107,"Pobla de Massaluca, la",2006,407,216,191,26,247,134
558,431114,"Pobla de Montornès, la",2006,2339,1238,1101,333,1644,362
559,251713,"Pobla de Segur, la",2006,3050,1554,1496,324,1902,824
560,431129,Poboleda,2006,353,200,153,24,229,100
561,081672,Polinyà,2006,6764,3463,3301,1189,5081,494
562,431135,"Pont d'Armentera, el",2006,580,296,284,59,370,151
563,250306,"Pont de Bar, el",2006,193,109,84,23,118,52
564,171352,Pont de Molins,2006,419,223,196,47,301,71
565,251734,"Pont de Suert, el",2006,2317,1201,1116,272,1560,485
566,081825,"Pont de Vilomara i Rocafort, el",2006,3310,1708,1602,538,2298,474
567,431418,Pontils,2006,139,71,68,11,94,34
568,081688,Pontons,2006,498,273,225,64,346,88
569,171365,Pontós,2006,217,119,98,21,139,57
570,251728,Ponts,2006,2567,1287,1280,353,1658,556
571,171371,Porqueres,2006,4154,2054,2100,702,2865,587
572,431140,Porrera,2006,488,266,222,55,308,125
573,171404,"Port de la Selva, el",2006,908,460,448,99,606,203
574,171387,Portbou,2006,1347,675,672,104,839,404
575,251749,"Portella, la",2006,796,457,339,70,592,134
576,431153,Pradell de la Teixeta,2006,178,88,90,14,119,45
577,431166,Prades,2006,622,323,299,73,390,159
578,431172,Prat de Comte,2006,196,97,99,23,111,62
579,081691,"Prat de Llobregat, el",2006,63069,31526,31543,8951,45339,8779
580,431188,Pratdip,2006,715,383,332,69,451,195
581,081712,Prats de Lluçanès,2006,2753,1392,1361,398,1754,601
582,081705,"Prats de Rei, els",2006,532,271,261,49,357,126
583,251752,Prats i Sansor,2006,226,133,93,27,170,29
584,251765,Preixana,2006,422,217,205,42,239,141
585,251771,Preixens,2006,514,256,258,61,282,171
586,082303,Premià de Dalt,2006,9890,4913,4977,1657,7034,1199
587,081727,Premià de Mar,2006,27860,13918,13942,4255,19751,3854
588,171390,"Preses, les",2006,1692,833,859,263,1144,285
589,251790,Prullans,2006,224,110,114,24,140,60
590,171411,Puigcerdà,2006,8859,4628,4231,1430,6222,1207
591,081748,Puigdàlber,2006,377,180,197,60,260,57
592,251804,Puiggròs,2006,298,160,138,46,183,69
593,431191,Puigpelat,2006,829,436,393,151,573,105
594,081751,Puig-reig,2006,4202,2059,2143,443,2643,1116
595,251811,Puigverd d'Agramunt,2006,268,147,121,36,169,63
596,251826,Puigverd de Lleida,2006,1259,640,619,186,817,256
597,081764,Pujalt,2006,203,101,102,21,129,53
598,081770,"Quar, la",2006,61,35,26,1,45,15
599,171426,Quart,2006,2637,1361,1276,396,1925,316
600,170433,Queralbs,2006,198,113,85,24,117,57
601,431205,Querol,2006,416,218,198,58,306,52
602,171432,Rabós,2006,194,97,97,22,137,35
603,081786,Rajadell,2006,467,251,216,58,319,90
604,431212,Rasquera,2006,934,480,454,98,570,266
605,171447,Regencós,2006,304,169,135,39,198,67
606,081799,Rellinars,2006,653,330,323,100,448,105
607,431227,Renau,2006,93,44,49,14,67,12
608,431233,Reus,2006,101767,50697,51070,16223,70713,14831
609,251832,Rialp,2006,649,341,308,78,485,86
610,431248,"Riba, la",2006,682,373,309,71,454,157
611,431251,Riba-roja d'Ebre,2006,1353,706,647,128,855,370
612,259059,Ribera d'Ondara,2006,476,255,221,46,294,136
613,251850,Ribera d'Urgellet,2006,971,515,456,110,653,208
614,171450,Ribes de Freser,2006,2017,993,1024,196,1265,556
615,171463,Riells i Viabrea,2006,3238,1686,1552,620,2324,294
616,431264,"Riera de Gaià, la",2006,1332,685,647,213,906,213
617,251863,Riner,2006,274,137,137,31,177,66
618,171479,Ripoll,2006,10832,5367,5465,1279,7155,2398
619,081803,Ripollet,2006,35427,18022,17405,5707,25438,4282
620,259139,Riu de Cerdanya,2006,94,47,47,7,68,19
621,171485,Riudarenes,2006,1761,919,842,243,1221,297
622,171498,Riudaura,2006,417,214,203,38,303,76
623,431270,Riudecanyes,2006,878,447,431,120,571,187
624,431286,Riudecols,2006,1133,590,543,150,771,212
625,171501,Riudellots de la Selva,2006,1849,952,897,268,1274,307
626,431299,Riudoms,2006,5925,3009,2916,964,3931,1030
627,171518,Riumors,2006,172,91,81,15,101,56
628,081810,"Roca del Vallès, la",2006,9418,4759,4659,1587,6748,1083
629,431303,Rocafort de Queralt,2006,264,138,126,22,156,86
630,431310,Roda de Berà,2006,5196,2747,2449,738,3688,770
631,081831,Roda de Ter,2006,5535,2695,2840,834,3673,1028
632,431325,Rodonyà,2006,474,249,225,71,294,109
633,431331,Roquetes,2006,7444,3891,3553,1101,5068,1275
634,171523,Roses,2006,17173,8696,8477,2859,11980,2334
635,251898,Rosselló,2006,2478,1308,1170,399,1699,380
636,431346,"Rourell, el",2006,354,177,177,57,220,77
637,081846,Rubí,2006,70006,35444,34562,11064,50687,8255
638,081859,Rubió,2006,146,81,65,22,91,33
639,171539,Rupià,2006,213,113,100,26,135,52
640,089019,Rupit i Pruit,2006,339,164,175,27,234,78
641,081878,Sabadell,2006,200545,98312,102233,29286,137931,33328
642,081884,Sagàs,2006,143,70,73,25,87,31
643,251902,Salàs de Pallars,2006,330,168,162,18,197,115
644,081901,Saldes,2006,326,180,146,30,238,58
645,171544,Sales de Llierca,2006,128,63,65,25,95,8
646,081918,Sallent,2006,7146,3446,3700,861,4594,1691
647,431359,Salomó,2006,439,228,211,57,267,115
648,439057,Salou,2006,22162,11890,10272,3097,17149,1916
649,171557,Salt,2006,28017,14906,13111,4754,19831,3432
650,251919,Sanaüja,2006,448,229,219,59,252,137
651,081944,Sant Adrià de Besòs,2006,32585,16002,16583,5211,22094,5280
652,081957,Sant Agustí de Lluçanès,2006,107,56,51,13,71,23
653,081960,Sant Andreu de la Barca,2006,25383,13073,12310,4409,18658,2316
654,081976,Sant Andreu de Llavaneres,2006,9463,4842,4621,1817,6478,1168
655,171576,Sant Andreu Salou,2006,156,73,83,31,85,40
656,171833,Sant Aniol de Finestres,2006,289,152,137,40,192,57
657,081982,Sant Antoni de Vilamajor,2006,4877,2460,2417,841,3403,633
658,081995,Sant Bartomeu del Grau,2006,1001,527,474,163,678,160
659,082009,Sant Boi de Llobregat,2006,81368,40483,40885,11892,57869,11607
660,082016,Sant Boi de Lluçanès,2006,575,291,284,55,365,155
661,431362,Sant Carles de la Ràpita,2006,13488,6737,6751,1910,9047,2531
662,082037,Sant Cebrià de Vallalta,2006,2873,1533,1340,469,2137,267
663,082021,Sant Celoni,2006,15544,7823,7721,2451,10633,2460
664,082042,Sant Climent de Llobregat,2006,3516,1772,1744,607,2500,409
665,171582,Sant Climent Sescebes,2006,482,250,232,72,288,122
666,082055,Sant Cugat del Vallès,2006,73774,36199,37575,15433,51034,7307
667,082068,Sant Cugat Sesgarrigues,2006,890,464,426,154,578,158
668,251961,Sant Esteve de la Sarga,2006,155,99,56,8,98,49
669,082074,Sant Esteve de Palautordera,2006,2079,1019,1060,434,1423,222
670,082080,Sant Esteve Sesrovires,2006,6590,3382,3208,1166,4723,701
671,171595,Sant Feliu de Buixalleu,2006,756,402,354,103,501,152
672,082107,Sant Feliu de Codines,2006,5412,2789,2623,861,3696,855
673,171609,Sant Feliu de Guíxols,2006,20867,10337,10530,3196,14159,3512
674,082114,Sant Feliu de Llobregat,2006,42486,20855,21631,6540,30390,5556
675,171616,Sant Feliu de Pallerols,2006,1272,631,641,178,819,275
676,082129,Sant Feliu Sasserra,2006,622,306,316,78,407,137
677,171621,Sant Ferriol,2006,194,107,87,28,125,41
678,082093,Sant Fost de Campsentelles,2006,7409,3764,3645,1127,5316,966
679,082135,Sant Fruitós de Bages,2006,7199,3701,3498,1213,5076,910
680,171637,Sant Gregori,2006,2951,1505,1446,494,2045,412
681,251924,Sant Guim de Freixenet,2006,1057,524,533,126,692,239
682,251977,Sant Guim de la Plana,2006,199,107,92,28,119,52
683,171642,Sant Hilari Sacalm,2006,5385,2789,2596,673,3701,1011
684,082153,Sant Hipòlit de Voltregà,2006,3319,1665,1654,513,2122,684
685,081939,Sant Iscle de Vallalta,2006,1166,604,562,233,773,160
686,439023,Sant Jaume d'Enveja,2006,3368,1711,1657,430,2195,743
687,082166,Sant Jaume de Frontanyà,2006,32,15,17,3,24,5
688,171655,Sant Jaume de Llierca,2006,815,409,406,96,494,225
689,431378,Sant Jaume dels Domenys,2006,1998,1046,952,309,1321,368
690,171674,Sant Joan de les Abadesses,2006,3565,1788,1777,385,2278,902
691,171680,Sant Joan de Mollet,2006,487,245,242,82,308,97
692,082188,Sant Joan de Vilatorrada,2006,10362,5234,5128,1576,7236,1550
693,082172,Sant Joan Despí,2006,31485,15560,15925,5317,22401,3767
694,171851,Sant Joan les Fonts,2006,2652,1347,1305,269,1796,587
695,171668,Sant Jordi Desvalls,2006,632,314,318,82,400,150
696,089030,Sant Julià de Cerdanyola,2006,259,137,122,40,156,63
697,171693,Sant Julià de Ramis,2006,2656,1363,1293,444,1864,348
698,082205,Sant Julià de Vilatorta,2006,2809,1370,1439,501,1927,381
699,179032,Sant Julià del Llor i Bonmatí,2006,1093,558,535,157,743,193
700,082212,Sant Just Desvern,2006,15327,7249,8078,2545,10528,2254
701,082227,Sant Llorenç d'Hortons,2006,2126,1081,1045,361,1439,326
702,171714,Sant Llorenç de la Muga,2006,196,102,94,21,129,46
703,251930,Sant Llorenç de Morunys,2006,950,494,456,91,615,244
704,082233,Sant Llorenç Savall,2006,2271,1155,1116,341,1458,472
705,082251,Sant Martí d'Albars,2006,114,57,57,10,76,28
706,082248,Sant Martí de Centelles,2006,907,469,438,162,605,140
707,171729,Sant Martí de Llémena,2006,520,268,252,91,342,87
708,259025,Sant Martí de Riucorb,2006,709,376,333,57,440,212
709,082264,Sant Martí de Tous,2006,1101,562,539,191,678,232
710,082270,Sant Martí Sarroca,2006,2849,1457,1392,418,1884,547
711,082286,Sant Martí Sesgueioles,2006,361,185,176,59,223,79
712,171735,Sant Martí Vell,2006,209,116,93,34,136,39
713,082299,Sant Mateu de Bages,2006,661,337,324,62,388,211
714,171740,Sant Miquel de Campmajor,2006,218,117,101,26,150,42
715,171753,Sant Miquel de Fluvià,2006,671,347,324,100,444,127
716,171766,Sant Mori,2006,164,80,84,16,120,28
717,171772,Sant Pau de Segúries,2006,666,335,331,69,419,178
718,082310,Sant Pere de Ribes,2006,26859,13576,13283,4674,19277,2908
719,082325,Sant Pere de Riudebitlles,2006,2246,1136,1110,336,1498,412
720,082331,Sant Pere de Torelló,2006,2264,1131,1133,288,1541,435
721,082346,Sant Pere de Vilamajor,2006,3578,1809,1769,689,2448,441
722,171788,Sant Pere Pescador,2006,1804,988,816,256,1250,298
723,081897,Sant Pere Sallavinera,2006,171,87,84,15,106,50
724,082359,Sant Pol de Mar,2006,4773,2433,2340,754,3360,659
725,082362,Sant Quintí de Mediona,2006,2039,1069,970,287,1362,390
726,082378,Sant Quirze de Besora,2006,2069,1014,1055,243,1297,529
727,082384,Sant Quirze del Vallès,2006,17138,8477,8661,3319,12327,1492
728,082397,Sant Quirze Safaja,2006,579,302,277,102,426,51
729,251945,Sant Ramon,2006,565,302,263,55,354,156
730,082401,Sant Sadurní d'Anoia,2006,11617,5768,5849,1974,7863,1780
731,082418,Sant Sadurní d'Osormort,2006,89,52,37,12,60,17
732,080983,Sant Salvador de Guardiola,2006,2863,1459,1404,479,2012,372
733,082628,Sant Vicenç de Castellet,2006,7835,3787,4048,1061,5220,1554
734,082649,Sant Vicenç de Montalt,2006,5127,2608,2519,1099,3501,527
735,082652,Sant Vicenç de Torelló,2006,1911,922,989,317,1209,385
736,082634,Sant Vicenç dels Horts,2006,27019,13563,13456,4503,19108,3408
737,431384,Santa Bàrbara,2006,3715,1883,1832,521,2362,832
738,082439,Santa Cecília de Voltregà,2006,199,107,92,27,135,37
739,082444,Santa Coloma de Cervelló,2006,7314,3661,3653,1419,5163,732
740,171805,Santa Coloma de Farners,2006,10565,5417,5148,1658,7224,1683
741,082457,Santa Coloma de Gramenet,2006,119056,60583,58473,15335,85420,18301
742,431397,Santa Coloma de Queralt,2006,3035,1518,1517,493,1959,583
743,171812,Santa Cristina d'Aro,2006,4214,2164,2050,717,2914,583
744,082460,Santa Eugènia de Berga,2006,2178,1149,1029,268,1595,315
745,082476,Santa Eulàlia de Riuprimer,2006,926,477,449,138,619,169
746,082482,Santa Eulàlia de Ronçana,2006,6111,3062,3049,981,4252,878
747,082495,Santa Fe del Penedès,2006,350,180,170,68,233,49
748,171827,Santa Llogaia d'Àlguema,2006,313,165,148,50,220,43
749,082508,Santa Margarida de Montbui,2006,9715,4883,4832,1559,6811,1345
750,082515,Santa Margarida i els Monjos,2006,6221,3269,2952,995,4529,697
751,082589,Santa Maria d'Oló,2006,1072,536,536,120,728,224
752,082536,Santa Maria de Besora,2006,187,94,93,20,117,50
753,082567,Santa Maria de Martorelles,2006,788,403,385,138,545,105
754,082554,Santa Maria de Merlès,2006,152,76,76,22,103,27
755,082573,Santa Maria de Miralles,2006,128,64,64,18,86,24
756,082592,Santa Maria de Palautordera,2006,8099,4221,3878,1355,5652,1092
757,431401,Santa Oliva,2006,2907,1545,1362,490,1942,475
758,171848,Santa Pau,2006,1565,799,766,185,1072,308
759,082606,Santa Perpètua de Mogoda,2006,21644,11014,10630,3221,16012,2411
760,082613,Santa Susanna,2006,2939,1527,1412,522,2053,364
761,081923,Santpedor,2006,6263,3117,3146,970,4384,909
762,431423,Sarral,2006,1596,826,770,204,1051,341
763,171864,Sarrià de Ter,2006,4065,2011,2054,558,2790,717
764,252017,Sarroca de Bellera,2006,142,78,64,4,87,51
765,252000,Sarroca de Lleida,2006,446,230,216,35,288,123
766,171870,"Saus, Camallera i Llampaies",2006,737,372,365,91,501,145
767,431439,Savallà del Comtat,2006,72,38,34,9,41,22
768,431444,"Secuita, la",2006,1269,653,616,178,900,191
769,171886,"Selva de Mar, la",2006,223,115,108,25,151,47
770,431457,"Selva del Camp, la",2006,4983,2515,2468,950,3271,762
771,431460,Senan,2006,46,33,13,9,29,8
772,430445,"Sénia, la",2006,5976,3090,2886,802,4150,1024
773,252022,Senterada,2006,126,66,60,11,90,25
774,250352,"Sentiu de Sió, la",2006,478,232,246,38,312,128
775,082671,Sentmenat,2006,7209,3640,3569,1174,5163,872
776,171903,Serinyà,2006,1045,546,499,158,700,187
777,252043,Seròs,2006,1909,1098,811,184,1268,457
778,171910,Serra de Daró,2006,184,104,80,22,105,57
779,171925,Setcases,2006,181,97,84,19,121,41
780,252038,"Seu d'Urgell, la",2006,12533,6189,6344,1836,8562,2135
781,082690,Seva,2006,3099,1576,1523,502,2130,467
782,252056,Sidamon,2006,688,355,333,86,475,127
783,171931,Sils,2006,4126,2089,2037,696,2841,589
784,082704,Sitges,2006,25642,12641,13001,3866,18261,3515
785,170524,Siurana,2006,181,91,90,17,118,46
786,082711,Sobremunt,2006,102,49,53,21,61,20
787,252069,"Soleràs, el",2006,382,201,181,35,229,118
788,431476,Solivella,2006,630,317,313,88,356,186
789,252075,Solsona,2006,8823,4506,4317,1392,5927,1504
790,082726,Sora,2006,193,106,87,27,133,33
791,252081,Soriguera,2006,337,179,158,32,229,76
792,252094,Sort,2006,2238,1151,1087,322,1514,402
793,252108,Soses,2006,1643,897,746,198,1138,307
794,082732,Subirats,2006,2943,1472,1471,472,1899,572
795,252115,Sudanell,2006,805,437,368,75,556,174
796,252120,Sunyer,2006,283,145,138,32,180,71
797,082747,Súria,2006,6290,3078,3212,822,4016,1452
798,171946,Susqueda,2006,112,64,48,8,81,23
799,082763,Tagamanent,2006,282,150,132,44,192,46
800,082779,Talamanca,2006,134,71,63,15,101,18
801,252154,Talarn,2006,339,163,176,38,215,86
802,252167,Talavera,2006,303,167,136,33,188,82
803,171959,"Tallada d'Empordà, la",2006,367,199,168,44,227,96
804,082785,Taradell,2006,5764,2992,2772,931,3912,921
805,431482,Tarragona,2006,131158,64783,66375,20194,91415,19549
806,252173,Tàrrega,2006,15155,7696,7459,2483,10315,2357
807,252189,Tarrés,2006,111,56,55,6,73,32
808,252192,Tarroja de Segarra,2006,175,92,83,16,107,52
809,082750,Tavèrnoles,2006,300,150,150,36,220,44
810,082802,Tavertet,2006,155,89,66,12,107,36
811,082819,Teià,2006,5867,2981,2886,975,4149,743
812,252206,Térmens,2006,1531,763,768,166,1028,337
813,171962,Terrades,2006,146,72,74,7,91,48
814,082798,Terrassa,2006,199817,99579,100238,30838,139068,29911
815,082824,Tiana,2006,7305,3599,3706,1301,5196,808
816,252213,Tírvia,2006,120,64,56,6,82,32
817,252228,Tiurana,2006,48,26,22,5,27,16
818,431495,Tivenys,2006,916,471,445,97,548,271
819,431508,Tivissa,2006,1788,903,885,205,1125,458
820,082830,Tona,2006,7328,3691,3637,1230,5032,1066
821,252234,Torà,2006,1327,686,641,188,865,274
822,082845,Tordera,2006,13420,6849,6571,2065,9315,2040
823,082858,Torelló,2006,13269,6558,6711,1860,9143,2266
824,252249,"Torms, els",2006,189,101,88,20,106,63
825,252252,Tornabous,2006,823,441,382,76,516,231
826,252271,"Torre de Cabdella, la",2006,722,370,352,39,467,216
827,082861,"Torre de Claramunt, la",2006,3298,1707,1591,587,2361,350
828,431515,"Torre de Fontaubella, la",2006,134,66,68,8,84,42
829,431520,"Torre de l'Espanyol, la",2006,714,374,340,76,457,181
830,252265,Torrebesses,2006,305,155,150,29,178,98
831,431536,Torredembarra,2006,14044,7088,6956,2175,9797,2072
832,252287,Torrefarrera,2006,3051,1575,1476,497,2167,387
833,259078,Torrefeta i Florejacs,2006,650,329,321,78,386,186
834,252304,Torregrossa,2006,2302,1164,1138,262,1467,573
835,252311,Torrelameu,2006,628,357,271,48,434,146
836,082877,Torrelavit,2006,1232,668,564,123,855,254
837,082883,Torrelles de Foix,2006,2252,1202,1050,341,1509,402
838,082896,Torrelles de Llobregat,2006,4861,2446,2415,906,3477,478
839,171978,Torrent,2006,190,100,90,23,130,37
840,252326,Torres de Segre,2006,2054,1066,988,267,1370,417
841,252332,Torre-serona,2006,341,177,164,33,238,70
842,171984,Torroella de Fluvià,2006,460,253,207,56,314,90
843,171997,Torroella de Montgrí,2006,10588,5449,5139,1629,7355,1604
844,431541,Torroja del Priorat,2006,142,82,60,8,99,35
845,172001,Tortellà,2006,729,364,365,88,429,212
846,431554,Tortosa,2006,34266,17496,16770,4655,23293,6318
847,172018,Toses,2006,160,97,63,23,103,34
848,172023,Tossa de Mar,2006,5414,2753,2661,740,3833,841
849,252347,Tremp,2006,5401,2668,2733,662,3304,1435
850,172044,Ullà,2006,1039,591,448,155,744,140
851,082900,Ullastrell,2006,1529,797,732,279,1047,203
852,172057,Ullastret,2006,233,121,112,33,151,49
853,431567,Ulldecona,2006,6229,3198,3031,803,4159,1267
854,431573,Ulldemolins,2006,508,274,234,36,296,176
855,172039,Ultramort,2006,200,115,85,16,126,58
856,172060,Urús,2006,200,103,97,26,136,38
857,082917,Vacarisses,2006,5094,2624,2470,1050,3520,524
858,170144,"Vajol, la",2006,101,59,42,11,69,21
859,172076,"Vall d'en Bas, la",2006,2650,1345,1305,325,1708,617
860,172082,"Vall de Bianya, la",2006,1256,640,616,185,837,234
861,250432,"Vall de Boí, la",2006,1079,582,497,119,791,169
862,259010,Vall de Cardós,2006,393,218,175,40,260,93
863,082922,Vallbona d'Anoia,2006,1311,669,642,191,904,216
864,252385,Vallbona de les Monges,2006,247,127,120,12,147,88
865,082938,Vallcebre,2006,276,149,127,25,180,71
866,431589,Vallclara,2006,108,62,46,9,61,38
867,252402,Vallfogona de Balaguer,2006,1601,802,799,190,1099,312
868,171707,Vallfogona de Ripollès,2006,206,110,96,25,133,48
869,431592,Vallfogona de Riucorb,2006,159,87,72,4,71,84
870,082943,Vallgorguina,2006,2016,1033,983,349,1447,220
871,082956,Vallirana,2006,12928,6501,6427,2244,9077,1607
872,172095,Vall-llobrega,2006,730,439,291,158,503,69
873,431606,Vallmoll,2006,1469,784,685,191,1064,214
874,082969,Vallromanes,2006,2094,1057,1037,462,1447,185
875,431613,Valls,2006,23315,11698,11617,3577,15921,3817
876,259062,"Valls d'Aguilar, les",2006,314,172,142,29,203,82
877,252398,"Valls de Valira, les",2006,744,405,339,65,504,175
878,431628,Vandellòs i l'Hospitalet de l'Infant,2006,5134,2627,2507,726,3618,790
879,259097,"Vansa i Fórnols, la",2006,196,108,88,11,127,58
880,082975,Veciana,2006,167,90,77,23,102,42
881,431634,"Vendrell, el",2006,31953,16140,15813,5300,22545,4108
882,172109,Ventalló,2006,698,375,323,65,474,159
883,252424,Verdú,2006,1027,504,523,111,619,297
884,172116,Verges,2006,1179,588,591,144,757,278
885,431649,Vespella de Gaià,2006,339,185,154,42,251,46
886,082981,Vic,2006,38747,19743,19004,6062,26504,6181
887,172121,Vidrà,2006,168,84,84,24,115,29
888,172137,Vidreres,2006,6676,3501,3175,1088,4630,958
889,252430,Vielha e Mijaran,2006,5239,2776,2463,767,3992,480
890,431652,Vilabella,2006,787,403,384,89,525,173
891,172142,Vilabertran,2006,843,435,408,112,548,183
892,172155,Vilablareix,2006,2213,1107,1106,362,1646,205
893,082994,Vilada,2006,516,261,255,44,332,140
894,172174,Viladamat,2006,421,216,205,48,276,97
895,172168,Viladasens,2006,191,98,93,21,123,47
896,083015,Viladecans,2006,61168,30754,30414,9879,44226,7063
897,083008,Viladecavalls,2006,7036,3545,3491,1421,4961,654
898,172180,Vilademuls,2006,786,409,377,101,507,178
899,172207,Viladrau,2006,999,522,477,141,679,179
900,172214,Vilafant,2006,5013,2489,2524,870,3567,576
901,083054,Vilafranca del Penedès,2006,36687,18375,18312,5642,25643,5402
902,252445,Vilagrassa,2006,467,243,224,58,295,114
903,172235,Vilajuïga,2006,1072,530,542,168,717,187
904,431750,Vilalba dels Arcs,2006,720,380,340,67,434,219
905,083067,Vilalba Sasserra,2006,581,293,288,93,416,72
906,252458,Vilaller,2006,678,388,290,65,490,123
907,172240,Vilallonga de Ter,2006,448,243,205,35,291,122
908,431665,Vilallonga del Camp,2006,1539,765,774,210,1097,232
909,172253,Vilamacolum,2006,280,148,132,39,181,60
910,172266,Vilamalla,2006,1092,581,511,188,787,117
911,172272,Vilamaniscle,2006,182,98,84,37,110,35
912,252477,Vilamòs,2006,173,94,79,23,131,19
913,172288,Vilanant,2006,333,163,170,37,229,67
914,431671,Vilanova d'Escornalbou,2006,466,252,214,52,334,80
915,252483,Vilanova de Bellpuig,2006,1100,568,532,106,677,317
916,252496,Vilanova de l'Aguda,2006,246,123,123,30,132,84
917,252542,Vilanova de la Barca,2006,1122,576,546,130,754,238
918,252509,Vilanova de Meià,2006,432,226,206,30,279,123
919,431687,Vilanova de Prades,2006,149,80,69,11,96,42
920,083036,Vilanova de Sau,2006,323,149,174,35,228,60
921,252516,Vilanova de Segrià,2006,809,427,382,84,576,149
922,083020,Vilanova del Camí,2006,12039,6107,5932,2090,8593,1356
923,089024,Vilanova del Vallès,2006,3774,1959,1815,718,2646,410
924,083073,Vilanova i la Geltrú,2006,62826,31047,31779,9467,43525,9834
925,431690,Vilaplana,2006,584,297,287,55,377,152
926,431704,Vila-rodona,2006,1088,582,506,121,722,245
927,172305,Vila-sacra,2006,485,241,244,53,350,82
928,252521,Vila-sana,2006,611,305,306,82,388,141
929,431711,Vila-seca,2006,17305,8814,8491,2714,12708,1883
930,082140,Vilassar de Dalt,2006,8334,4140,4194,1240,5786,1308
931,082191,Vilassar de Mar,2006,19051,9343,9708,3221,13148,2682
932,172229,Vilaür,2006,139,69,70,17,94,28
933,431726,Vilaverd,2006,438,223,215,53,273,112
934,431732,"Vilella Alta, la",2006,121,68,53,15,75,31
935,431747,"Vilella Baixa, la",2006,198,105,93,27,124,47
936,172333,Vilobí d'Onyar,2006,2718,1468,1250,383,1908,427
937,083041,Vilobí del Penedès,2006,1033,535,498,155,688,190
938,172327,Vilopriu,2006,189,103,86,29,116,44
939,252537,"Vilosell, el",2006,202,99,103,8,130,64
940,431763,Vimbodí i Poblet,2006,1052,595,457,112,645,295
941,252555,Vinaixa,2006,604,307,297,55,397,152
942,431779,Vinebre,2006,483,250,233,36,333,114
943,431785,Vinyols i els Arcs,2006,1553,803,750,233,1079,241
944,083089,Viver i Serrateix,2006,194,98,96,29,125,40
945,430521,Xerta,2006,1278,643,635,153,785,340
946,000000,Catalunya,2006,7134697,3543706,3590991,1020751,4938427,1175519
0,250019,Abella de la Conca,2007,188,102,86,23,125,40
1,080018,Abrera,2007,10840,5648,5192,1801,7976,1063
2,250024,Àger,2007,555,302,253,39,337,179
3,250030,Agramunt,2007,5434,2845,2589,769,3648,1017
4,080023,Aguilar de Segarra,2007,252,131,121,35,160,57
5,170010,Agullana,2007,753,397,356,89,477,187
6,080142,Aiguafreda,2007,2375,1144,1231,351,1544,480
7,430017,Aiguamúrcia,2007,864,460,404,118,599,147
8,170025,Aiguaviva,2007,614,310,304,109,415,90
9,250387,Aitona,2007,2376,1239,1137,266,1545,565
10,250045,"Alamús, els",2007,722,370,352,74,484,164
11,250058,Alàs i Cerc,2007,396,210,186,44,253,99
12,250061,"Albagés, l'",2007,490,260,230,63,292,135
13,170031,Albanyà,2007,137,70,67,24,95,18
14,250077,Albatàrrec,2007,1639,871,768,256,1142,241
15,250083,Albesa,2007,1575,805,770,200,1027,348
16,250096,"Albi, l'",2007,839,428,411,96,543,200
17,430022,Albinyana,2007,2200,1119,1081,349,1483,368
18,430038,"Albiol, l'",2007,377,196,181,84,254,39
19,170046,Albons,2007,625,327,298,87,430,108
20,430043,Alcanar,2007,9969,5137,4832,1316,6830,1823
21,250100,Alcanó,2007,249,122,127,21,151,77
22,250117,Alcarràs,2007,6510,3345,3165,936,4535,1039
23,250122,Alcoletge,2007,2289,1214,1075,339,1627,323
24,430056,Alcover,2007,4731,2437,2294,781,3203,747
25,439044,"Aldea, l'",2007,3927,2083,1844,482,2615,830
26,430069,Aldover,2007,946,461,485,113,595,238
27,430075,"Aleixar, l'",2007,862,441,421,147,545,170
28,080039,Alella,2007,8998,4433,4565,1387,6484,1127
29,430081,Alfara de Carles,2007,389,211,178,33,251,105
30,250138,Alfarràs,2007,3228,1676,1552,458,2096,674
31,250143,Alfés,2007,329,175,154,28,206,95
32,430094,Alforja,2007,1730,902,828,250,1157,323
33,250156,Algerri,2007,477,244,233,31,280,166
34,250169,Alguaire,2007,3055,1590,1465,397,2050,608
35,250175,Alins,2007,257,131,126,19,156,82
36,430108,Alió,2007,368,189,179,30,258,80
37,250194,Almacelles,2007,6131,3216,2915,817,4127,1187
38,250208,Almatret,2007,424,221,203,28,237,159
39,250215,Almenar,2007,3596,1878,1718,461,2368,767
40,430115,Almoster,2007,1286,653,633,263,878,145
41,250220,Alòs de Balaguer,2007,156,91,65,13,87,56
42,170062,Alp,2007,1576,823,753,212,1201,163
43,080044,Alpens,2007,303,167,136,50,193,60
44,250236,Alpicat,2007,5648,2829,2819,973,3988,687
45,250241,Alt Àneu,2007,450,256,194,53,304,93
46,430120,Altafulla,2007,4415,2210,2205,774,3130,511
47,170078,Amer,2007,2266,1132,1134,245,1479,542
48,430136,"Ametlla de Mar, l'",2007,7071,3630,3441,981,4793,1297
49,080057,"Ametlla del Vallès, l'",2007,7632,3833,3799,1543,5260,829
50,439060,"Ampolla, l'",2007,2662,1365,1297,299,1791,572
51,430141,Amposta,2007,19805,10058,9747,2935,13611,3259
52,170084,Anglès,2007,5281,2697,2584,765,3481,1035
53,250273,Anglesola,2007,1307,658,649,154,840,313
54,250292,Arbeca,2007,2431,1255,1176,297,1510,624
55,430167,"Arboç, l'",2007,5063,2735,2328,862,3481,720
56,430154,Arbolí,2007,113,61,52,3,85,25
57,170097,Arbúcies,2007,6271,3340,2931,1007,4261,1003
58,080060,Arenys de Mar,2007,14164,6926,7238,2022,9587,2555
59,080076,Arenys de Munt,2007,7807,3905,3902,1345,5361,1101
60,170101,Argelaguer,2007,423,221,202,73,260,90
61,080082,Argençola,2007,229,135,94,30,156,43
62,430173,"Argentera, l'",2007,143,85,58,10,98,35
63,080095,Argentona,2007,11402,5661,5741,2005,7843,1554
64,170118,"Armentera, l'",2007,783,384,399,89,492,202
65,430189,Arnes,2007,497,260,237,38,279,180
66,250313,Arres,2007,65,44,21,5,50,10
67,250328,Arsèguel,2007,97,49,48,7,69,21
68,080109,Artés,2007,5179,2606,2573,790,3493,896
69,250334,Artesa de Lleida,2007,1452,756,696,210,916,326
70,250349,Artesa de Segre,2007,3737,1950,1787,497,2466,774
71,430192,Ascó,2007,1616,817,799,163,1071,382
72,250365,Aspa,2007,265,138,127,29,147,89
73,250371,"Avellanes i Santa Linya, les",2007,473,266,207,35,297,141
74,080116,Avià,2007,2108,1049,1059,308,1380,420
75,080121,Avinyó,2007,2190,1101,1089,343,1403,444
76,170123,Avinyonet de Puigventós,2007,1361,712,649,292,945,124
77,080137,Avinyonet del Penedès,2007,1588,854,734,233,1075,280
78,080155,Badalona,2007,216201,108323,107878,31001,153222,31978
79,089045,Badia del Vallès,2007,13975,6883,7092,2126,9827,2022
80,080168,Bagà,2007,2248,1120,1128,258,1461,529
81,250390,Baix Pallars,2007,406,226,180,45,258,103
82,250404,Balaguer,2007,15781,7971,7810,2454,10646,2681
83,080174,Balenyà,2007,3581,1799,1782,578,2501,502
84,080180,Balsareny,2007,3410,1715,1695,439,2278,693
85,430206,Banyeres del Penedès,2007,2696,1393,1303,478,1888,330
86,170157,Banyoles,2007,17451,8687,8764,2999,11497,2955
87,250411,Barbens,2007,836,452,384,80,527,229
88,430213,Barberà de la Conca,2007,513,276,237,65,333,115
89,082520,Barberà del Vallès,2007,29208,14575,14633,4653,21226,3329
90,080193,Barcelona,2007,1595110,755370,839740,188051,1076890,330169
91,250426,"Baronia de Rialb, la",2007,285,155,130,34,177,74
92,170160,Bàscara,2007,915,490,425,110,596,209
93,250447,Bassella,2007,255,132,123,30,156,69
94,430228,Batea,2007,2112,1084,1028,244,1329,539
95,250450,Bausen,2007,61,38,23,4,31,26
96,080207,Begues,2007,5898,2943,2955,1281,4098,519
97,170139,Begur,2007,4086,2093,1993,597,2835,654
98,250463,Belianes,2007,580,297,283,77,329,174
99,251706,Bellaguarda,2007,353,184,169,36,191,126
100,170182,Bellcaire d'Empordà,2007,651,308,343,98,411,142
101,250479,Bellcaire d'Urgell,2007,1289,628,661,129,784,376
102,250485,Bell-lloc d'Urgell,2007,2372,1177,1195,352,1510,510
103,250498,Bellmunt d'Urgell,2007,213,104,109,26,128,59
104,430234,Bellmunt del Priorat,2007,336,164,172,32,211,93
105,080214,Bellprat,2007,93,53,40,8,64,21
106,250501,Bellpuig,2007,4576,2371,2205,664,3055,857
107,430249,Bellvei,2007,1840,978,862,308,1251,281
108,250518,Bellver de Cerdanya,2007,2014,1064,950,250,1396,368
109,250523,Bellvís,2007,2428,1243,1185,281,1555,592
110,250539,Benavent de Segrià,2007,1365,721,644,257,946,162
111,430252,Benifallet,2007,808,405,403,84,454,270
112,430265,Benissanet,2007,1249,666,583,143,828,278
113,080229,Berga,2007,16596,8246,8350,2146,10984,3466
114,170195,Besalú,2007,2265,1114,1151,294,1460,511
115,170209,Bescanó,2007,4121,2075,2046,734,2737,650
116,170216,Beuda,2007,153,78,75,14,119,20
117,080235,Bigues i Riells del Fai,2007,7807,4013,3794,1462,5531,814
118,250557,Biosca,2007,228,121,107,21,129,78
119,170221,"Bisbal d'Empordà, la",2007,9593,4819,4774,1498,6485,1610
120,430271,"Bisbal de Falset, la",2007,245,127,118,28,142,75
121,430287,"Bisbal del Penedès, la",2007,3142,1652,1490,470,2184,488
122,172348,Biure,2007,245,124,121,33,164,48
123,430290,Blancafort,2007,415,223,192,49,255,111
124,170237,Blanes,2007,38368,19399,18969,5844,27019,5505
125,170293,Boadella i les Escaules,2007,228,109,119,24,152,52
126,170242,Bolvir,2007,329,177,152,35,240,54
127,430304,Bonastre,2007,584,310,274,93,393,98
128,250576,"Bòrdes, Es",2007,241,127,114,23,182,36
129,170255,Bordils,2007,1625,834,791,268,1092,265
130,250582,"Borges Blanques, les",2007,5734,2906,2828,745,3793,1196
131,430311,"Borges del Camp, les",2007,1965,995,970,295,1322,348
132,170268,Borrassà,2007,613,316,297,58,429,126
133,080240,Borredà,2007,571,293,278,79,365,127
134,250595,Bossòst,2007,1115,584,531,142,811,162
135,430326,Bot,2007,727,372,355,54,424,249
136,430332,Botarell,2007,998,529,469,176,716,106
137,250560,Bovera,2007,364,186,178,16,209,139
138,430347,Bràfim,2007,674,350,324,79,460,135
139,170274,Breda,2007,3707,1882,1825,538,2455,714
140,080253,"Bruc, el",2007,1743,930,813,305,1227,211
141,080266,"Brull, el",2007,227,122,105,34,151,42
142,170280,Brunyola i Sant Martí Sapresa,2007,365,184,181,44,221,100
143,430350,Cabacés,2007,343,182,161,34,209,100
144,250609,Cabanabona,2007,103,49,54,6,50,47
145,170314,Cabanelles,2007,242,138,104,21,166,55
146,170307,Cabanes,2007,916,481,435,154,586,176
147,080272,"Cabanyes, les",2007,842,428,414,176,580,86
148,250616,Cabó,2007,104,59,45,6,62,36
149,430363,Cabra del Camp,2007,1011,537,474,151,690,170
150,080288,Cabrera d'Anoia,2007,1192,628,564,204,853,135
151,080291,Cabrera de Mar,2007,4269,2185,2084,739,2993,537
152,080305,Cabrils,2007,6698,3296,3402,1474,4591,633
153,170329,Cadaqués,2007,2806,1384,1422,439,1962,405
154,080312,Calaf,2007,3435,1809,1626,470,2335,630
155,430379,Calafell,2007,21871,11154,10717,3137,15800,2934
156,080348,Calders,2007,868,443,425,137,569,162
157,080327,Caldes d'Estrac,2007,2672,1294,1378,365,1834,473
158,170335,Caldes de Malavella,2007,6067,3028,3039,1037,4129,901
159,080333,Caldes de Montbui,2007,16159,8108,8051,2585,11175,2399
160,080351,Calella,2007,18034,8986,9048,2572,12560,2902
161,080370,Calldetenes,2007,2252,1160,1092,342,1601,309
162,080386,Callús,2007,1610,784,826,244,1049,317
163,080364,Calonge de Segarra,2007,205,106,99,27,118,60
164,170340,Calonge i Sant Antoni,2007,10009,5100,4909,1473,6980,1556
165,250621,Camarasa,2007,933,486,447,71,587,275
166,439039,Camarles,2007,3479,1796,1683,475,2293,711
167,430385,Cambrils,2007,29112,14508,14604,4827,20810,3475
168,170353,Camós,2007,698,351,347,89,460,149
169,170366,Campdevànol,2007,3519,1783,1736,414,2257,848
170,170372,Campelles,2007,111,58,53,6,83,22
171,080399,Campins,2007,378,192,186,67,264,47
172,170388,Campllong,2007,400,201,199,80,250,70
173,170391,Camprodon,2007,2516,1246,1270,304,1633,579
174,250637,Canejan,2007,104,55,49,6,64,34
175,170405,Canet d'Adri,2007,599,312,287,65,429,105
176,080403,Canet de Mar,2007,13181,6510,6671,1922,9030,2229
177,080410,Canovelles,2007,15704,8301,7403,2507,11338,1859
178,080425,Cànoves i Samalús,2007,2638,1361,1277,455,1820,363
179,170412,Cantallops,2007,295,151,144,27,191,77
180,080431,Canyelles,2007,3783,1963,1820,716,2704,363
181,430398,Capafonts,2007,122,64,58,5,78,39
182,430402,Capçanes,2007,401,197,204,38,262,101
183,080446,Capellades,2007,5386,2663,2723,801,3617,968
184,170427,Capmany,2007,518,270,248,57,338,123
185,080459,Capolat,2007,81,41,40,9,51,21
186,080462,Cardedeu,2007,15775,7832,7943,2806,10990,1979
187,080478,Cardona,2007,5164,2532,2632,586,3320,1258
188,080484,Carme,2007,811,425,386,104,532,175
189,430419,Caseres,2007,307,150,157,32,172,103
190,170448,Cassà de la Selva,2007,8994,4622,4372,1425,6012,1557
191,080497,Casserres,2007,1599,782,817,158,1026,415
192,080575,Castell de l'Areny,2007,76,46,30,11,49,16
193,259046,Castell de Mur,2007,185,95,90,26,103,56
194,250642,Castellar de la Ribera,2007,165,81,84,27,91,47
195,080522,Castellar de n'Hug,2007,221,109,112,22,160,39
196,080500,Castellar del Riu,2007,143,76,67,23,92,28
197,080517,Castellar del Vallès,2007,22007,11017,10990,4010,15362,2635
198,080538,Castellbell i el Vilar,2007,3479,1774,1705,485,2388,606
199,080543,Castellbisbal,2007,11540,5931,5609,2301,8085,1154
200,080556,Castellcir,2007,584,303,281,109,381,94
201,250674,Castelldans,2007,1002,552,450,97,662,243
202,080569,Castelldefels,2007,58955,29532,29423,9913,42936,6106
203,080581,Castellet i la Gornal,2007,2044,1057,987,336,1368,340
204,170464,Castellfollit de la Roca,2007,997,516,481,118,634,245
205,080608,Castellfollit de Riubregós,2007,194,101,93,14,130,50
206,080594,Castellfollit del Boix,2007,418,203,215,68,262,88
207,080615,Castellgalí,2007,1611,850,761,292,1093,226
208,080620,Castellnou de Bages,2007,907,474,433,169,650,88
209,250680,Castellnou de Seana,2007,750,392,358,82,462,206
210,170470,Castelló d'Empúries,2007,10629,5476,5153,1669,7372,1588
211,250693,Castelló de Farfanya,2007,579,303,276,49,370,160
212,080636,Castellolí,2007,468,222,246,76,312,80
213,170486,Castell-Platja d'Aro,2007,9766,4988,4778,1303,7149,1314
214,250707,Castellserà,2007,1118,571,547,116,691,311
215,080641,Castellterçol,2007,2238,1103,1135,320,1442,476
216,430424,Castellvell del Camp,2007,2474,1256,1218,500,1738,236
217,080654,Castellví de la Marca,2007,1596,792,804,248,1034,314
218,080667,Castellví de Rosanes,2007,1576,799,777,304,1086,186
219,430430,"Catllar, el",2007,3751,1949,1802,623,2727,401
220,250714,Cava,2007,55,33,22,1,38,16
221,171899,"Cellera de Ter, la",2007,2124,1074,1050,318,1383,423
222,170499,Celrà,2007,3947,1952,1995,787,2735,425
223,080673,Centelles,2007,6909,3381,3528,1000,4689,1220
224,082687,Cercs,2007,1331,678,653,131,846,354
225,082665,Cerdanyola del Vallès,2007,57758,28564,29194,8756,41967,7035
226,080689,Cervelló,2007,7944,4051,3893,1246,5812,886
227,250729,Cervera,2007,9093,4684,4409,1509,6144,1440
228,250735,Cervià de les Garrigues,2007,865,452,413,86,525,254
229,170502,Cervià de Ter,2007,850,422,428,148,532,170
230,170519,Cistella,2007,242,127,115,24,160,58
231,250740,Ciutadilla,2007,227,129,98,26,139,62
232,250753,Clariana de Cardener,2007,147,79,68,23,108,16
233,250766,"Cogul, el",2007,214,119,95,14,135,65
234,170545,Colera,2007,592,302,290,54,393,145
235,250772,Coll de Nargó,2007,626,333,293,60,407,159
236,080692,Collbató,2007,3780,1965,1815,792,2650,338
237,430458,Colldejou,2007,187,103,84,12,142,33
238,080706,Collsuspina,2007,323,173,150,55,223,45
239,170558,Colomers,2007,203,102,101,16,124,63
240,251636,"Coma i la Pedra, la",2007,252,150,102,21,179,52
241,251615,Conca de Dalt,2007,434,222,212,36,264,134
242,430461,Conesa,2007,137,71,66,14,83,40
243,430477,Constantí,2007,6183,3349,2834,972,4408,803
244,080713,Copons,2007,307,148,159,49,203,55
245,430483,Corbera d'Ebre,2007,1161,621,540,139,746,276
246,080728,Corbera de Llobregat,2007,13133,6687,6446,2374,9380,1379
247,250788,Corbins,2007,1340,717,623,176,924,240
248,170577,Corçà,2007,1255,622,633,151,876,228
249,080734,Cornellà de Llobregat,2007,84477,42028,42449,11998,58120,14359
250,170561,Cornellà del Terri,2007,2106,1056,1050,299,1410,397
251,430496,Cornudella de Montsant,2007,1006,526,480,109,648,249
252,430509,Creixell,2007,2952,1525,1427,397,2027,528
253,170583,Crespià,2007,247,130,117,32,157,58
254,179011,"Cruïlles, Monells i Sant Sadurní de l'Heura",2007,1291,645,646,187,898,206
255,080749,Cubelles,2007,12773,6980,5793,2033,9187,1553
256,250791,Cubells,2007,385,202,183,47,213,125
257,430516,Cunit,2007,11102,5721,5381,1727,7765,1610
258,170600,Darnius,2007,537,270,267,54,345,138
259,170617,Das,2007,193,107,86,29,131,33
260,439018,Deltebre,2007,11063,5611,5452,1400,7470,2193
261,080752,Dosrius,2007,4658,2349,2309,834,3389,435
262,430537,Duesaigües,2007,234,137,97,23,147,64
263,170622,"Escala, l'",2007,9330,4855,4475,1221,6448,1661
264,080765,Esparreguera,2007,21260,10902,10358,3597,15072,2591
265,170638,Espinelves,2007,183,94,89,20,116,47
266,250812,"Espluga Calba, l'",2007,438,233,205,32,284,122
267,430542,"Espluga de Francolí, l'",2007,3891,1937,1954,514,2517,860
268,080771,Esplugues de Llobregat,2007,46286,22690,23596,6087,32668,7531
269,170643,Espolla,2007,404,196,208,42,258,104
270,170656,Esponellà,2007,441,213,228,65,289,87
271,250827,Espot,2007,359,196,163,44,257,58
272,080787,"Espunyola, l'",2007,260,129,131,34,161,65
273,082541,"Esquirol, l'",2007,2254,1135,1119,345,1440,469
274,250886,Estamariu,2007,122,64,58,12,69,41
275,080790,"Estany, l'",2007,379,180,199,35,238,106
276,250851,Estaràs,2007,179,101,78,19,114,46
277,250864,Esterri d'Àneu,2007,815,417,398,103,561,151
278,250870,Esterri de Cardós,2007,71,31,40,7,48,16
279,430555,Falset,2007,2742,1377,1365,390,1813,539
280,170059,"Far d'Empordà, el",2007,510,260,250,95,330,85
281,250899,Farrera,2007,112,66,46,13,79,20
282,430568,"Fatarella, la",2007,1170,587,583,109,715,346
283,430574,"Febró, la",2007,56,35,21,2,44,10
284,081347,Figaró-Montmany,2007,1009,521,488,159,639,211
285,080804,Fígols,2007,49,28,21,3,27,19
286,259084,Fígols i Alinyà,2007,265,146,119,16,155,94
287,430580,"Figuera, la",2007,164,89,75,13,111,40
288,170669,Figueres,2007,41115,20389,20726,6512,28324,6279
289,430593,Figuerola del Camp,2007,330,153,177,61,206,63
290,170675,Flaçà,2007,1018,504,514,137,673,208
291,430607,Flix,2007,4006,2051,1955,407,2693,906
292,250925,"Floresta, la",2007,191,102,89,25,107,59
293,080826,Fogars de la Selva,2007,1437,743,694,262,996,179
294,080811,Fogars de Montclús,2007,448,241,207,76,294,78
295,170681,Foixà,2007,324,168,156,43,199,82
296,080832,Folgueroles,2007,2058,1038,1020,406,1367,285
297,250931,Fondarella,2007,788,400,388,106,566,116
298,080847,Fonollosa,2007,1279,659,620,198,901,180
299,170694,Fontanals de Cerdanya,2007,446,226,220,42,327,77
300,170708,Fontanilles,2007,163,96,67,19,107,37
301,170715,Fontcoberta,2007,1212,590,622,187,879,146
302,080850,Font-rubí,2007,1430,751,679,217,903,310
303,250946,Foradada,2007,192,115,77,17,119,56
304,179026,Forallac,2007,1736,857,879,220,1212,304
305,430614,Forès,2007,55,32,23,0,28,27
306,170736,Fornells de la Selva,2007,1971,952,1019,384,1361,226
307,170741,Fortià,2007,605,313,292,86,395,124
308,080863,"Franqueses del Vallès, les",2007,16325,8410,7915,2629,11840,1856
309,430629,Freginals,2007,451,238,213,43,286,122
310,250962,"Fuliola, la",2007,1241,622,619,140,789,312
311,250978,Fulleda,2007,115,61,54,8,73,34
312,080902,Gaià,2007,158,83,75,26,105,27
313,430635,"Galera, la",2007,852,434,418,103,546,203
314,080879,Gallifa,2007,224,116,108,36,158,30
315,430640,Gandesa,2007,3040,1560,1480,395,1984,661
316,430653,Garcia,2007,553,286,267,46,341,166
317,430666,"Garidells, els",2007,198,102,96,24,134,40
318,080885,"Garriga, la",2007,14183,6863,7320,2435,9755,1993
319,170754,Garrigàs,2007,355,202,153,43,222,90
320,170767,Garrigoles,2007,166,90,76,15,109,42
321,170773,Garriguella,2007,795,410,385,109,527,159
322,080898,Gavà,2007,44678,22243,22435,7023,31607,6048
323,250984,Gavet de la Conca,2007,301,144,157,24,166,111
324,080919,Gelida,2007,6151,3131,3020,1029,4244,878
325,170789,Ger,2007,444,239,205,63,312,69
326,259123,Gimenells i el Pla de la Font,2007,1143,594,549,140,744,259
327,430672,Ginestar,2007,1052,558,494,123,686,243
328,170792,Girona,2007,92186,45029,47157,14726,65003,12457
329,080924,Gironella,2007,4844,2343,2501,556,3097,1191
330,080930,Gisclareny,2007,34,18,16,0,31,3
331,430688,Godall,2007,817,420,397,92,484,241
332,250997,Golmés,2007,1610,827,783,258,1074,278
333,170806,Gombrèn,2007,229,113,116,26,153,50
334,251001,Gósol,2007,223,120,103,12,154,57
335,080945,"Granada, la",2007,1866,946,920,302,1292,272
336,251018,"Granadella, la",2007,748,387,361,68,445,235
337,080958,Granera,2007,76,50,26,2,58,16
338,251023,"Granja d'Escarp, la",2007,1043,550,493,105,689,249
339,080961,Granollers,2007,58854,29374,29480,8848,41654,8352
340,251039,Granyanella,2007,174,90,84,17,116,41
341,251057,Granyena de les Garrigues,2007,163,88,75,10,103,50
342,251044,Granyena de Segarra,2007,149,77,72,4,86,59
343,430691,Gratallops,2007,253,137,116,30,161,62
344,080977,Gualba,2007,1065,551,514,166,760,139
345,170813,Gualta,2007,349,198,151,51,234,64
346,080996,Guardiola de Berguedà,2007,948,497,451,117,600,231
347,430705,"Guiamets, els",2007,332,172,160,30,207,95
348,170828,Guils de Cerdanya,2007,452,241,211,53,343,56
349,251095,Guimerà,2007,335,173,162,12,188,135
350,259031,"Guingueta d'Àneu, la",2007,370,207,163,42,251,77
351,251109,Guissona,2007,5253,2803,2450,955,3731,567
352,251116,Guixers,2007,150,87,63,9,100,41
353,081000,Gurb,2007,2344,1191,1153,454,1581,309
354,430712,Horta de Sant Joan,2007,1253,675,578,140,776,337
355,081017,"Hospitalet de Llobregat, l'",2007,251848,123694,128154,30543,175741,45564
356,081629,"Hostalets de Pierola, els",2007,2219,1164,1055,382,1567,270
357,170834,Hostalric,2007,3773,1936,1837,598,2621,554
358,081022,Igualada,2007,36923,18264,18659,5586,24960,6377
359,251155,Isona i Conca Dellà,2007,1153,619,534,122,686,345
360,170849,Isòvol,2007,278,161,117,22,204,52
361,251137,Ivars d'Urgell,2007,1786,939,847,207,1144,435
362,251121,Ivars de Noguera,2007,340,184,156,25,219,96
363,251142,Ivorra,2007,147,72,75,13,89,45
364,170852,Jafre,2007,403,228,175,35,270,98
365,170865,"Jonquera, la",2007,3075,1590,1485,418,2272,385
366,081038,Jorba,2007,742,362,380,141,463,138
367,259101,Josa i Tuixén,2007,172,94,78,12,120,40
368,170871,Juià,2007,297,152,145,48,180,69
369,251180,Juncosa,2007,520,275,245,52,308,160
370,251193,Juneda,2007,3222,1674,1548,408,2118,696
371,251214,Les,2007,944,473,471,126,694,124
372,251229,Linyola,2007,2655,1362,1293,386,1731,538
373,081043,"Llacuna, la",2007,878,474,404,98,585,195
374,170887,Lladó,2007,605,313,292,83,396,126
375,251235,Lladorre,2007,225,111,114,28,150,47
376,251240,Lladurs,2007,200,109,91,19,126,55
377,081056,"Llagosta, la",2007,13517,6825,6692,2009,9669,1839
378,170890,Llagostera,2007,7314,3798,3516,1122,4945,1247
379,170904,Llambilles,2007,641,336,305,104,438,99
380,170911,Llanars,2007,569,298,271,63,392,114
381,170926,Llançà,2007,4862,2417,2445,652,3296,914
382,251253,Llardecans,2007,554,288,266,53,324,177
383,251266,Llavorsí,2007,330,168,162,35,219,76
384,251207,Lleida,2007,127314,63053,64261,18806,88383,20125
385,170932,Llers,2007,1144,577,567,173,763,208
386,251272,Lles de Cerdanya,2007,220,129,91,15,142,63
387,081075,Lliçà d'Amunt,2007,13491,6893,6598,2586,9347,1558
388,081081,Lliçà de Vall,2007,6088,3136,2952,1052,4322,714
389,251288,Llimiana,2007,164,89,75,12,104,48
390,081069,Llinars del Vallès,2007,8581,4295,4286,1399,5991,1191
391,170947,Llívia,2007,1388,755,633,161,1038,189
392,430727,"Lloar, el",2007,113,64,49,11,67,35
393,251291,Llobera,2007,221,117,104,22,139,60
394,430733,Llorac,2007,113,62,51,10,71,32
395,430748,Llorenç del Penedès,2007,2085,1037,1048,369,1399,317
396,170950,Lloret de Mar,2007,34997,18501,16496,5212,26379,3406
397,170963,"Llosses, les",2007,238,130,108,20,170,48
398,081094,Lluçà,2007,252,131,121,40,164,48
399,171024,Maçanet de Cabrenys,2007,722,380,342,60,450,212
400,171030,Maçanet de la Selva,2007,6254,3225,3029,1009,4425,820
401,170979,Madremanya,2007,219,102,117,29,141,49
402,170985,Maià de Montcal,2007,378,194,184,48,249,81
403,251333,Maials,2007,966,492,474,101,570,295
404,251305,Maldà,2007,277,151,126,29,156,92
405,081108,Malgrat de Mar,2007,17822,9008,8814,2593,12314,2915
406,081115,Malla,2007,267,124,143,30,195,42
407,081120,Manlleu,2007,20091,10199,9892,3413,13466,3212
408,081136,Manresa,2007,73140,35923,37217,10391,48624,14125
409,430764,Marçà,2007,662,335,327,97,392,173
410,430751,Margalef,2007,122,70,52,10,71,41
411,082423,Marganell,2007,292,136,156,41,188,63
412,081141,Martorell,2007,25844,13313,12531,4367,17912,3565
413,081154,Martorelles,2007,4893,2497,2396,666,3429,798
414,430770,Mas de Barberans,2007,667,335,332,64,415,188
415,171002,Masarac,2007,269,140,129,32,170,67
416,430786,Masdenverge,2007,1098,569,529,144,711,243
417,081167,"Masies de Roda, les",2007,767,381,386,99,536,132
418,081173,"Masies de Voltregà, les",2007,3152,1554,1598,537,2142,473
419,430799,Masllorenç,2007,503,256,247,64,317,122
420,081189,"Masnou, el",2007,21935,10564,11371,3296,15261,3378
421,430803,"Masó, la",2007,287,144,143,28,194,65
422,430810,Maspujols,2007,542,279,263,94,321,127
423,081192,Masquefa,2007,7747,3903,3844,1506,5388,853
424,430825,"Masroig, el",2007,525,261,264,56,321,148
425,251312,Massalcoreig,2007,625,332,293,70,389,166
426,171019,Massanes,2007,693,369,324,92,495,106
427,251327,Massoteres,2007,221,122,99,39,137,45
428,081206,Matadepera,2007,8266,4196,4070,1756,5581,929
429,081213,Mataró,2007,119035,59796,59239,17551,84019,17465
430,081228,Mediona,2007,2251,1177,1074,327,1478,446
431,251348,Menàrguens,2007,835,433,402,90,499,246
432,170998,Meranges,2007,87,55,32,6,57,24
433,171058,Mieres,2007,320,172,148,45,205,70
434,430831,"Milà, el",2007,177,84,93,24,111,42
435,251351,Miralcamp,2007,1368,676,692,180,914,274
436,430846,Miravet,2007,795,426,369,83,525,187
437,081385,Moià,2007,5486,2794,2692,960,3674,852
438,430859,"Molar, el",2007,290,160,130,28,173,89
439,081234,Molins de Rei,2007,23544,11575,11969,3684,16493,3367
440,251370,Mollerussa,2007,13086,6786,6300,2230,9186,1670
441,171061,Mollet de Peralada,2007,174,87,87,18,106,50
442,081249,Mollet del Vallès,2007,51365,25954,25411,8323,37045,5997
443,171077,Molló,2007,340,168,172,25,226,89
444,251364,"Molsosa, la",2007,128,64,64,11,85,32
445,081287,Monistrol de Calders,2007,702,351,351,103,471,128
446,081271,Monistrol de Montserrat,2007,2903,1516,1387,346,2031,526
447,171096,Montagut i Oix,2007,940,492,448,134,603,203
448,430862,Montblanc,2007,6818,3455,3363,945,4675,1198
449,430884,Montbrió del Camp,2007,1917,978,939,288,1274,355
450,081252,Montcada i Reixac,2007,32111,16017,16094,5199,22422,4490
451,081304,Montclar,2007,119,55,64,23,66,30
452,251399,Montellà i Martinet,2007,597,316,281,68,388,141
453,081311,Montesquiu,2007,861,436,425,98,568,195
454,251403,Montferrer i Castellbò,2007,983,536,447,124,711,148
455,430897,Montferri,2007,323,175,148,59,200,64
456,251386,Montgai,2007,740,370,370,75,433,232
457,081265,Montgat,2007,9778,4784,4994,1456,7068,1254
458,081326,Montmajor,2007,478,251,227,57,307,114
459,081332,Montmaneu,2007,199,106,93,18,130,51
460,430901,"Montmell, el",2007,1341,731,610,210,946,185
461,081350,Montmeló,2007,8873,4410,4463,1414,6234,1225
462,251425,Montoliu de Lleida,2007,510,264,246,52,341,117
463,251410,Montoliu de Segarra,2007,185,108,77,9,115,61
464,251431,Montornès de Segarra,2007,108,50,58,7,67,34
465,081363,Montornès del Vallès,2007,14723,7593,7130,2434,10543,1746
466,430918,Mont-ral,2007,182,101,81,17,146,19
467,171100,Mont-ras,2007,1859,967,892,289,1324,246
468,430923,Mont-roig del Camp,2007,10292,5395,4897,1450,7337,1505
469,081379,Montseny,2007,299,162,137,26,206,67
470,430939,Móra d'Ebre,2007,5232,2585,2647,816,3416,1000
471,430944,Móra la Nova,2007,3189,1630,1559,459,2157,573
472,430957,"Morell, el",2007,2855,1489,1366,473,2002,380
473,430960,"Morera de Montsant, la",2007,157,89,68,19,104,34
474,081290,Muntanyola,2007,513,266,247,98,369,46
475,081398,Mura,2007,232,127,105,26,165,41
476,251459,Nalec,2007,95,48,47,6,60,29
477,250254,Naut Aran,2007,1716,902,814,238,1287,191
478,081402,Navarcles,2007,5732,2835,2897,806,3877,1049
479,081419,Navàs,2007,5959,2955,3004,845,3894,1220
480,171117,Navata,2007,1023,513,510,180,655,188
481,251462,Navès,2007,274,134,140,37,169,68
482,081424,"Nou de Berguedà, la",2007,149,75,74,25,85,39
483,430976,"Nou de Gaià, la",2007,461,233,228,73,299,89
484,430982,Nulles,2007,414,209,205,46,281,87
485,251484,Odèn,2007,285,167,118,16,188,81
486,081430,Òdena,2007,3161,1604,1557,536,2148,477
487,171122,Ogassa,2007,274,160,114,31,187,56
488,081458,Olèrdola,2007,3280,1717,1563,606,2266,408
489,081461,Olesa de Bonesvalls,2007,1556,817,739,232,1134,190
490,081477,Olesa de Montserrat,2007,22257,11274,10983,3857,15351,3049
491,251497,Oliana,2007,1938,978,960,214,1275,449
492,251500,Oliola,2007,263,147,116,28,179,56
493,251517,Olius,2007,752,383,369,133,505,114
494,081483,Olivella,2007,2842,1515,1327,555,2064,223
495,081496,Olost,2007,1193,597,596,151,749,293
496,171143,Olot,2007,32337,16254,16083,4563,21340,6434
497,251522,"Oluges, les",2007,177,96,81,8,113,56
498,081445,Olvan,2007,893,442,451,98,561,234
499,251538,"Omellons, els",2007,246,129,117,20,157,69
500,251543,"Omells de na Gaia, els",2007,147,83,64,13,91,43
501,171156,Ordis,2007,366,192,174,61,244,61
502,251556,Organyà,2007,959,480,479,93,598,268
503,081509,Orís,2007,286,142,144,38,200,48
504,081516,Oristà,2007,586,289,297,46,391,149
505,081521,Orpí,2007,183,91,92,26,122,35
506,081537,Òrrius,2007,487,255,232,87,318,82
507,251569,Os de Balaguer,2007,958,510,448,136,594,228
508,171169,Osor,2007,372,189,183,28,222,122
509,251575,Ossó de Sió,2007,235,119,116,28,146,61
510,081542,Pacs del Penedès,2007,831,420,411,129,592,110
511,081555,Palafolls,2007,8061,4049,4012,1503,5719,839
512,171175,Palafrugell,2007,21412,10938,10474,3257,14761,3394
513,171181,Palamós,2007,17400,8616,8784,2635,11889,2876
514,251581,"Palau d'Anglesola, el",2007,1947,988,959,283,1280,384
515,171194,Palau de Santa Eulàlia,2007,95,52,43,6,70,19
516,171215,Palau-sator,2007,289,154,135,26,193,70
517,171208,Palau-saverdera,2007,1300,679,621,154,857,289
518,081568,Palau-solità i Plegamans,2007,13594,6885,6709,2463,9678,1453
519,431009,"Pallaresos, els",2007,3538,1815,1723,802,2505,231
520,081574,Pallejà,2007,10819,5443,5376,1985,7665,1169
521,430995,"Palma d'Ebre, la",2007,421,200,221,41,244,136
522,089058,"Palma de Cervelló, la",2007,3009,1506,1503,501,2190,318
523,171236,Palol de Revardit,2007,459,234,225,81,295,83
524,171241,Pals,2007,2540,1289,1251,291,1676,573
525,081580,"Papiol, el",2007,3781,1913,1868,588,2661,532
526,171254,Pardines,2007,164,89,75,22,95,47
527,081593,Parets del Vallès,2007,16720,8558,8162,2858,11900,1962
528,171267,Parlavà,2007,380,197,183,34,261,85
529,431016,Passanant i Belltall,2007,194,104,90,8,117,69
530,171289,Pau,2007,568,295,273,73,385,110
531,431021,Paüls,2007,607,302,305,58,379,170
532,171292,Pedret i Marzà,2007,172,89,83,24,117,31
533,251641,Penelles,2007,527,302,225,56,318,153
534,171306,"Pera, la",2007,426,215,211,57,271,98
535,081607,Perafita,2007,394,200,194,47,246,101
536,431037,Perafort,2007,996,525,471,157,723,116
537,171328,Peralada,2007,1693,860,833,256,1131,306
538,251654,Peramola,2007,370,200,170,36,225,109
539,431042,"Perelló, el",2007,2895,1557,1338,327,1912,656
540,081614,Piera,2007,13652,7015,6637,2436,9211,2005
541,431055,"Piles, les",2007,201,115,86,20,145,36
542,081635,Pineda de Mar,2007,25568,13042,12526,3750,18056,3762
543,431068,"Pinell de Brai, el",2007,1126,576,550,138,688,300
544,251667,Pinell de Solsonès,2007,213,115,98,28,135,50
545,251673,Pinós,2007,323,178,145,38,210,75
546,431074,Pira,2007,488,241,247,91,305,92
547,431080,"Pla de Santa Maria, el",2007,2045,1076,969,297,1376,372
548,081640,"Pla del Penedès, el",2007,891,451,440,115,565,211
549,171334,"Planes d'Hostoles, les",2007,1809,918,891,216,1115,478
550,171349,Planoles,2007,272,148,124,22,179,71
551,259118,"Plans de Sió, els",2007,602,316,286,62,351,189
552,251689,"Poal, el",2007,647,345,302,69,411,167
553,251692,"Pobla de Cérvoles, la",2007,251,136,115,34,151,66
554,081653,"Pobla de Claramunt, la",2007,2193,1151,1042,365,1481,347
555,081666,"Pobla de Lillet, la",2007,1322,646,676,95,834,393
556,431093,"Pobla de Mafumet, la",2007,1734,863,871,309,1251,174
557,431107,"Pobla de Massaluca, la",2007,396,208,188,25,239,132
558,431114,"Pobla de Montornès, la",2007,2568,1364,1204,393,1802,373
559,251713,"Pobla de Segur, la",2007,3089,1575,1514,349,1925,815
560,431129,Poboleda,2007,354,197,157,27,231,96
561,081672,Polinyà,2007,7105,3632,3473,1286,5303,516
562,431135,"Pont d'Armentera, el",2007,604,305,299,67,380,157
563,250306,"Pont de Bar, el",2007,191,110,81,22,118,51
564,171352,Pont de Molins,2007,440,233,207,47,318,75
565,251734,"Pont de Suert, el",2007,2418,1255,1163,281,1659,478
566,081825,"Pont de Vilomara i Rocafort, el",2007,3521,1816,1705,597,2443,481
567,431418,Pontils,2007,146,81,65,8,98,40
568,081688,Pontons,2007,556,298,258,72,387,97
569,171365,Pontós,2007,201,111,90,19,120,62
570,251728,Ponts,2007,2682,1357,1325,361,1759,562
571,171371,Porqueres,2007,4208,2096,2112,718,2899,591
572,431140,Porrera,2007,477,261,216,52,303,122
573,171404,"Port de la Selva, el",2007,947,483,464,103,643,201
574,171387,Portbou,2007,1307,654,653,93,821,393
575,251749,"Portella, la",2007,790,445,345,68,593,129
576,431153,Pradell de la Teixeta,2007,169,86,83,13,112,44
577,431166,Prades,2007,649,342,307,69,422,158
578,431172,Prat de Comte,2007,193,99,94,19,108,66
579,081691,"Prat de Llobregat, el",2007,62663,31284,31379,8990,44853,8820
580,431188,Pratdip,2007,760,410,350,68,476,216
581,081712,Prats de Lluçanès,2007,2709,1353,1356,374,1741,594
582,081705,"Prats de Rei, els",2007,537,274,263,43,366,128
583,251752,Prats i Sansor,2007,213,122,91,28,155,30
584,251765,Preixana,2007,411,209,202,41,231,139
585,251771,Preixens,2007,523,264,259,60,294,169
586,082303,Premià de Dalt,2007,9788,4853,4935,1640,6894,1254
587,081727,Premià de Mar,2007,27590,13721,13869,4198,19436,3956
588,171390,"Preses, les",2007,1686,831,855,269,1144,273
589,251790,Prullans,2007,246,122,124,32,155,59
590,171411,Puigcerdà,2007,8949,4625,4324,1496,6238,1215
591,081748,Puigdàlber,2007,449,219,230,69,315,65
592,251804,Puiggròs,2007,299,158,141,48,181,70
593,431191,Puigpelat,2007,891,474,417,161,623,107
594,081751,Puig-reig,2007,4238,2085,2153,471,2678,1089
595,251811,Puigverd d'Agramunt,2007,278,154,124,35,177,66
596,251826,Puigverd de Lleida,2007,1317,669,648,206,855,256
597,081764,Pujalt,2007,196,97,99,21,128,47
598,081770,"Quar, la",2007,61,36,25,2,44,15
599,171426,Quart,2007,2618,1352,1266,393,1906,319
600,170433,Queralbs,2007,197,112,85,25,116,56
601,431205,Querol,2007,533,281,252,64,397,72
602,171432,Rabós,2007,182,90,92,19,126,37
603,081786,Rajadell,2007,470,256,214,61,320,89
604,431212,Rasquera,2007,934,473,461,100,580,254
605,171447,Regencós,2007,326,185,141,43,211,72
606,081799,Rellinars,2007,658,334,324,97,453,108
607,431227,Renau,2007,88,42,46,10,65,13
608,431233,Reus,2007,104835,52332,52503,16830,73007,14998
609,251832,Rialp,2007,662,346,316,84,491,87
610,431248,"Riba, la",2007,710,384,326,81,462,167
611,431251,Riba-roja d'Ebre,2007,1332,701,631,114,859,359
612,259059,Ribera d'Ondara,2007,470,243,227,47,293,130
613,251850,Ribera d'Urgellet,2007,946,505,441,115,626,205
614,171450,Ribes de Freser,2007,2001,976,1025,189,1252,560
615,171463,Riells i Viabrea,2007,3465,1797,1668,673,2481,311
616,431264,"Riera de Gaià, la",2007,1453,742,711,245,994,214
617,251863,Riner,2007,287,144,143,35,184,68
618,171479,Ripoll,2007,10867,5390,5477,1289,7203,2375
619,081803,Ripollet,2007,35661,18210,17451,5832,25535,4294
620,259139,Riu de Cerdanya,2007,112,59,53,12,86,14
621,171485,Riudarenes,2007,1853,975,878,274,1277,302
622,171498,Riudaura,2007,429,217,212,47,305,77
623,431270,Riudecanyes,2007,973,502,471,155,631,187
624,431286,Riudecols,2007,1194,633,561,155,819,220
625,171501,Riudellots de la Selva,2007,1877,967,910,281,1296,300
626,431299,Riudoms,2007,6149,3129,3020,1028,4066,1055
627,171518,Riumors,2007,189,103,86,20,118,51
628,081810,"Roca del Vallès, la",2007,9656,4859,4797,1666,6866,1124
629,431303,Rocafort de Queralt,2007,271,144,127,25,167,79
630,431310,Roda de Berà,2007,5586,2962,2624,817,3964,805
631,081831,Roda de Ter,2007,5671,2765,2906,861,3784,1026
632,431325,Rodonyà,2007,504,269,235,86,314,104
633,431331,Roquetes,2007,7689,4010,3679,1173,5224,1292
634,171523,Roses,2007,18139,9238,8901,3031,12610,2498
635,251898,Rosselló,2007,2611,1329,1282,452,1781,378
636,431346,"Rourell, el",2007,362,183,179,62,225,75
637,081846,Rubí,2007,70494,35545,34949,11357,50745,8392
638,081859,Rubió,2007,161,85,76,22,103,36
639,171539,Rupià,2007,223,115,108,28,141,54
640,089019,Rupit i Pruit,2007,332,164,168,27,229,76
641,081878,Sabadell,2007,201712,98781,102931,30011,138304,33397
642,081884,Sagàs,2007,135,69,66,24,81,30
643,251902,Salàs de Pallars,2007,335,177,158,13,206,116
644,081901,Saldes,2007,336,188,148,28,247,61
645,171544,Sales de Llierca,2007,133,70,63,26,100,7
646,081918,Sallent,2007,7083,3414,3669,879,4545,1659
647,431359,Salomó,2007,445,236,209,63,272,110
648,439057,Salou,2007,23398,12643,10755,3334,18043,2021
649,171557,Salt,2007,27673,14648,13025,4785,19575,3313
650,251919,Sanaüja,2007,454,235,219,60,257,137
651,081944,Sant Adrià de Besòs,2007,32734,16101,16633,5297,22117,5320
652,081957,Sant Agustí de Lluçanès,2007,101,52,49,11,67,23
653,081960,Sant Andreu de la Barca,2007,25743,13220,12523,4612,18745,2386
654,081976,Sant Andreu de Llavaneres,2007,9745,4968,4777,1851,6647,1247
655,171576,Sant Andreu Salou,2007,161,75,86,32,89,40
656,171833,Sant Aniol de Finestres,2007,306,164,142,44,205,57
657,081982,Sant Antoni de Vilamajor,2007,5091,2546,2545,923,3526,642
658,081995,Sant Bartomeu del Grau,2007,975,508,467,154,672,149
659,082009,Sant Boi de Llobregat,2007,80727,40091,40636,11831,57125,11771
660,082016,Sant Boi de Lluçanès,2007,572,290,282,56,364,152
661,431362,Sant Carles de la Ràpita,2007,14262,7110,7152,2048,9611,2603
662,082037,Sant Cebrià de Vallalta,2007,3075,1609,1466,505,2279,291
663,082021,Sant Celoni,2007,15992,8005,7987,2553,10944,2495
664,082042,Sant Climent de Llobregat,2007,3631,1840,1791,665,2553,413
665,171582,Sant Climent Sescebes,2007,503,268,235,72,309,122
666,082055,Sant Cugat del Vallès,2007,74345,36373,37972,15705,51154,7486
667,082068,Sant Cugat Sesgarrigues,2007,927,486,441,163,602,162
668,251961,Sant Esteve de la Sarga,2007,151,96,55,7,98,46
669,082074,Sant Esteve de Palautordera,2007,2245,1094,1151,494,1518,233
670,082080,Sant Esteve Sesrovires,2007,6704,3416,3288,1202,4769,733
671,171595,Sant Feliu de Buixalleu,2007,793,418,375,109,535,149
672,082107,Sant Feliu de Codines,2007,5495,2789,2706,905,3708,882
673,171609,Sant Feliu de Guíxols,2007,21155,10526,10629,3163,14472,3520
674,082114,Sant Feliu de Llobregat,2007,42273,20693,21580,6572,30061,5640
675,171616,Sant Feliu de Pallerols,2007,1335,662,673,190,871,274
676,082129,Sant Feliu Sasserra,2007,612,309,303,71,401,140
677,171621,Sant Ferriol,2007,205,114,91,34,132,39
678,082093,Sant Fost de Campsentelles,2007,7656,3880,3776,1203,5427,1026
679,082135,Sant Fruitós de Bages,2007,7448,3826,3622,1265,5240,943
680,171637,Sant Gregori,2007,3006,1528,1478,531,2076,399
681,251924,Sant Guim de Freixenet,2007,1060,527,533,132,683,245
682,251977,Sant Guim de la Plana,2007,185,99,86,23,111,51
683,171642,Sant Hilari Sacalm,2007,5520,2845,2675,715,3792,1013
684,082153,Sant Hipòlit de Voltregà,2007,3379,1692,1687,522,2182,675
685,081939,Sant Iscle de Vallalta,2007,1193,618,575,240,779,174
686,439023,Sant Jaume d'Enveja,2007,3434,1761,1673,444,2233,757
687,082166,Sant Jaume de Frontanyà,2007,30,14,16,3,22,5
688,171655,Sant Jaume de Llierca,2007,794,403,391,78,491,225
689,431378,Sant Jaume dels Domenys,2007,2136,1118,1018,335,1438,363
690,171674,Sant Joan de les Abadesses,2007,3586,1810,1776,398,2307,881
691,171680,Sant Joan de Mollet,2007,513,256,257,80,332,101
692,082188,Sant Joan de Vilatorrada,2007,10474,5312,5162,1644,7243,1587
693,082172,Sant Joan Despí,2007,31671,15640,16031,5385,22413,3873
694,171851,Sant Joan les Fonts,2007,2697,1372,1325,283,1826,588
695,171668,Sant Jordi Desvalls,2007,622,313,309,76,399,147
696,089030,Sant Julià de Cerdanyola,2007,255,136,119,37,155,63
697,171693,Sant Julià de Ramis,2007,2866,1467,1399,485,2025,356
698,082205,Sant Julià de Vilatorta,2007,2887,1412,1475,527,1966,394
699,179032,Sant Julià del Llor i Bonmatí,2007,1194,607,587,165,839,190
700,082212,Sant Just Desvern,2007,15391,7294,8097,2528,10539,2324
701,082227,Sant Llorenç d'Hortons,2007,2219,1136,1083,388,1505,326
702,171714,Sant Llorenç de la Muga,2007,215,115,100,23,144,48
703,251930,Sant Llorenç de Morunys,2007,1004,518,486,107,656,241
704,082233,Sant Llorenç Savall,2007,2313,1174,1139,354,1487,472
705,082251,Sant Martí d'Albars,2007,113,57,56,11,74,28
706,082248,Sant Martí de Centelles,2007,941,489,452,164,640,137
707,171729,Sant Martí de Llémena,2007,527,272,255,94,347,86
708,259025,Sant Martí de Riucorb,2007,703,372,331,57,432,214
709,082264,Sant Martí de Tous,2007,1104,563,541,199,678,227
710,082270,Sant Martí Sarroca,2007,2997,1534,1463,463,1977,557
711,082286,Sant Martí Sesgueioles,2007,385,197,188,63,241,81
712,171735,Sant Martí Vell,2007,232,117,115,45,146,41
713,082299,Sant Mateu de Bages,2007,669,344,325,63,400,206
714,171740,Sant Miquel de Campmajor,2007,218,119,99,27,148,43
715,171753,Sant Miquel de Fluvià,2007,710,360,350,106,477,127
716,171766,Sant Mori,2007,163,78,85,14,126,23
717,171772,Sant Pau de Segúries,2007,681,335,346,69,434,178
718,082310,Sant Pere de Ribes,2007,27509,13921,13588,4763,19751,2995
719,082325,Sant Pere de Riudebitlles,2007,2319,1183,1136,370,1525,424
720,082331,Sant Pere de Torelló,2007,2272,1145,1127,291,1547,434
721,082346,Sant Pere de Vilamajor,2007,3728,1870,1858,727,2549,452
722,171788,Sant Pere Pescador,2007,1878,1021,857,268,1314,296
723,081897,Sant Pere Sallavinera,2007,177,92,85,16,111,50
724,082359,Sant Pol de Mar,2007,4904,2502,2402,792,3427,685
725,082362,Sant Quintí de Mediona,2007,2131,1097,1034,333,1405,393
726,082378,Sant Quirze de Besora,2007,2146,1048,1098,272,1343,531
727,082384,Sant Quirze del Vallès,2007,17819,8810,9009,3480,12779,1560
728,082397,Sant Quirze Safaja,2007,629,318,311,115,460,54
729,251945,Sant Ramon,2007,570,304,266,56,355,159
730,082401,Sant Sadurní d'Anoia,2007,11790,5837,5953,2015,7986,1789
731,082418,Sant Sadurní d'Osormort,2007,86,50,36,12,55,19
732,080983,Sant Salvador de Guardiola,2007,2970,1526,1444,513,2070,387
733,082628,Sant Vicenç de Castellet,2007,8096,3932,4164,1098,5434,1564
734,082649,Sant Vicenç de Montalt,2007,5267,2680,2587,1156,3556,555
735,082652,Sant Vicenç de Torelló,2007,1958,938,1020,333,1238,387
736,082634,Sant Vicenç dels Horts,2007,27106,13558,13548,4593,19069,3444
737,431384,Santa Bàrbara,2007,3805,1939,1866,532,2442,831
738,082439,Santa Cecília de Voltregà,2007,189,98,91,25,128,36
739,082444,Santa Coloma de Cervelló,2007,7508,3748,3760,1497,5284,727
740,171805,Santa Coloma de Farners,2007,11090,5715,5375,1793,7584,1713
741,082457,Santa Coloma de Gramenet,2007,116765,59329,57436,15214,83049,18502
742,431397,Santa Coloma de Queralt,2007,3058,1531,1527,517,1949,592
743,171812,Santa Cristina d'Aro,2007,4547,2330,2217,784,3150,613
744,082460,Santa Eugènia de Berga,2007,2194,1152,1042,276,1596,322
745,082476,Santa Eulàlia de Riuprimer,2007,954,486,468,139,647,168
746,082482,Santa Eulàlia de Ronçana,2007,6458,3239,3219,1118,4416,924
747,082495,Santa Fe del Penedès,2007,366,182,184,73,247,46
748,171827,Santa Llogaia d'Àlguema,2007,310,161,149,46,221,43
749,082508,Santa Margarida de Montbui,2007,9825,4945,4880,1605,6872,1348
750,082515,Santa Margarida i els Monjos,2007,6459,3355,3104,1074,4655,730
751,082589,Santa Maria d'Oló,2007,1087,548,539,133,730,224
752,082536,Santa Maria de Besora,2007,183,92,91,19,114,50
753,082567,Santa Maria de Martorelles,2007,806,418,388,145,554,107
754,082554,Santa Maria de Merlès,2007,151,77,74,26,96,29
755,082573,Santa Maria de Miralles,2007,128,61,67,14,88,26
756,082592,Santa Maria de Palautordera,2007,8235,4262,3973,1400,5722,1113
757,431401,Santa Oliva,2007,2988,1591,1397,510,2011,467
758,171848,Santa Pau,2007,1567,792,775,191,1087,289
759,082606,Santa Perpètua de Mogoda,2007,23443,12034,11409,3971,16964,2508
760,082613,Santa Susanna,2007,3019,1557,1462,518,2099,402
761,081923,Santpedor,2007,6557,3271,3286,1050,4571,936
762,431423,Sarral,2007,1660,859,801,213,1107,340
763,171864,Sarrià de Ter,2007,4144,2054,2090,589,2827,728
764,252017,Sarroca de Bellera,2007,129,74,55,3,82,44
765,252000,Sarroca de Lleida,2007,430,225,205,31,281,118
766,171870,"Saus, Camallera i Llampaies",2007,760,371,389,96,514,150
767,431439,Savallà del Comtat,2007,71,39,32,6,42,23
768,431444,"Secuita, la",2007,1363,700,663,202,960,201
769,171886,"Selva de Mar, la",2007,216,109,107,23,147,46
770,431457,"Selva del Camp, la",2007,5097,2587,2510,977,3342,778
771,431460,Senan,2007,54,35,19,10,36,8
772,430445,"Sénia, la",2007,6108,3153,2955,845,4236,1027
773,252022,Senterada,2007,142,76,66,11,103,28
774,250352,"Sentiu de Sió, la",2007,507,249,258,42,337,128
775,082671,Sentmenat,2007,7376,3723,3653,1256,5250,870
776,171903,Serinyà,2007,1084,558,526,182,707,195
777,252043,Seròs,2007,1893,1079,814,186,1252,455
778,171910,Serra de Daró,2007,190,108,82,23,113,54
779,171925,Setcases,2007,176,94,82,17,114,45
780,252038,"Seu d'Urgell, la",2007,12703,6282,6421,1897,8706,2100
781,082690,Seva,2007,3191,1632,1559,516,2180,495
782,252056,Sidamon,2007,707,366,341,97,484,126
783,171931,Sils,2007,4347,2215,2132,746,3008,593
784,082704,Sitges,2007,26225,13038,13187,4045,18597,3583
785,170524,Siurana,2007,205,110,95,25,128,52
786,082711,Sobremunt,2007,98,48,50,15,63,20
787,252069,"Soleràs, el",2007,407,215,192,52,240,115
788,431476,Solivella,2007,686,346,340,105,395,186
789,252075,Solsona,2007,9000,4592,4408,1478,5977,1545
790,082726,Sora,2007,178,100,78,27,118,33
791,252081,Soriguera,2007,341,180,161,31,235,75
792,252094,Sort,2007,2264,1166,1098,322,1542,400
793,252108,Soses,2007,1672,895,777,220,1152,300
794,082732,Subirats,2007,3008,1505,1503,491,1931,586
795,252115,Sudanell,2007,833,461,372,80,576,177
796,252120,Sunyer,2007,290,149,141,34,183,73
797,082747,Súria,2007,6369,3131,3238,822,4094,1453
798,171946,Susqueda,2007,126,69,57,10,91,25
799,082763,Tagamanent,2007,301,157,144,51,199,51
800,082779,Talamanca,2007,140,75,65,14,112,14
801,252154,Talarn,2007,382,187,195,51,243,88
802,252167,Talavera,2007,306,175,131,34,195,77
803,171959,"Tallada d'Empordà, la",2007,395,210,185,54,244,97
804,082785,Taradell,2007,5864,3027,2837,932,3973,959
805,431482,Tarragona,2007,134163,66343,67820,21005,93495,19663
806,252173,Tàrrega,2007,15515,7820,7695,2540,10593,2382
807,252189,Tarrés,2007,109,55,54,5,72,32
808,252192,Tarroja de Segarra,2007,172,91,81,18,104,50
809,082750,Tavèrnoles,2007,310,157,153,36,227,47
810,082802,Tavertet,2007,147,80,67,9,105,33
811,082819,Teià,2007,5969,3037,2932,959,4173,837
812,252206,Térmens,2007,1489,760,729,166,989,334
813,171962,Terrades,2007,266,138,128,34,176,56
814,082798,Terrassa,2007,202136,100692,101444,31819,140399,29918
815,082824,Tiana,2007,7417,3639,3778,1350,5258,809
816,252213,Tírvia,2007,130,72,58,12,87,31
817,252228,Tiurana,2007,56,30,26,5,35,16
818,431495,Tivenys,2007,926,474,452,104,545,277
819,431508,Tivissa,2007,1781,897,884,187,1145,449
820,082830,Tona,2007,7578,3806,3772,1313,5166,1099
821,252234,Torà,2007,1333,688,645,186,879,268
822,082845,Tordera,2007,14017,7145,6872,2192,9751,2074
823,082858,Torelló,2007,13449,6658,6791,1921,9254,2274
824,252249,"Torms, els",2007,182,98,84,18,104,60
825,252252,Tornabous,2007,822,436,386,79,517,226
826,252271,"Torre de Cabdella, la",2007,792,400,392,54,518,220
827,082861,"Torre de Claramunt, la",2007,3466,1808,1658,597,2511,358
828,431515,"Torre de Fontaubella, la",2007,137,68,69,9,83,45
829,431520,"Torre de l'Espanyol, la",2007,681,351,330,79,424,178
830,252265,Torrebesses,2007,306,156,150,26,184,96
831,431536,Torredembarra,2007,14524,7247,7277,2238,10140,2146
832,252287,Torrefarrera,2007,3338,1717,1621,568,2381,389
833,259078,Torrefeta i Florejacs,2007,637,324,313,74,385,178
834,252304,Torregrossa,2007,2259,1146,1113,254,1437,568
835,252311,Torrelameu,2007,637,355,282,52,437,148
836,082877,Torrelavit,2007,1275,698,577,134,878,263
837,082883,Torrelles de Foix,2007,2307,1227,1080,344,1545,418
838,082896,Torrelles de Llobregat,2007,4974,2494,2480,954,3528,492
839,171978,Torrent,2007,191,98,93,19,135,37
840,252326,Torres de Segre,2007,2021,1055,966,264,1352,405
841,252332,Torre-serona,2007,348,182,166,37,235,76
842,171984,Torroella de Fluvià,2007,556,305,251,78,393,85
843,171997,Torroella de Montgrí,2007,10924,5569,5355,1713,7568,1643
844,431541,Torroja del Priorat,2007,147,85,62,6,101,40
845,172001,Tortellà,2007,749,377,372,86,451,212
846,431554,Tortosa,2007,34832,17903,16929,4756,23733,6343
847,172018,Toses,2007,158,97,61,21,104,33
848,172023,Tossa de Mar,2007,5662,2873,2789,785,3994,883
849,252347,Tremp,2007,6022,2979,3043,808,3761,1453
850,172044,Ullà,2007,1019,593,426,156,736,127
851,082900,Ullastrell,2007,1687,865,822,325,1153,209
852,172057,Ullastret,2007,218,113,105,32,141,45
853,431567,Ulldecona,2007,6566,3416,3150,882,4395,1289
854,431573,Ulldemolins,2007,493,272,221,34,289,170
855,172039,Ultramort,2007,196,116,80,15,122,59
856,172060,Urús,2007,200,106,94,26,135,39
857,082917,Vacarisses,2007,5431,2814,2617,1129,3735,567
858,170144,"Vajol, la",2007,109,63,46,10,76,23
859,172076,"Vall d'en Bas, la",2007,2680,1354,1326,348,1726,606
860,172082,"Vall de Bianya, la",2007,1304,658,646,201,870,233
861,250432,"Vall de Boí, la",2007,1049,572,477,110,778,161
862,259010,Vall de Cardós,2007,399,220,179,46,261,92
863,082922,Vallbona d'Anoia,2007,1337,672,665,205,924,208
864,252385,Vallbona de les Monges,2007,249,126,123,15,146,88
865,082938,Vallcebre,2007,269,147,122,23,172,74
866,431589,Vallclara,2007,118,68,50,11,68,39
867,252402,Vallfogona de Balaguer,2007,1660,837,823,212,1137,311
868,171707,Vallfogona de Ripollès,2007,219,119,100,27,141,51
869,431592,Vallfogona de Riucorb,2007,158,88,70,4,74,80
870,082943,Vallgorguina,2007,2193,1122,1071,404,1556,233
871,082956,Vallirana,2007,13326,6681,6645,2356,9357,1613
872,172095,Vall-llobrega,2007,778,400,378,165,542,71
873,431606,Vallmoll,2007,1529,813,716,203,1107,219
874,082969,Vallromanes,2007,2204,1113,1091,505,1499,200
875,431613,Valls,2007,23948,12035,11913,3704,16382,3862
876,259062,"Valls d'Aguilar, les",2007,314,172,142,23,213,78
877,252398,"Valls de Valira, les",2007,875,480,395,91,610,174
878,431628,Vandellòs i l'Hospitalet de l'Infant,2007,5420,2777,2643,756,3854,810
879,259097,"Vansa i Fórnols, la",2007,195,106,89,14,127,54
880,082975,Veciana,2007,171,92,79,25,102,44
881,431634,"Vendrell, el",2007,33340,16891,16449,5534,23538,4268
882,172109,Ventalló,2007,725,383,342,77,485,163
883,252424,Verdú,2007,1014,491,523,123,591,300
884,172116,Verges,2007,1175,588,587,141,764,270
885,431649,Vespella de Gaià,2007,379,207,172,48,280,51
886,082981,Vic,2007,38321,19334,18987,6169,25997,6155
887,172121,Vidrà,2007,179,89,90,24,123,32
888,172137,Vidreres,2007,7016,3666,3350,1174,4844,998
889,252430,Vielha e Mijaran,2007,5385,2883,2502,771,4140,474
890,431652,Vilabella,2007,789,401,388,93,520,176
891,172142,Vilabertran,2007,844,439,405,116,552,176
892,172155,Vilablareix,2007,2266,1133,1133,377,1675,214
893,082994,Vilada,2007,519,261,258,43,341,135
894,172174,Viladamat,2007,440,229,211,54,290,96
895,172168,Viladasens,2007,200,98,102,21,135,44
896,083015,Viladecans,2007,61718,30998,30720,10181,44290,7247
897,083008,Viladecavalls,2007,7079,3565,3514,1384,5017,678
898,172180,Vilademuls,2007,769,406,363,100,497,172
899,172207,Viladrau,2007,1036,535,501,145,715,176
900,172214,Vilafant,2007,5193,2595,2598,899,3672,622
901,083054,Vilafranca del Penedès,2007,36656,18279,18377,5718,25459,5479
902,252445,Vilagrassa,2007,451,237,214,54,282,115
903,172235,Vilajuïga,2007,1117,562,555,187,742,188
904,431750,Vilalba dels Arcs,2007,737,388,349,70,441,226
905,083067,Vilalba Sasserra,2007,588,298,290,96,421,71
906,252458,Vilaller,2007,656,381,275,65,476,115
907,172240,Vilallonga de Ter,2007,459,249,210,39,300,120
908,431665,Vilallonga del Camp,2007,1631,823,808,233,1161,237
909,172253,Vilamacolum,2007,293,153,140,32,198,63
910,172266,Vilamalla,2007,1106,588,518,172,819,115
911,172272,Vilamaniscle,2007,172,94,78,32,107,33
912,252477,Vilamòs,2007,184,100,84,26,142,16
913,172288,Vilanant,2007,328,161,167,46,220,62
914,431671,Vilanova d'Escornalbou,2007,502,268,234,63,353,86
915,252483,Vilanova de Bellpuig,2007,1119,581,538,105,699,315
916,252496,Vilanova de l'Aguda,2007,235,121,114,28,124,83
917,252542,Vilanova de la Barca,2007,1105,551,554,132,736,237
918,252509,Vilanova de Meià,2007,411,214,197,27,259,125
919,431687,Vilanova de Prades,2007,144,79,65,11,91,42
920,083036,Vilanova de Sau,2007,329,154,175,38,232,59
921,252516,Vilanova de Segrià,2007,831,447,384,81,599,151
922,083020,Vilanova del Camí,2007,12208,6263,5945,2127,8700,1381
923,089024,Vilanova del Vallès,2007,4121,2122,1999,823,2859,439
924,083073,Vilanova i la Geltrú,2007,63196,31168,32028,9456,43753,9987
925,431690,Vilaplana,2007,613,311,302,62,401,150
926,431704,Vila-rodona,2007,1112,570,542,144,726,242
927,172305,Vila-sacra,2007,508,251,257,62,361,85
928,252521,Vila-sana,2007,618,312,306,86,394,138
929,431711,Vila-seca,2007,18678,9474,9204,2980,13734,1964
930,082140,Vilassar de Dalt,2007,8476,4207,4269,1300,5868,1308
931,082191,Vilassar de Mar,2007,19052,9298,9754,3219,13066,2767
932,172229,Vilaür,2007,142,73,69,20,92,30
933,431726,Vilaverd,2007,473,239,234,57,300,116
934,431732,"Vilella Alta, la",2007,115,66,49,13,72,30
935,431747,"Vilella Baixa, la",2007,202,107,95,30,129,43
936,172333,Vilobí d'Onyar,2007,2756,1453,1303,412,1901,443
937,083041,Vilobí del Penedès,2007,1071,557,514,170,711,190
938,172327,Vilopriu,2007,187,100,87,28,113,46
939,252537,"Vilosell, el",2007,205,104,101,10,130,65
940,431763,Vimbodí i Poblet,2007,1050,592,458,123,638,289
941,252555,Vinaixa,2007,591,305,286,50,386,155
942,431779,Vinebre,2007,478,249,229,46,313,119
943,431785,Vinyols i els Arcs,2007,1594,813,781,238,1109,247
944,083089,Viver i Serrateix,2007,192,99,93,28,122,42
945,430521,Xerta,2007,1296,644,652,161,787,348
946,000000,Catalunya,2007,7210508,3578176,3632332,1046915,4979965,1183628
0,250019,Abella de la Conca,2008,183,100,83,23,124,36
1,080018,Abrera,2008,11278,5882,5396,1891,8259,1128
2,250024,Àger,2008,557,302,255,37,343,177
3,250030,Agramunt,2008,5577,2918,2659,812,3748,1017
4,080023,Aguilar de Segarra,2008,249,132,117,36,159,54
5,170010,Agullana,2008,806,421,385,106,512,188
6,080142,Aiguafreda,2008,2428,1178,1250,351,1579,498
7,430017,Aiguamúrcia,2008,886,472,414,112,618,156
8,170025,Aiguaviva,2008,678,346,332,134,449,95
9,250387,Aitona,2008,2345,1211,1134,262,1522,561
10,250045,"Alamús, els",2008,724,373,351,78,476,170
11,250058,Alàs i Cerc,2008,396,205,191,41,252,103
12,250061,"Albagés, l'",2008,476,252,224,58,277,141
13,170031,Albanyà,2008,143,76,67,23,101,19
14,250077,Albatàrrec,2008,1749,941,808,270,1233,246
15,250083,Albesa,2008,1546,799,747,189,1018,339
16,250096,"Albi, l'",2008,841,427,414,91,544,206
17,430022,Albinyana,2008,2292,1159,1133,372,1537,383
18,430038,"Albiol, l'",2008,415,216,199,97,278,40
19,170046,Albons,2008,666,345,321,91,466,109
20,430043,Alcanar,2008,10510,5425,5085,1406,7244,1860
21,250100,Alcanó,2008,244,119,125,22,152,70
22,250117,Alcarràs,2008,7281,3780,3501,1044,5174,1063
23,250122,Alcoletge,2008,2547,1336,1211,357,1850,340
24,430056,Alcover,2008,4962,2574,2388,852,3365,745
25,439044,"Aldea, l'",2008,3966,2123,1843,457,2677,832
26,430069,Aldover,2008,957,471,486,115,593,249
27,430075,"Aleixar, l'",2008,900,453,447,149,582,169
28,080039,Alella,2008,9260,4545,4715,1461,6596,1203
29,430081,Alfara de Carles,2008,392,211,181,34,255,103
30,250138,Alfarràs,2008,3163,1627,1536,462,2023,678
31,250143,Alfés,2008,323,172,151,28,205,90
32,430094,Alforja,2008,1814,940,874,257,1222,335
33,250156,Algerri,2008,473,239,234,30,270,173
34,250169,Alguaire,2008,3129,1632,1497,427,2090,612
35,250175,Alins,2008,265,136,129,18,165,82
36,430108,Alió,2008,379,192,187,37,267,75
37,250194,Almacelles,2008,6295,3326,2969,846,4263,1186
38,250208,Almatret,2008,415,221,194,25,231,159
39,250215,Almenar,2008,3665,1915,1750,468,2431,766
40,430115,Almoster,2008,1339,667,672,277,916,146
41,250220,Alòs de Balaguer,2008,153,91,62,12,86,55
42,170062,Alp,2008,1686,885,801,230,1285,171
43,080044,Alpens,2008,312,173,139,54,202,56
44,250236,Alpicat,2008,5900,2929,2971,1050,4141,709
45,250241,Alt Àneu,2008,439,252,187,45,303,91
46,430120,Altafulla,2008,4554,2284,2270,772,3245,537
47,170078,Amer,2008,2270,1109,1161,242,1497,531
48,430136,"Ametlla de Mar, l'",2008,7424,3798,3626,1060,5021,1343
49,080057,"Ametlla del Vallès, l'",2008,7796,3893,3903,1573,5384,839
50,439060,"Ampolla, l'",2008,2947,1514,1433,320,2039,588
51,430141,Amposta,2008,20652,10573,10079,3156,14204,3292
52,170084,Anglès,2008,5446,2792,2654,811,3626,1009
53,250273,Anglesola,2008,1332,675,657,168,855,309
54,250292,Arbeca,2008,2472,1281,1191,308,1537,627
55,430167,"Arboç, l'",2008,5377,2868,2509,937,3695,745
56,430154,Arbolí,2008,111,60,51,1,86,24
57,170097,Arbúcies,2008,6526,3479,3047,1053,4452,1021
58,080060,Arenys de Mar,2008,14449,7053,7396,2073,9751,2625
59,080076,Arenys de Munt,2008,8023,4004,4019,1393,5494,1136
60,170101,Argelaguer,2008,430,224,206,71,278,81
61,080082,Argençola,2008,230,136,94,29,162,39
62,430173,"Argentera, l'",2008,143,82,61,10,98,35
63,080095,Argentona,2008,11544,5741,5803,2056,7925,1563
64,170118,"Armentera, l'",2008,827,402,425,97,526,204
65,430189,Arnes,2008,497,255,242,33,282,182
66,250313,Arres,2008,66,46,20,4,54,8
67,250328,Arsèguel,2008,93,50,43,7,65,21
68,080109,Artés,2008,5305,2669,2636,828,3590,887
69,250334,Artesa de Lleida,2008,1503,787,716,233,946,324
70,250349,Artesa de Segre,2008,3872,2040,1832,531,2572,769
71,430192,Ascó,2008,1601,826,775,163,1063,375
72,250365,Aspa,2008,262,136,126,30,148,84
73,250371,"Avellanes i Santa Linya, les",2008,470,266,204,37,293,140
74,080116,Avià,2008,2144,1076,1068,327,1394,423
75,080121,Avinyó,2008,2222,1112,1110,339,1424,459
76,170123,Avinyonet de Puigventós,2008,1417,752,665,320,960,137
77,080137,Avinyonet del Penedès,2008,1660,888,772,256,1117,287
78,080155,Badalona,2008,215329,107931,107398,31366,151895,32068
79,089045,Badia del Vallès,2008,13829,6811,7018,2140,9651,2038
80,080168,Bagà,2008,2321,1153,1168,270,1517,534
81,250390,Baix Pallars,2008,407,223,184,49,257,101
82,250404,Balaguer,2008,16341,8284,8057,2562,11034,2745
83,080174,Balenyà,2008,3672,1838,1834,582,2576,514
84,080180,Balsareny,2008,3505,1796,1709,441,2389,675
85,430206,Banyeres del Penedès,2008,2845,1470,1375,532,1964,349
86,170157,Banyoles,2008,17917,8975,8942,3121,11819,2977
87,250411,Barbens,2008,890,478,412,95,549,246
88,430213,Barberà de la Conca,2008,521,284,237,66,343,112
89,082520,Barberà del Vallès,2008,30271,15131,15140,4836,22028,3407
90,080193,Barcelona,2008,1615908,767697,848211,190674,1095605,329629
91,250426,"Baronia de Rialb, la",2008,276,149,127,39,166,71
92,170160,Bàscara,2008,915,489,426,108,596,211
93,250447,Bassella,2008,258,136,122,31,163,64
94,430228,Batea,2008,2169,1123,1046,247,1380,542
95,250450,Bausen,2008,60,37,23,4,28,28
96,080207,Begues,2008,6078,3025,3053,1301,4248,529
97,170139,Begur,2008,4304,2226,2078,633,2993,678
98,250463,Belianes,2008,584,300,284,77,332,175
99,251706,Bellaguarda,2008,344,181,163,36,187,121
100,170182,Bellcaire d'Empordà,2008,651,317,334,99,418,134
101,250479,Bellcaire d'Urgell,2008,1269,622,647,132,776,361
102,250485,Bell-lloc d'Urgell,2008,2413,1201,1212,362,1556,495
103,250498,Bellmunt d'Urgell,2008,215,103,112,27,131,57
104,430234,Bellmunt del Priorat,2008,347,175,172,38,216,93
105,080214,Bellprat,2008,91,52,39,7,60,24
106,250501,Bellpuig,2008,4798,2499,2299,719,3232,847
107,430249,Bellvei,2008,1985,1061,924,344,1360,281
108,250518,Bellver de Cerdanya,2008,2132,1129,1003,264,1486,382
109,250523,Bellvís,2008,2468,1278,1190,293,1583,592
110,250539,Benavent de Segrià,2008,1445,747,698,288,981,176
111,430252,Benifallet,2008,802,401,401,77,469,256
112,430265,Benissanet,2008,1268,684,584,155,834,279
113,080229,Berga,2008,17072,8568,8504,2276,11373,3423
114,170195,Besalú,2008,2290,1107,1183,301,1473,516
115,170209,Bescanó,2008,4242,2120,2122,770,2799,673
116,170216,Beuda,2008,158,80,78,16,118,24
117,080235,Bigues i Riells del Fai,2008,8191,4218,3973,1571,5758,862
118,250557,Biosca,2008,221,119,102,21,131,69
119,170221,"Bisbal d'Empordà, la",2008,10173,5160,5013,1584,6945,1644
120,430271,"Bisbal de Falset, la",2008,241,126,115,30,136,75
121,430287,"Bisbal del Penedès, la",2008,3328,1739,1589,523,2289,516
122,172348,Biure,2008,244,125,119,29,164,51
123,430290,Blancafort,2008,428,227,201,50,269,109
124,170237,Blanes,2008,39107,19719,19388,6014,27414,5679
125,170293,Boadella i les Escaules,2008,233,113,120,24,161,48
126,170242,Bolvir,2008,363,197,166,41,261,61
127,430304,Bonastre,2008,642,346,296,98,441,103
128,250576,"Bòrdes, Es",2008,237,128,109,23,177,37
129,170255,Bordils,2008,1703,873,830,285,1162,256
130,250582,"Borges Blanques, les",2008,5942,3025,2917,807,3932,1203
131,430311,"Borges del Camp, les",2008,2061,1045,1016,341,1361,359
132,170268,Borrassà,2008,682,360,322,79,475,128
133,080240,Borredà,2008,609,325,284,89,391,129
134,250595,Bossòst,2008,1202,624,578,153,878,171
135,430326,Bot,2008,708,362,346,53,417,238
136,430332,Botarell,2008,1032,548,484,181,737,114
137,250560,Bovera,2008,357,182,175,18,192,147
138,430347,Bràfim,2008,652,329,323,82,428,142
139,170274,Breda,2008,3753,1913,1840,544,2490,719
140,080253,"Bruc, el",2008,1841,990,851,341,1286,214
141,080266,"Brull, el",2008,246,133,113,46,162,38
142,170280,Brunyola i Sant Martí Sapresa,2008,363,181,182,36,227,100
143,430350,Cabacés,2008,342,185,157,34,212,96
144,250609,Cabanabona,2008,101,45,56,8,45,48
145,170314,Cabanelles,2008,236,135,101,22,163,51
146,170307,Cabanes,2008,903,478,425,147,582,174
147,080272,"Cabanyes, les",2008,890,449,441,193,602,95
148,250616,Cabó,2008,99,57,42,9,58,32
149,430363,Cabra del Camp,2008,1078,571,507,172,739,167
150,080288,Cabrera d'Anoia,2008,1274,678,596,218,911,145
151,080291,Cabrera de Mar,2008,4321,2211,2110,739,3022,560
152,080305,Cabrils,2008,6834,3370,3464,1525,4664,645
153,170329,Cadaqués,2008,2873,1431,1442,450,1996,427
154,080312,Calaf,2008,3561,1890,1671,495,2430,636
155,430379,Calafell,2008,22939,11716,11223,3359,16511,3069
156,080348,Calders,2008,914,463,451,152,594,168
157,080327,Caldes d'Estrac,2008,2735,1324,1411,392,1867,476
158,170335,Caldes de Malavella,2008,6459,3202,3257,1121,4393,945
159,080333,Caldes de Montbui,2008,16518,8295,8223,2709,11396,2413
160,080351,Calella,2008,18615,9257,9358,2713,12887,3015
161,080370,Calldetenes,2008,2329,1187,1142,362,1653,314
162,080386,Callús,2008,1675,824,851,247,1094,334
163,080364,Calonge de Segarra,2008,201,107,94,27,117,57
164,170340,Calonge i Sant Antoni,2008,10428,5308,5120,1554,7247,1627
165,250621,Camarasa,2008,948,492,456,75,599,274
166,439039,Camarles,2008,3629,1872,1757,504,2409,716
167,430385,Cambrils,2008,30956,15517,15439,5239,22052,3665
168,170353,Camós,2008,696,352,344,90,452,154
169,170366,Campdevànol,2008,3501,1766,1735,412,2243,846
170,170372,Campelles,2008,128,64,64,16,88,24
171,080399,Campins,2008,380,195,185,65,270,45
172,170388,Campllong,2008,423,212,211,81,270,72
173,170391,Camprodon,2008,2578,1280,1298,316,1687,575
174,250637,Canejan,2008,110,59,51,6,67,37
175,170405,Canet d'Adri,2008,601,309,292,73,420,108
176,080403,Canet de Mar,2008,13381,6648,6733,1977,9104,2300
177,080410,Canovelles,2008,15816,8403,7413,2533,11408,1875
178,080425,Cànoves i Samalús,2008,2693,1378,1315,467,1870,356
179,170412,Cantallops,2008,320,164,156,37,202,81
180,080431,Canyelles,2008,4005,2060,1945,766,2852,387
181,430398,Capafonts,2008,117,62,55,2,75,40
182,430402,Capçanes,2008,408,200,208,36,268,104
183,080446,Capellades,2008,5458,2693,2765,820,3685,953
184,170427,Capmany,2008,560,301,259,69,365,126
185,080459,Capolat,2008,76,36,40,12,45,19
186,080462,Cardedeu,2008,16102,7964,8138,2890,11192,2020
187,080478,Cardona,2008,5176,2537,2639,601,3328,1247
188,080484,Carme,2008,805,426,379,99,535,171
189,430419,Caseres,2008,294,145,149,30,165,99
190,170448,Cassà de la Selva,2008,9256,4774,4482,1471,6207,1578
191,080497,Casserres,2008,1634,812,822,171,1044,419
192,080575,Castell de l'Areny,2008,78,46,32,11,54,13
193,259046,Castell de Mur,2008,177,93,84,22,101,54
194,250642,Castellar de la Ribera,2008,159,78,81,27,88,44
195,080522,Castellar de n'Hug,2008,208,110,98,16,153,39
196,080500,Castellar del Riu,2008,147,77,70,21,99,27
197,080517,Castellar del Vallès,2008,22626,11288,11338,4167,15778,2681
198,080538,Castellbell i el Vilar,2008,3617,1859,1758,522,2484,611
199,080543,Castellbisbal,2008,11795,6058,5737,2382,8226,1187
200,080556,Castellcir,2008,631,324,307,123,415,93
201,250674,Castelldans,2008,1029,566,463,106,686,237
202,080569,Castelldefels,2008,60572,30415,30157,10201,44004,6367
203,080581,Castellet i la Gornal,2008,2181,1131,1050,365,1481,335
204,170464,Castellfollit de la Roca,2008,1014,514,500,125,653,236
205,080608,Castellfollit de Riubregós,2008,192,101,91,14,125,53
206,080594,Castellfollit del Boix,2008,425,206,219,71,269,85
207,080615,Castellgalí,2008,1760,921,839,320,1186,254
208,080620,Castellnou de Bages,2008,966,508,458,178,695,93
209,250680,Castellnou de Seana,2008,731,381,350,79,447,205
210,170470,Castelló d'Empúries,2008,11653,6054,5599,1814,8110,1729
211,250693,Castelló de Farfanya,2008,584,313,271,50,376,158
212,080636,Castellolí,2008,474,229,245,75,314,85
213,170486,Castell-Platja d'Aro,2008,10150,5168,4982,1402,7367,1381
214,250707,Castellserà,2008,1123,585,538,120,698,305
215,080641,Castellterçol,2008,2325,1164,1161,350,1491,484
216,430424,Castellvell del Camp,2008,2588,1328,1260,539,1806,243
217,080654,Castellví de la Marca,2008,1628,813,815,260,1060,308
218,080667,Castellví de Rosanes,2008,1659,837,822,319,1134,206
219,430430,"Catllar, el",2008,3973,2056,1917,678,2880,415
220,250714,Cava,2008,55,36,19,0,38,17
221,171899,"Cellera de Ter, la",2008,2162,1095,1067,323,1414,425
222,170499,Celrà,2008,4329,2155,2174,880,3019,430
223,080673,Centelles,2008,7133,3493,3640,1070,4836,1227
224,082687,Cercs,2008,1324,676,648,132,833,359
225,082665,Cerdanyola del Vallès,2008,58493,28913,29580,8946,42288,7259
226,080689,Cervelló,2008,8187,4167,4020,1312,5942,933
227,250729,Cervera,2008,9247,4783,4464,1568,6242,1437
228,250735,Cervià de les Garrigues,2008,860,447,413,84,534,242
229,170502,Cervià de Ter,2008,863,432,431,156,546,161
230,170519,Cistella,2008,253,132,121,30,165,58
231,250740,Ciutadilla,2008,226,129,97,24,143,59
232,250753,Clariana de Cardener,2008,147,78,69,21,110,16
233,250766,"Cogul, el",2008,211,115,96,14,132,65
234,170545,Colera,2008,578,301,277,46,386,146
235,250772,Coll de Nargó,2008,628,330,298,57,420,151
236,080692,Collbató,2008,3971,2071,1900,869,2745,357
237,430458,Colldejou,2008,186,101,85,14,139,33
238,080706,Collsuspina,2008,334,179,155,54,232,48
239,170558,Colomers,2008,203,98,105,19,126,58
240,251636,"Coma i la Pedra, la",2008,267,163,104,22,193,52
241,251615,Conca de Dalt,2008,418,217,201,30,260,128
242,430461,Conesa,2008,134,68,66,13,84,37
243,430477,Constantí,2008,6401,3464,2937,1058,4533,810
244,080713,Copons,2008,313,147,166,49,204,60
245,430483,Corbera d'Ebre,2008,1169,626,543,131,758,280
246,080728,Corbera de Llobregat,2008,13435,6861,6574,2492,9541,1402
247,250788,Corbins,2008,1370,729,641,193,927,250
248,170577,Corçà,2008,1270,627,643,155,883,232
249,080734,Cornellà de Llobregat,2008,85180,42342,42838,12246,58242,14692
250,170561,Cornellà del Terri,2008,2189,1106,1083,320,1462,407
251,430496,Cornudella de Montsant,2008,1006,525,481,113,645,248
252,430509,Creixell,2008,3154,1633,1521,421,2150,583
253,170583,Crespià,2008,257,132,125,34,169,54
254,179011,"Cruïlles, Monells i Sant Sadurní de l'Heura",2008,1270,633,637,183,883,204
255,080749,Cubelles,2008,13243,6715,6528,2196,9425,1622
256,250791,Cubells,2008,397,202,195,48,224,125
257,430516,Cunit,2008,11730,6048,5682,1858,8146,1726
258,170600,Darnius,2008,534,270,264,54,344,136
259,170617,Das,2008,214,113,101,34,145,35
260,439018,Deltebre,2008,11445,5864,5581,1425,7819,2201
261,080752,Dosrius,2008,4869,2459,2410,893,3526,450
262,430537,Duesaigües,2008,236,138,98,20,152,64
263,170622,"Escala, l'",2008,9829,5079,4750,1300,6781,1748
264,080765,Esparreguera,2008,21451,11021,10430,3678,15135,2638
265,170638,Espinelves,2008,191,97,94,20,126,45
266,250812,"Espluga Calba, l'",2008,424,224,200,35,262,127
267,430542,"Espluga de Francolí, l'",2008,3934,1956,1978,519,2566,849
268,080771,Esplugues de Llobregat,2008,46586,22795,23791,6205,32653,7728
269,170643,Espolla,2008,408,197,211,35,267,106
270,170656,Esponellà,2008,451,218,233,73,287,91
271,250827,Espot,2008,360,196,164,45,260,55
272,080787,"Espunyola, l'",2008,269,132,137,35,164,70
273,082541,"Esquirol, l'",2008,2289,1152,1137,356,1461,472
274,250886,Estamariu,2008,115,61,54,10,64,41
275,080790,"Estany, l'",2008,385,180,205,40,241,104
276,250851,Estaràs,2008,178,98,80,16,115,47
277,250864,Esterri d'Àneu,2008,891,469,422,114,629,148
278,250870,Esterri de Cardós,2008,72,31,41,6,51,15
279,430555,Falset,2008,2807,1407,1400,409,1854,544
280,170059,"Far d'Empordà, el",2008,524,265,259,100,327,97
281,250899,Farrera,2008,115,69,46,12,85,18
282,430568,"Fatarella, la",2008,1139,573,566,108,694,337
283,430574,"Febró, la",2008,49,31,18,0,39,10
284,081347,Figaró-Montmany,2008,1045,538,507,164,672,209
285,080804,Fígols,2008,47,26,21,3,23,21
286,259084,Fígols i Alinyà,2008,280,158,122,16,166,98
287,430580,"Figuera, la",2008,156,86,70,11,106,39
288,170669,Figueres,2008,42809,21419,21390,6828,29651,6330
289,430593,Figuerola del Camp,2008,330,152,178,60,205,65
290,170675,Flaçà,2008,1050,518,532,138,699,213
291,430607,Flix,2008,4054,2062,1992,413,2748,893
292,250925,"Floresta, la",2008,199,110,89,25,119,55
293,080826,Fogars de la Selva,2008,1480,768,712,276,1025,179
294,080811,Fogars de Montclús,2008,459,248,211,83,294,82
295,170681,Foixà,2008,333,179,154,41,213,79
296,080832,Folgueroles,2008,2154,1083,1071,439,1424,291
297,250931,Fondarella,2008,811,408,403,113,583,115
298,080847,Fonollosa,2008,1362,697,665,210,966,186
299,170694,Fontanals de Cerdanya,2008,443,227,216,39,327,77
300,170708,Fontanilles,2008,167,101,66,20,110,37
301,170715,Fontcoberta,2008,1200,585,615,188,863,149
302,080850,Font-rubí,2008,1461,767,694,219,928,314
303,250946,Foradada,2008,189,109,80,16,120,53
304,179026,Forallac,2008,1740,863,877,214,1225,301
305,430614,Forès,2008,49,29,20,0,27,22
306,170736,Fornells de la Selva,2008,2110,1010,1100,425,1452,233
307,170741,Fortià,2008,628,320,308,89,409,130
308,080863,"Franqueses del Vallès, les",2008,16978,8741,8237,2807,12262,1909
309,430629,Freginals,2008,449,238,211,40,289,120
310,250962,"Fuliola, la",2008,1225,613,612,135,786,304
311,250978,Fulleda,2008,119,65,54,7,78,34
312,080902,Gaià,2008,160,85,75,26,107,27
313,430635,"Galera, la",2008,851,443,408,102,556,193
314,080879,Gallifa,2008,213,112,101,31,150,32
315,430640,Gandesa,2008,3173,1635,1538,403,2113,657
316,430653,Garcia,2008,606,307,299,66,368,172
317,430666,"Garidells, els",2008,222,111,111,30,152,40
318,080885,"Garriga, la",2008,14585,7056,7529,2562,10004,2019
319,170754,Garrigàs,2008,395,216,179,48,257,90
320,170767,Garrigoles,2008,167,89,78,18,108,41
321,170773,Garriguella,2008,821,417,404,111,544,166
322,080898,Gavà,2008,45190,22494,22696,7241,31766,6183
323,250984,Gavet de la Conca,2008,304,148,156,26,168,110
324,080919,Gelida,2008,6601,3349,3252,1139,4569,893
325,170789,Ger,2008,449,239,210,60,317,72
326,259123,Gimenells i el Pla de la Font,2008,1184,602,582,157,758,269
327,430672,Ginestar,2008,1098,592,506,135,710,253
328,170792,Girona,2008,94484,46380,48104,15011,66963,12510
329,080924,Gironella,2008,5016,2440,2576,588,3235,1193
330,080930,Gisclareny,2008,34,19,15,0,29,5
331,430688,Godall,2008,836,428,408,95,503,238
332,250997,Golmés,2008,1661,836,825,271,1110,280
333,170806,Gombrèn,2008,239,115,124,32,160,47
334,251001,Gósol,2008,233,132,101,21,157,55
335,080945,"Granada, la",2008,1949,996,953,318,1353,278
336,251018,"Granadella, la",2008,758,392,366,70,452,236
337,080958,Granera,2008,72,49,23,2,57,13
338,251023,"Granja d'Escarp, la",2008,1024,549,475,100,672,252
339,080961,Granollers,2008,60122,30235,29887,9038,42661,8423
340,251039,Granyanella,2008,178,90,88,18,115,45
341,251057,Granyena de les Garrigues,2008,161,90,71,10,105,46
342,251044,Granyena de Segarra,2008,144,73,71,2,84,58
343,430691,Gratallops,2008,257,135,122,32,167,58
344,080977,Gualba,2008,1126,574,552,187,800,139
345,170813,Gualta,2008,347,192,155,53,229,65
346,080996,Guardiola de Berguedà,2008,982,523,459,115,632,235
347,430705,"Guiamets, els",2008,327,167,160,26,211,90
348,170828,Guils de Cerdanya,2008,467,247,220,54,348,65
349,251095,Guimerà,2008,341,187,154,15,194,132
350,259031,"Guingueta d'Àneu, la",2008,376,210,166,42,261,73
351,251109,Guissona,2008,5683,3008,2675,1074,4037,572
352,251116,Guixers,2008,140,81,59,10,94,36
353,081000,Gurb,2008,2394,1228,1166,456,1627,311
354,430712,Horta de Sant Joan,2008,1287,699,588,147,807,333
355,081017,"Hospitalet de Llobregat, l'",2008,253782,124667,129115,32010,175625,46147
356,081629,"Hostalets de Pierola, els",2008,2426,1275,1151,436,1713,277
357,170834,Hostalric,2008,3882,1996,1886,603,2718,561
358,081022,Igualada,2008,38164,18994,19170,5921,25788,6455
359,251155,Isona i Conca Dellà,2008,1151,614,537,111,694,346
360,170849,Isòvol,2008,268,156,112,22,190,56
361,251137,Ivars d'Urgell,2008,1747,930,817,206,1121,420
362,251121,Ivars de Noguera,2008,348,186,162,33,223,92
363,251142,Ivorra,2008,138,70,68,12,84,42
364,170852,Jafre,2008,402,225,177,34,268,100
365,170865,"Jonquera, la",2008,3107,1592,1515,459,2247,401
366,081038,Jorba,2008,786,388,398,137,510,139
367,259101,Josa i Tuixén,2008,159,84,75,11,114,34
368,170871,Juià,2008,301,159,142,51,181,69
369,251180,Juncosa,2008,508,267,241,54,304,150
370,251193,Juneda,2008,3342,1748,1594,428,2216,698
371,251214,Les,2008,968,479,489,134,711,123
372,251229,Linyola,2008,2781,1451,1330,413,1820,548
373,081043,"Llacuna, la",2008,910,488,422,107,600,203
374,170887,Lladó,2008,644,335,309,89,427,128
375,251235,Lladorre,2008,230,113,117,27,154,49
376,251240,Lladurs,2008,212,117,95,27,131,54
377,081056,"Llagosta, la",2008,13645,6890,6755,2084,9683,1878
378,170890,Llagostera,2008,7614,3948,3666,1191,5165,1258
379,170904,Llambilles,2008,660,341,319,115,438,107
380,170911,Llanars,2008,571,304,267,60,396,115
381,170926,Llançà,2008,5082,2542,2540,683,3432,967
382,251253,Llardecans,2008,545,280,265,51,319,175
383,251266,Llavorsí,2008,365,186,179,45,247,73
384,251207,Lleida,2008,131731,65544,66187,19647,91704,20380
385,170932,Llers,2008,1157,584,573,171,779,207
386,251272,Lles de Cerdanya,2008,263,156,107,27,176,60
387,081075,Lliçà d'Amunt,2008,13809,7070,6739,2672,9554,1583
388,081081,Lliçà de Vall,2008,6182,3189,2993,1082,4341,759
389,251288,Llimiana,2008,163,91,72,12,104,47
390,081069,Llinars del Vallès,2008,8839,4438,4401,1482,6126,1231
391,170947,Llívia,2008,1517,836,681,193,1125,199
392,430727,"Lloar, el",2008,115,68,47,13,68,34
393,251291,Llobera,2008,212,115,97,25,134,53
394,430733,Llorac,2008,106,56,50,9,67,30
395,430748,Llorenç del Penedès,2008,2157,1086,1071,393,1444,320
396,170950,Lloret de Mar,2008,37734,20033,17701,5656,28490,3588
397,170963,"Llosses, les",2008,234,128,106,19,170,45
398,081094,Lluçà,2008,255,132,123,39,168,48
399,171024,Maçanet de Cabrenys,2008,723,379,344,62,449,212
400,171030,Maçanet de la Selva,2008,6611,3446,3165,1058,4675,878
401,170979,Madremanya,2008,232,105,127,33,146,53
402,170985,Maià de Montcal,2008,407,211,196,60,263,84
403,251333,Maials,2008,977,498,479,99,585,293
404,251305,Maldà,2008,273,146,127,26,152,95
405,081108,Malgrat de Mar,2008,18261,9162,9099,2681,12586,2994
406,081115,Malla,2008,261,130,131,29,191,41
407,081120,Manlleu,2008,20505,10435,10070,3535,13732,3238
408,081136,Manresa,2008,75053,37001,38052,10812,50212,14029
409,430764,Marçà,2008,651,330,321,99,389,163
410,430751,Margalef,2008,120,67,53,9,70,41
411,082423,Marganell,2008,301,145,156,39,199,63
412,081141,Martorell,2008,26169,13553,12616,4550,18022,3597
413,081154,Martorelles,2008,4905,2475,2430,682,3423,800
414,430770,Mas de Barberans,2008,676,340,336,68,424,184
415,171002,Masarac,2008,278,149,129,33,180,65
416,430786,Masdenverge,2008,1121,589,532,134,747,240
417,081167,"Masies de Roda, les",2008,745,370,375,94,523,128
418,081173,"Masies de Voltregà, les",2008,3189,1574,1615,566,2163,460
419,430799,Masllorenç,2008,517,268,249,68,328,121
420,081189,"Masnou, el",2008,22066,10613,11453,3296,15372,3398
421,430803,"Masó, la",2008,291,146,145,31,188,72
422,430810,Maspujols,2008,565,295,270,98,341,126
423,081192,Masquefa,2008,8029,4075,3954,1602,5535,892
424,430825,"Masroig, el",2008,550,279,271,61,332,157
425,251312,Massalcoreig,2008,614,327,287,63,394,157
426,171019,Massanes,2008,709,375,334,96,509,104
427,251327,Massoteres,2008,224,121,103,40,139,45
428,081206,Matadepera,2008,8460,4268,4192,1825,5670,965
429,081213,Mataró,2008,119780,60036,59744,18191,83990,17599
430,081228,Mediona,2008,2307,1193,1114,357,1488,462
431,251348,Menàrguens,2008,843,436,407,88,509,246
432,170998,Meranges,2008,83,51,32,5,56,22
433,171058,Mieres,2008,346,181,165,55,216,75
434,430831,"Milà, el",2008,177,85,92,23,110,44
435,251351,Miralcamp,2008,1405,697,708,185,952,268
436,430846,Miravet,2008,799,425,374,84,524,191
437,081385,Moià,2008,5661,2865,2796,998,3776,887
438,430859,"Molar, el",2008,293,163,130,27,175,91
439,081234,Molins de Rei,2008,23828,11700,12128,3837,16651,3340
440,251370,Mollerussa,2008,13675,7157,6518,2338,9662,1675
441,171061,Mollet de Peralada,2008,171,86,85,16,105,50
442,081249,Mollet del Vallès,2008,51912,26196,25716,8540,37208,6164
443,171077,Molló,2008,349,171,178,29,230,90
444,251364,"Molsosa, la",2008,126,63,63,8,85,33
445,081287,Monistrol de Calders,2008,701,357,344,102,466,133
446,081271,Monistrol de Montserrat,2008,2983,1547,1436,376,2085,522
447,171096,Montagut i Oix,2008,960,500,460,141,624,195
448,430862,Montblanc,2008,7069,3635,3434,988,4858,1223
449,430884,Montbrió del Camp,2008,2061,1051,1010,291,1414,356
450,081252,Montcada i Reixac,2008,32750,16405,16345,5314,22915,4521
451,081304,Montclar,2008,117,55,62,18,70,29
452,251399,Montellà i Martinet,2008,629,340,289,74,416,139
453,081311,Montesquiu,2008,880,446,434,109,586,185
454,251403,Montferrer i Castellbò,2008,1070,593,477,138,783,149
455,430897,Montferri,2008,350,185,165,67,218,65
456,251386,Montgai,2008,731,374,357,76,435,220
457,081265,Montgat,2008,10059,4955,5104,1515,7283,1261
458,081326,Montmajor,2008,472,248,224,52,307,113
459,081332,Montmaneu,2008,200,107,93,18,130,52
460,430901,"Montmell, el",2008,1420,766,654,218,1013,189
461,081350,Montmeló,2008,8870,4396,4474,1413,6212,1245
462,251425,Montoliu de Lleida,2008,491,249,242,52,324,115
463,251410,Montoliu de Segarra,2008,188,109,79,11,119,58
464,251431,Montornès de Segarra,2008,107,50,57,7,66,34
465,081363,Montornès del Vallès,2008,15058,7779,7279,2552,10727,1779
466,430918,Mont-ral,2008,175,95,80,17,138,20
467,171100,Mont-ras,2008,1838,956,882,274,1312,252
468,430923,Mont-roig del Camp,2008,11131,5843,5288,1608,7948,1575
469,081379,Montseny,2008,320,171,149,30,221,69
470,430939,Móra d'Ebre,2008,5500,2715,2785,873,3628,999
471,430944,Móra la Nova,2008,3212,1650,1562,469,2149,594
472,430957,"Morell, el",2008,3080,1611,1469,505,2193,382
473,430960,"Morera de Montsant, la",2008,153,90,63,20,101,32
474,081290,Muntanyola,2008,548,281,267,115,385,48
475,081398,Mura,2008,237,128,109,30,168,39
476,251459,Nalec,2008,93,47,46,5,59,29
477,250254,Naut Aran,2008,1731,900,831,249,1288,194
478,081402,Navarcles,2008,5818,2875,2943,803,3979,1036
479,081419,Navàs,2008,6133,3066,3067,890,4030,1213
480,171117,Navata,2008,1080,546,534,200,683,197
481,251462,Navès,2008,274,134,140,36,169,69
482,081424,"Nou de Berguedà, la",2008,156,78,78,24,88,44
483,430976,"Nou de Gaià, la",2008,475,240,235,86,301,88
484,430982,Nulles,2008,415,211,204,51,277,87
485,251484,Odèn,2008,290,171,119,14,200,76
486,081430,Òdena,2008,3272,1669,1603,566,2224,482
487,171122,Ogassa,2008,266,158,108,27,183,56
488,081458,Olèrdola,2008,3375,1755,1620,639,2332,404
489,081461,Olesa de Bonesvalls,2008,1662,880,782,265,1193,204
490,081477,Olesa de Montserrat,2008,22914,11568,11346,3989,15816,3109
491,251497,Oliana,2008,1949,970,979,225,1281,443
492,251500,Oliola,2008,262,149,113,31,178,53
493,251517,Olius,2008,789,403,386,142,539,108
494,081483,Olivella,2008,3123,1664,1459,613,2270,240
495,081496,Olost,2008,1199,600,599,149,766,284
496,171143,Olot,2008,32903,16593,16310,4658,21842,6403
497,251522,"Oluges, les",2008,186,103,83,11,117,58
498,081445,Olvan,2008,905,446,459,104,566,235
499,251538,"Omellons, els",2008,241,127,114,21,152,68
500,251543,"Omells de na Gaia, els",2008,146,78,68,12,92,42
501,171156,Ordis,2008,375,202,173,63,247,65
502,251556,Organyà,2008,946,475,471,88,587,271
503,081509,Orís,2008,301,150,151,45,204,52
504,081516,Oristà,2008,591,292,299,46,395,150
505,081521,Orpí,2008,193,101,92,23,134,36
506,081537,Òrrius,2008,635,328,307,110,433,92
507,251569,Os de Balaguer,2008,998,526,472,153,626,219
508,171169,Osor,2008,361,185,176,25,216,120
509,251575,Ossó de Sió,2008,227,117,110,27,140,60
510,081542,Pacs del Penedès,2008,855,438,417,139,595,121
511,081555,Palafolls,2008,8368,4233,4135,1543,5952,873
512,171175,Palafrugell,2008,22109,11249,10860,3462,15197,3450
513,171181,Palamós,2008,17766,8797,8969,2666,12187,2913
514,251581,"Palau d'Anglesola, el",2008,2050,1025,1025,310,1345,395
515,171194,Palau de Santa Eulàlia,2008,105,60,45,8,76,21
516,171215,Palau-sator,2008,289,151,138,29,188,72
517,171208,Palau-saverdera,2008,1423,722,701,183,929,311
518,081568,Palau-solità i Plegamans,2008,13916,7027,6889,2531,9890,1495
519,431009,"Pallaresos, els",2008,3828,1961,1867,902,2689,237
520,081574,Pallejà,2008,11011,5546,5465,2077,7732,1202
521,430995,"Palma d'Ebre, la",2008,416,201,215,39,235,142
522,089058,"Palma de Cervelló, la",2008,3027,1501,1526,517,2179,331
523,171236,Palol de Revardit,2008,478,243,235,90,309,79
524,171241,Pals,2008,2698,1368,1330,311,1796,591
525,081580,"Papiol, el",2008,3828,1927,1901,596,2706,526
526,171254,Pardines,2008,168,92,76,24,96,48
527,081593,Parets del Vallès,2008,17224,8871,8353,2950,12262,2012
528,171267,Parlavà,2008,383,195,188,34,266,83
529,431016,Passanant i Belltall,2008,175,96,79,7,108,60
530,171289,Pau,2008,586,301,285,83,393,110
531,431021,Paüls,2008,626,311,315,62,391,173
532,171292,Pedret i Marzà,2008,163,85,78,22,107,34
533,251641,Penelles,2008,551,298,253,53,343,155
534,171306,"Pera, la",2008,445,225,220,62,283,100
535,081607,Perafita,2008,407,204,203,54,249,104
536,431037,Perafort,2008,1099,581,518,171,812,116
537,171328,Peralada,2008,1762,892,870,275,1170,317
538,251654,Peramola,2008,374,199,175,37,228,109
539,431042,"Perelló, el",2008,3140,1694,1446,375,2090,675
540,081614,Piera,2008,14025,7217,6808,2528,9449,2048
541,431055,"Piles, les",2008,220,120,100,26,153,41
542,081635,Pineda de Mar,2008,25931,13175,12756,3854,18229,3848
543,431068,"Pinell de Brai, el",2008,1132,581,551,129,704,299
544,251667,Pinell de Solsonès,2008,212,115,97,26,133,53
545,251673,Pinós,2008,320,176,144,35,208,77
546,431074,Pira,2008,504,252,252,95,307,102
547,431080,"Pla de Santa Maria, el",2008,2213,1155,1058,346,1482,385
548,081640,"Pla del Penedès, el",2008,1004,514,490,145,648,211
549,171334,"Planes d'Hostoles, les",2008,1795,908,887,212,1098,485
550,171349,Planoles,2008,282,149,133,25,191,66
551,259118,"Plans de Sió, els",2008,595,310,285,59,346,190
552,251689,"Poal, el",2008,649,339,310,71,414,164
553,251692,"Pobla de Cérvoles, la",2008,245,131,114,29,151,65
554,081653,"Pobla de Claramunt, la",2008,2235,1163,1072,384,1497,354
555,081666,"Pobla de Lillet, la",2008,1338,663,675,96,853,389
556,431093,"Pobla de Mafumet, la",2008,2108,1066,1042,357,1562,189
557,431107,"Pobla de Massaluca, la",2008,400,205,195,32,233,135
558,431114,"Pobla de Montornès, la",2008,2741,1462,1279,423,1915,403
559,251713,"Pobla de Segur, la",2008,3151,1595,1556,368,1980,803
560,431129,Poboleda,2008,369,205,164,31,248,90
561,081672,Polinyà,2008,7403,3799,3604,1382,5484,537
562,431135,"Pont d'Armentera, el",2008,606,314,292,70,384,152
563,250306,"Pont de Bar, el",2008,189,110,79,25,113,51
564,171352,Pont de Molins,2008,490,260,230,63,347,80
565,251734,"Pont de Suert, el",2008,2553,1332,1221,337,1743,473
566,081825,"Pont de Vilomara i Rocafort, el",2008,3635,1885,1750,602,2530,503
567,431418,Pontils,2008,152,84,68,10,106,36
568,081688,Pontons,2008,558,302,256,78,386,94
569,171365,Pontós,2008,244,133,111,33,152,59
570,251728,Ponts,2008,2749,1397,1352,369,1818,562
571,171371,Porqueres,2008,4332,2163,2169,756,2970,606
572,431140,Porrera,2008,464,248,216,54,295,115
573,171404,"Port de la Selva, el",2008,1029,535,494,112,707,210
574,171387,Portbou,2008,1306,648,658,94,820,392
575,251749,"Portella, la",2008,816,444,372,78,604,134
576,431153,Pradell de la Teixeta,2008,164,80,84,12,108,44
577,431166,Prades,2008,683,353,330,76,449,158
578,431172,Prat de Comte,2008,194,101,93,21,112,61
579,081691,"Prat de Llobregat, el",2008,62899,31425,31474,9065,44833,9001
580,431188,Pratdip,2008,833,446,387,91,515,227
581,081712,Prats de Lluçanès,2008,2719,1344,1375,360,1780,579
582,081705,"Prats de Rei, els",2008,540,273,267,43,372,125
583,251752,Prats i Sansor,2008,231,130,101,33,163,35
584,251765,Preixana,2008,413,209,204,43,234,136
585,251771,Preixens,2008,505,258,247,63,274,168
586,082303,Premià de Dalt,2008,9867,4910,4957,1646,6928,1293
587,081727,Premià de Mar,2008,27545,13694,13851,4251,19314,3980
588,171390,"Preses, les",2008,1708,842,866,274,1154,280
589,251790,Prullans,2008,236,123,113,26,147,63
590,171411,Puigcerdà,2008,9365,4855,4510,1582,6539,1244
591,081748,Puigdàlber,2008,484,237,247,73,338,73
592,251804,Puiggròs,2008,311,164,147,49,189,73
593,431191,Puigpelat,2008,953,504,449,180,664,109
594,081751,Puig-reig,2008,4326,2122,2204,487,2771,1068
595,251811,Puigverd d'Agramunt,2008,284,163,121,32,185,67
596,251826,Puigverd de Lleida,2008,1356,693,663,218,881,257
597,081764,Pujalt,2008,199,100,99,20,133,46
598,081770,"Quar, la",2008,60,35,25,2,44,14
599,171426,Quart,2008,2762,1419,1343,448,1990,324
600,170433,Queralbs,2008,192,110,82,23,113,56
601,431205,Querol,2008,549,297,252,72,396,81
602,171432,Rabós,2008,194,98,96,22,130,42
603,081786,Rajadell,2008,492,268,224,71,334,87
604,431212,Rasquera,2008,952,485,467,111,585,256
605,171447,Regencós,2008,313,176,137,43,203,67
606,081799,Rellinars,2008,685,353,332,100,479,106
607,431227,Renau,2008,94,44,50,7,74,13
608,431233,Reus,2008,107770,53845,53925,17595,75071,15104
609,251832,Rialp,2008,656,346,310,82,485,89
610,431248,"Riba, la",2008,720,395,325,76,477,167
611,431251,Riba-roja d'Ebre,2008,1328,699,629,119,861,348
612,259059,Ribera d'Ondara,2008,466,246,220,44,293,129
613,251850,Ribera d'Urgellet,2008,991,533,458,126,664,201
614,171450,Ribes de Freser,2008,2006,986,1020,188,1264,554
615,171463,Riells i Viabrea,2008,3659,1917,1742,713,2614,332
616,431264,"Riera de Gaià, la",2008,1540,790,750,268,1062,210
617,251863,Riner,2008,300,152,148,43,193,64
618,171479,Ripoll,2008,11012,5473,5539,1342,7303,2367
619,081803,Ripollet,2008,36255,18512,17743,6062,25806,4387
620,259139,Riu de Cerdanya,2008,116,61,55,12,90,14
621,171485,Riudarenes,2008,2002,1043,959,321,1374,307
622,171498,Riudaura,2008,426,213,213,44,299,83
623,431270,Riudecanyes,2008,1041,532,509,169,679,193
624,431286,Riudecols,2008,1218,644,574,151,848,219
625,171501,Riudellots de la Selva,2008,1940,1009,931,302,1348,290
626,431299,Riudoms,2008,6385,3266,3119,1057,4268,1060
627,171518,Riumors,2008,216,113,103,31,138,47
628,081810,"Roca del Vallès, la",2008,10032,5071,4961,1792,7061,1179
629,431303,Rocafort de Queralt,2008,284,155,129,33,178,73
630,431310,Roda de Berà,2008,6002,3174,2828,912,4266,824
631,081831,Roda de Ter,2008,5863,2874,2989,919,3906,1038
632,431325,Rodonyà,2008,520,282,238,88,329,103
633,431331,Roquetes,2008,7987,4191,3796,1211,5473,1303
634,171523,Roses,2008,19463,9968,9495,3177,13572,2714
635,251898,Rosselló,2008,2752,1426,1326,473,1912,367
636,431346,"Rourell, el",2008,376,190,186,67,233,76
637,081846,Rubí,2008,71927,36174,35753,11872,51520,8535
638,081859,Rubió,2008,186,95,91,27,120,39
639,171539,Rupià,2008,240,124,116,32,155,53
640,089019,Rupit i Pruit,2008,329,165,164,30,220,79
641,081878,Sabadell,2008,203969,99947,104022,30788,139679,33502
642,081884,Sagàs,2008,138,71,67,26,83,29
643,251902,Salàs de Pallars,2008,341,177,164,13,217,111
644,081901,Saldes,2008,344,196,148,34,245,65
645,171544,Sales de Llierca,2008,132,69,63,26,96,10
646,081918,Sallent,2008,7061,3428,3633,902,4516,1643
647,431359,Salomó,2008,482,257,225,65,304,113
648,439057,Salou,2008,25754,14019,11735,3672,19949,2133
649,171557,Salt,2008,28763,15458,13305,5074,20401,3288
650,251919,Sanaüja,2008,458,237,221,63,266,129
651,081944,Sant Adrià de Besòs,2008,33223,16335,16888,5453,22351,5419
652,081957,Sant Agustí de Lluçanès,2008,105,55,50,13,71,21
653,081960,Sant Andreu de la Barca,2008,26279,13504,12775,4838,18981,2460
654,081976,Sant Andreu de Llavaneres,2008,10009,5091,4918,1900,6813,1296
655,171576,Sant Andreu Salou,2008,157,75,82,27,92,38
656,171833,Sant Aniol de Finestres,2008,319,170,149,48,213,58
657,081982,Sant Antoni de Vilamajor,2008,5332,2686,2646,995,3683,654
658,081995,Sant Bartomeu del Grau,2008,961,503,458,154,663,144
659,082009,Sant Boi de Llobregat,2008,81335,40386,40949,12116,57173,12046
660,082016,Sant Boi de Lluçanès,2008,573,294,279,57,367,149
661,431362,Sant Carles de la Ràpita,2008,15307,7706,7601,2216,10379,2712
662,082037,Sant Cebrià de Vallalta,2008,3208,1668,1540,552,2345,311
663,082021,Sant Celoni,2008,16586,8307,8279,2676,11398,2512
664,082042,Sant Climent de Llobregat,2008,3676,1853,1823,691,2571,414
665,171582,Sant Climent Sescebes,2008,501,265,236,69,307,125
666,082055,Sant Cugat del Vallès,2008,76274,37345,38929,16352,52162,7760
667,082068,Sant Cugat Sesgarrigues,2008,923,479,444,163,593,167
668,251961,Sant Esteve de la Sarga,2008,149,92,57,6,98,45
669,082074,Sant Esteve de Palautordera,2008,2364,1155,1209,528,1587,249
670,082080,Sant Esteve Sesrovires,2008,6903,3495,3408,1261,4863,779
671,171595,Sant Feliu de Buixalleu,2008,803,429,374,108,550,145
672,082107,Sant Feliu de Codines,2008,5620,2853,2767,931,3804,885
673,171609,Sant Feliu de Guíxols,2008,21726,10888,10838,3246,14919,3561
674,082114,Sant Feliu de Llobregat,2008,42628,20821,21807,6835,29995,5798
675,171616,Sant Feliu de Pallerols,2008,1389,687,702,212,896,281
676,082129,Sant Feliu Sasserra,2008,633,322,311,79,414,140
677,171621,Sant Ferriol,2008,216,121,95,39,138,39
678,082093,Sant Fost de Campsentelles,2008,7939,4029,3910,1263,5579,1097
679,082135,Sant Fruitós de Bages,2008,7782,3991,3791,1368,5457,957
680,171637,Sant Gregori,2008,3068,1554,1514,540,2113,415
681,251924,Sant Guim de Freixenet,2008,1104,546,558,147,714,243
682,251977,Sant Guim de la Plana,2008,184,99,85,27,109,48
683,171642,Sant Hilari Sacalm,2008,5744,2983,2761,760,3953,1031
684,082153,Sant Hipòlit de Voltregà,2008,3431,1728,1703,551,2220,660
685,081939,Sant Iscle de Vallalta,2008,1235,647,588,229,832,174
686,439023,Sant Jaume d'Enveja,2008,3479,1778,1701,449,2265,765
687,082166,Sant Jaume de Frontanyà,2008,29,14,15,4,20,5
688,171655,Sant Jaume de Llierca,2008,809,410,399,78,500,231
689,431378,Sant Jaume dels Domenys,2008,2348,1233,1115,387,1587,374
690,171674,Sant Joan de les Abadesses,2008,3589,1803,1786,385,2317,887
691,171680,Sant Joan de Mollet,2008,515,255,260,82,330,103
692,082188,Sant Joan de Vilatorrada,2008,10661,5417,5244,1722,7346,1593
693,082172,Sant Joan Despí,2008,31647,15559,16088,5438,22199,4010
694,171851,Sant Joan les Fonts,2008,2751,1408,1343,297,1860,594
695,171668,Sant Jordi Desvalls,2008,626,315,311,75,404,147
696,089030,Sant Julià de Cerdanyola,2008,257,139,118,41,156,60
697,171693,Sant Julià de Ramis,2008,3133,1625,1508,560,2212,361
698,082205,Sant Julià de Vilatorta,2008,2933,1421,1512,550,1983,400
699,179032,Sant Julià del Llor i Bonmatí,2008,1225,627,598,183,862,180
700,082212,Sant Just Desvern,2008,15365,7305,8060,2472,10552,2341
701,082227,Sant Llorenç d'Hortons,2008,2302,1188,1114,392,1592,318
702,171714,Sant Llorenç de la Muga,2008,218,112,106,27,144,47
703,251930,Sant Llorenç de Morunys,2008,1071,552,519,123,695,253
704,082233,Sant Llorenç Savall,2008,2357,1184,1173,359,1518,480
705,082251,Sant Martí d'Albars,2008,112,59,53,11,74,27
706,082248,Sant Martí de Centelles,2008,997,530,467,170,694,133
707,171729,Sant Martí de Llémena,2008,532,279,253,93,355,84
708,259025,Sant Martí de Riucorb,2008,697,368,329,61,416,220
709,082264,Sant Martí de Tous,2008,1150,579,571,216,713,221
710,082270,Sant Martí Sarroca,2008,3077,1563,1514,489,2031,557
711,082286,Sant Martí Sesgueioles,2008,376,192,184,55,243,78
712,171735,Sant Martí Vell,2008,242,128,114,47,153,42
713,082299,Sant Mateu de Bages,2008,673,351,322,64,408,201
714,171740,Sant Miquel de Campmajor,2008,243,127,116,31,170,42
715,171753,Sant Miquel de Fluvià,2008,718,363,355,98,487,133
716,171766,Sant Mori,2008,179,86,93,18,140,21
717,171772,Sant Pau de Segúries,2008,699,349,350,73,449,177
718,082310,Sant Pere de Ribes,2008,28066,14229,13837,4886,20105,3075
719,082325,Sant Pere de Riudebitlles,2008,2359,1194,1165,375,1561,423
720,082331,Sant Pere de Torelló,2008,2322,1167,1155,312,1571,439
721,082346,Sant Pere de Vilamajor,2008,3891,1952,1939,761,2659,471
722,171788,Sant Pere Pescador,2008,1970,1065,905,300,1372,298
723,081897,Sant Pere Sallavinera,2008,171,88,83,16,106,49
724,082359,Sant Pol de Mar,2008,4970,2520,2450,800,3450,720
725,082362,Sant Quintí de Mediona,2008,2167,1102,1065,366,1402,399
726,082378,Sant Quirze de Besora,2008,2215,1081,1134,291,1399,525
727,082384,Sant Quirze del Vallès,2008,18225,8988,9237,3577,13033,1615
728,082397,Sant Quirze Safaja,2008,617,317,300,117,447,53
729,251945,Sant Ramon,2008,549,299,250,54,339,156
730,082401,Sant Sadurní d'Anoia,2008,11909,5895,6014,2039,8074,1796
731,082418,Sant Sadurní d'Osormort,2008,91,53,38,13,59,19
732,080983,Sant Salvador de Guardiola,2008,3044,1548,1496,567,2083,394
733,082628,Sant Vicenç de Castellet,2008,8275,4115,4160,1096,5626,1553
734,082649,Sant Vicenç de Montalt,2008,5434,2769,2665,1196,3641,597
735,082652,Sant Vicenç de Torelló,2008,1977,949,1028,328,1267,382
736,082634,Sant Vicenç dels Horts,2008,27461,13791,13670,4659,19271,3531
737,431384,Santa Bàrbara,2008,3965,2034,1931,544,2606,815
738,082439,Santa Cecília de Voltregà,2008,194,101,93,29,129,36
739,082444,Santa Coloma de Cervelló,2008,7659,3814,3845,1592,5310,757
740,171805,Santa Coloma de Farners,2008,11412,5889,5523,1843,7834,1735
741,082457,Santa Coloma de Gramenet,2008,117336,59829,57507,15751,82799,18786
742,431397,Santa Coloma de Queralt,2008,3128,1588,1540,529,1993,606
743,171812,Santa Cristina d'Aro,2008,4713,2405,2308,810,3254,649
744,082460,Santa Eugènia de Berga,2008,2235,1172,1063,283,1632,320
745,082476,Santa Eulàlia de Riuprimer,2008,1004,512,492,150,692,162
746,082482,Santa Eulàlia de Ronçana,2008,6669,3350,3319,1168,4547,954
747,082495,Santa Fe del Penedès,2008,391,199,192,83,260,48
748,171827,Santa Llogaia d'Àlguema,2008,317,169,148,51,222,44
749,082508,Santa Margarida de Montbui,2008,9778,4913,4865,1614,6787,1377
750,082515,Santa Margarida i els Monjos,2008,6768,3511,3257,1192,4832,744
751,082589,Santa Maria d'Oló,2008,1089,551,538,135,725,229
752,082536,Santa Maria de Besora,2008,169,85,84,16,106,47
753,082567,Santa Maria de Martorelles,2008,813,416,397,135,563,115
754,082554,Santa Maria de Merlès,2008,156,77,79,29,98,29
755,082573,Santa Maria de Miralles,2008,130,63,67,14,90,26
756,082592,Santa Maria de Palautordera,2008,8614,4445,4169,1497,5972,1145
757,431401,Santa Oliva,2008,3133,1655,1478,548,2100,485
758,171848,Santa Pau,2008,1584,800,784,187,1105,292
759,082606,Santa Perpètua de Mogoda,2008,24325,12472,11853,4328,17430,2567
760,082613,Santa Susanna,2008,3119,1587,1532,554,2168,397
761,081923,Santpedor,2008,6787,3392,3395,1103,4732,952
762,431423,Sarral,2008,1686,870,816,233,1121,332
763,171864,Sarrià de Ter,2008,4320,2151,2169,635,2940,745
764,252017,Sarroca de Bellera,2008,136,79,57,3,88,45
765,252000,Sarroca de Lleida,2008,438,232,206,35,278,125
766,171870,"Saus, Camallera i Llampaies",2008,761,369,392,97,510,154
767,431439,Savallà del Comtat,2008,72,39,33,6,43,23
768,431444,"Secuita, la",2008,1466,753,713,221,1038,207
769,171886,"Selva de Mar, la",2008,213,106,107,20,147,46
770,431457,"Selva del Camp, la",2008,5238,2652,2586,1003,3460,775
771,431460,Senan,2008,59,39,20,10,39,10
772,430445,"Sénia, la",2008,6225,3218,3007,887,4310,1028
773,252022,Senterada,2008,141,75,66,11,104,26
774,250352,"Sentiu de Sió, la",2008,512,251,261,41,346,125
775,082671,Sentmenat,2008,7633,3837,3796,1346,5413,874
776,171903,Serinyà,2008,1101,570,531,170,742,189
777,252043,Seròs,2008,1876,1062,814,186,1247,443
778,171910,Serra de Daró,2008,197,114,83,24,123,50
779,171925,Setcases,2008,165,91,74,11,108,46
780,252038,"Seu d'Urgell, la",2008,12986,6431,6555,1971,8917,2098
781,082690,Seva,2008,3279,1679,1600,549,2228,502
782,252056,Sidamon,2008,727,369,358,101,499,127
783,171931,Sils,2008,4850,2499,2351,854,3380,616
784,082704,Sitges,2008,27070,13475,13595,4204,19123,3743
785,170524,Siurana,2008,211,110,101,28,127,56
786,082711,Sobremunt,2008,102,51,51,15,68,19
787,252069,"Soleràs, el",2008,419,226,193,56,249,114
788,431476,Solivella,2008,685,350,335,99,402,184
789,252075,Solsona,2008,9166,4656,4510,1508,6093,1565
790,082726,Sora,2008,174,95,79,20,120,34
791,252081,Soriguera,2008,360,190,170,43,242,75
792,252094,Sort,2008,2373,1203,1170,366,1618,389
793,252108,Soses,2008,1662,884,778,212,1152,298
794,082732,Subirats,2008,3052,1544,1508,509,1971,572
795,252115,Sudanell,2008,863,479,384,88,600,175
796,252120,Sunyer,2008,296,151,145,35,185,76
797,082747,Súria,2008,6454,3168,3286,831,4149,1474
798,171946,Susqueda,2008,125,69,56,11,88,26
799,082763,Tagamanent,2008,303,158,145,56,195,52
800,082779,Talamanca,2008,152,85,67,23,114,15
801,252154,Talarn,2008,403,207,196,57,255,91
802,252167,Talavera,2008,304,168,136,31,196,77
803,171959,"Tallada d'Empordà, la",2008,401,208,193,53,243,105
804,082785,Taradell,2008,5929,3065,2864,956,3998,975
805,431482,Tarragona,2008,137536,68213,69323,21526,95961,20049
806,252173,Tàrrega,2008,16149,8169,7980,2658,11101,2390
807,252189,Tarrés,2008,106,52,54,7,71,28
808,252192,Tarroja de Segarra,2008,180,95,85,22,108,50
809,082750,Tavèrnoles,2008,318,161,157,42,230,46
810,082802,Tavertet,2008,148,80,68,10,103,35
811,082819,Teià,2008,5987,3056,2931,944,4186,857
812,252206,Térmens,2008,1521,786,735,174,1011,336
813,171962,Terrades,2008,254,129,125,30,171,53
814,082798,Terrassa,2008,206245,102875,103370,33133,142912,30200
815,082824,Tiana,2008,7505,3670,3835,1382,5298,825
816,252213,Tírvia,2008,135,72,63,10,94,31
817,252228,Tiurana,2008,78,40,38,12,44,22
818,431495,Tivenys,2008,948,486,462,110,564,274
819,431508,Tivissa,2008,1841,941,900,193,1189,459
820,082830,Tona,2008,7805,3909,3896,1386,5300,1119
821,252234,Torà,2008,1370,719,651,176,925,269
822,082845,Tordera,2008,14800,7585,7215,2393,10265,2142
823,082858,Torelló,2008,13680,6791,6889,1973,9436,2271
824,252249,"Torms, els",2008,180,95,85,19,102,59
825,252252,Tornabous,2008,847,449,398,87,534,226
826,252271,"Torre de Cabdella, la",2008,808,408,400,56,534,218
827,082861,"Torre de Claramunt, la",2008,3615,1885,1730,650,2587,378
828,431515,"Torre de Fontaubella, la",2008,140,72,68,10,81,49
829,431520,"Torre de l'Espanyol, la",2008,673,352,321,77,419,177
830,252265,Torrebesses,2008,298,155,143,28,178,92
831,431536,Torredembarra,2008,15056,7522,7534,2322,10517,2217
832,252287,Torrefarrera,2008,3697,1888,1809,685,2629,383
833,259078,Torrefeta i Florejacs,2008,633,329,304,71,387,175
834,252304,Torregrossa,2008,2237,1137,1100,249,1429,559
835,252311,Torrelameu,2008,651,360,291,60,438,153
836,082877,Torrelavit,2008,1290,703,587,138,888,264
837,082883,Torrelles de Foix,2008,2432,1293,1139,385,1616,431
838,082896,Torrelles de Llobregat,2008,5208,2609,2599,1025,3686,497
839,171978,Torrent,2008,184,95,89,19,128,37
840,252326,Torres de Segre,2008,2055,1073,982,272,1364,419
841,252332,Torre-serona,2008,353,183,170,38,234,81
842,171984,Torroella de Fluvià,2008,658,351,307,93,473,92
843,171997,Torroella de Montgrí,2008,11441,5832,5609,1792,7947,1702
844,431541,Torroja del Priorat,2008,169,94,75,14,109,46
845,172001,Tortellà,2008,758,378,380,91,459,208
846,431554,Tortosa,2008,35734,18429,17305,4867,24581,6286
847,172018,Toses,2008,150,90,60,18,99,33
848,172023,Tossa de Mar,2008,5845,2982,2863,817,4104,924
849,252347,Tremp,2008,6190,3088,3102,831,3909,1450
850,172044,Ullà,2008,1067,622,445,158,773,136
851,082900,Ullastrell,2008,1761,900,861,351,1210,200
852,172057,Ullastret,2008,227,117,110,36,146,45
853,431567,Ulldecona,2008,6987,3621,3366,950,4741,1296
854,431573,Ulldemolins,2008,473,262,211,33,273,167
855,172039,Ultramort,2008,193,112,81,13,122,58
856,172060,Urús,2008,196,102,94,25,132,39
857,082917,Vacarisses,2008,5787,3007,2780,1225,3979,583
858,170144,"Vajol, la",2008,102,61,41,10,74,18
859,172076,"Vall d'en Bas, la",2008,2735,1376,1359,363,1770,602
860,172082,"Vall de Bianya, la",2008,1307,660,647,207,870,230
861,250432,"Vall de Boí, la",2008,1080,589,491,113,806,161
862,259010,Vall de Cardós,2008,402,214,188,41,268,93
863,082922,Vallbona d'Anoia,2008,1387,713,674,205,967,215
864,252385,Vallbona de les Monges,2008,251,128,123,16,149,86
865,082938,Vallcebre,2008,269,150,119,22,172,75
866,431589,Vallclara,2008,126,70,56,18,73,35
867,252402,Vallfogona de Balaguer,2008,1735,883,852,214,1211,310
868,171707,Vallfogona de Ripollès,2008,225,118,107,28,144,53
869,431592,Vallfogona de Riucorb,2008,129,76,53,1,69,59
870,082943,Vallgorguina,2008,2404,1242,1162,469,1692,243
871,082956,Vallirana,2008,13752,6889,6863,2469,9596,1687
872,172095,Vall-llobrega,2008,825,433,392,175,579,71
873,431606,Vallmoll,2008,1599,847,752,225,1157,217
874,082969,Vallromanes,2008,2206,1120,1086,505,1491,210
875,431613,Valls,2008,24710,12486,12224,3858,16950,3902
876,259062,"Valls d'Aguilar, les",2008,305,169,136,20,204,81
877,252398,"Valls de Valira, les",2008,861,478,383,76,620,165
878,431628,Vandellòs i l'Hospitalet de l'Infant,2008,5653,2875,2778,821,4001,831
879,259097,"Vansa i Fórnols, la",2008,188,104,84,13,121,54
880,082975,Veciana,2008,170,92,78,24,102,44
881,431634,"Vendrell, el",2008,34931,17692,17239,5836,24625,4470
882,172109,Ventalló,2008,730,389,341,74,492,164
883,252424,Verdú,2008,1029,506,523,128,606,295
884,172116,Verges,2008,1195,602,593,156,764,275
885,431649,Vespella de Gaià,2008,395,217,178,50,297,48
886,082981,Vic,2008,38964,19596,19368,6426,26384,6154
887,172121,Vidrà,2008,178,90,88,23,124,31
888,172137,Vidreres,2008,7316,3819,3497,1255,5022,1039
889,252430,Vielha e Mijaran,2008,5633,3038,2595,814,4340,479
890,431652,Vilabella,2008,808,409,399,102,521,185
891,172142,Vilabertran,2008,860,455,405,117,567,176
892,172155,Vilablareix,2008,2277,1129,1148,378,1676,223
893,082994,Vilada,2008,534,266,268,47,347,140
894,172174,Viladamat,2008,439,231,208,56,289,94
895,172168,Viladasens,2008,207,104,103,24,137,46
896,083015,Viladecans,2008,62573,31429,31144,10523,44502,7548
897,083008,Viladecavalls,2008,7170,3602,3568,1396,5102,672
898,172180,Vilademuls,2008,781,407,374,97,513,171
899,172207,Viladrau,2008,1066,554,512,168,725,173
900,172214,Vilafant,2008,5314,2640,2674,901,3766,647
901,083054,Vilafranca del Penedès,2008,37364,18662,18702,5892,25909,5563
902,252445,Vilagrassa,2008,449,236,213,59,279,111
903,172235,Vilajuïga,2008,1138,570,568,195,743,200
904,431750,Vilalba dels Arcs,2008,723,381,342,68,431,224
905,083067,Vilalba Sasserra,2008,585,299,286,105,404,76
906,252458,Vilaller,2008,699,405,294,64,514,121
907,172240,Vilallonga de Ter,2008,477,262,215,48,312,117
908,431665,Vilallonga del Camp,2008,1772,901,871,269,1261,242
909,172253,Vilamacolum,2008,318,168,150,40,216,62
910,172266,Vilamalla,2008,1115,599,516,178,808,129
911,172272,Vilamaniscle,2008,173,94,79,30,114,29
912,252477,Vilamòs,2008,187,99,88,23,145,19
913,172288,Vilanant,2008,348,171,177,52,231,65
914,431671,Vilanova d'Escornalbou,2008,531,290,241,64,371,96
915,252483,Vilanova de Bellpuig,2008,1157,605,552,131,720,306
916,252496,Vilanova de l'Aguda,2008,227,116,111,27,124,76
917,252542,Vilanova de la Barca,2008,1181,581,600,135,799,247
918,252509,Vilanova de Meià,2008,405,215,190,32,246,127
919,431687,Vilanova de Prades,2008,145,79,66,14,90,41
920,083036,Vilanova de Sau,2008,331,152,179,38,232,61
921,252516,Vilanova de Segrià,2008,822,435,387,85,590,147
922,083020,Vilanova del Camí,2008,12428,6351,6077,2209,8764,1455
923,089024,Vilanova del Vallès,2008,4459,2296,2163,932,3071,456
924,083073,Vilanova i la Geltrú,2008,64905,32079,32826,9950,44813,10142
925,431690,Vilaplana,2008,609,311,298,60,402,147
926,431704,Vila-rodona,2008,1207,627,580,167,801,239
927,172305,Vila-sacra,2008,545,264,281,67,386,92
928,252521,Vila-sana,2008,667,335,332,90,434,143
929,431711,Vila-seca,2008,20039,10219,9820,3216,14764,2059
930,082140,Vilassar de Dalt,2008,8621,4281,4340,1321,5975,1325
931,082191,Vilassar de Mar,2008,19090,9282,9808,3249,13018,2823
932,172229,Vilaür,2008,142,72,70,19,92,31
933,431726,Vilaverd,2008,490,248,242,64,313,113
934,431732,"Vilella Alta, la",2008,112,64,48,12,69,31
935,431747,"Vilella Baixa, la",2008,205,107,98,29,133,43
936,172333,Vilobí d'Onyar,2008,2862,1516,1346,435,1982,445
937,083041,Vilobí del Penedès,2008,1109,579,530,173,748,188
938,172327,Vilopriu,2008,217,111,106,38,132,47
939,252537,"Vilosell, el",2008,203,101,102,9,129,65
940,431763,Vimbodí i Poblet,2008,1065,595,470,122,656,287
941,252555,Vinaixa,2008,602,309,293,53,397,152
942,431779,Vinebre,2008,496,251,245,54,325,117
943,431785,Vinyols i els Arcs,2008,1738,894,844,259,1222,257
944,083089,Viver i Serrateix,2008,193,100,93,31,119,43
945,430521,Xerta,2008,1307,651,656,159,804,344
946,000000,Catalunya,2008,7364078,3661028,3703050,1083951,5084172,1195955
0,250019,Abella de la Conca,2009,183,102,81,22,123,38
1,080018,Abrera,2009,11521,5974,5547,2003,8295,1223
2,250024,Àger,2009,575,304,271,48,350,177
3,250030,Agramunt,2009,5608,2866,2742,851,3744,1013
4,080023,Aguilar de Segarra,2009,257,135,122,36,167,54
5,170010,Agullana,2009,812,429,383,108,522,182
6,080142,Aiguafreda,2009,2464,1195,1269,366,1598,500
7,430017,Aiguamúrcia,2009,906,480,426,115,625,166
8,170025,Aiguaviva,2009,714,362,352,149,471,94
9,250387,Aitona,2009,2398,1256,1142,285,1560,553
10,250045,"Alamús, els",2009,740,384,356,85,488,167
11,250058,Alàs i Cerc,2009,391,206,185,44,244,103
12,250061,"Albagés, l'",2009,476,257,219,56,282,138
13,170031,Albanyà,2009,152,81,71,25,110,17
14,250077,Albatàrrec,2009,1872,985,887,296,1330,246
15,250083,Albesa,2009,1613,834,779,214,1060,339
16,250096,"Albi, l'",2009,836,423,413,95,525,216
17,430022,Albinyana,2009,2275,1146,1129,365,1518,392
18,430038,"Albiol, l'",2009,405,210,195,85,278,42
19,170046,Albons,2009,687,358,329,97,473,117
20,430043,Alcanar,2009,10570,5434,5136,1414,7254,1902
21,250100,Alcanó,2009,239,116,123,21,149,69
22,250117,Alcarràs,2009,7776,4060,3716,1159,5541,1076
23,250122,Alcoletge,2009,2677,1406,1271,392,1935,350
24,430056,Alcover,2009,5100,2606,2494,896,3439,765
25,439044,"Aldea, l'",2009,4063,2154,1909,504,2729,830
26,430069,Aldover,2009,984,488,496,122,616,246
27,430075,"Aleixar, l'",2009,898,444,454,153,576,169
28,080039,Alella,2009,9397,4637,4760,1526,6627,1244
29,430081,Alfara de Carles,2009,400,215,185,35,261,104
30,250138,Alfarràs,2009,3155,1635,1520,463,2024,668
31,250143,Alfés,2009,318,169,149,27,207,84
32,430094,Alforja,2009,1851,960,891,255,1248,348
33,250156,Algerri,2009,469,242,227,31,266,172
34,250169,Alguaire,2009,3165,1661,1504,431,2123,611
35,250175,Alins,2009,297,154,143,31,182,84
36,430108,Alió,2009,384,194,190,37,268,79
37,250194,Almacelles,2009,6506,3427,3079,885,4428,1193
38,250208,Almatret,2009,397,215,182,18,227,152
39,250215,Almenar,2009,3669,1929,1740,465,2431,773
40,430115,Almoster,2009,1357,677,680,275,935,147
41,250220,Alòs de Balaguer,2009,146,87,59,9,80,57
42,170062,Alp,2009,1735,918,817,246,1311,178
43,080044,Alpens,2009,311,168,143,52,203,56
44,250236,Alpicat,2009,6058,3032,3026,1130,4213,715
45,250241,Alt Àneu,2009,434,248,186,46,308,80
46,430120,Altafulla,2009,4685,2340,2345,828,3283,574
47,170078,Amer,2009,2304,1146,1158,256,1526,522
48,430136,"Ametlla de Mar, l'",2009,7592,3884,3708,1110,5078,1404
49,080057,"Ametlla del Vallès, l'",2009,7949,3991,3958,1604,5478,867
50,439060,"Ampolla, l'",2009,3118,1620,1498,327,2155,636
51,430141,Amposta,2009,21240,10821,10419,3325,14595,3320
52,170084,Anglès,2009,5569,2828,2741,870,3700,999
53,250273,Anglesola,2009,1351,681,670,179,860,312
54,250292,Arbeca,2009,2480,1282,1198,306,1551,623
55,430167,"Arboç, l'",2009,5441,2866,2575,979,3694,768
56,430154,Arbolí,2009,112,60,52,3,84,25
57,170097,Arbúcies,2009,6595,3508,3087,1089,4499,1007
58,080060,Arenys de Mar,2009,14627,7166,7461,2086,9833,2708
59,080076,Arenys de Munt,2009,8190,4085,4105,1438,5572,1180
60,170101,Argelaguer,2009,445,233,212,67,296,82
61,080082,Argençola,2009,240,139,101,30,168,42
62,430173,"Argentera, l'",2009,134,78,56,6,92,36
63,080095,Argentona,2009,11633,5784,5849,2085,7932,1616
64,170118,"Armentera, l'",2009,855,411,444,119,542,194
65,430189,Arnes,2009,488,251,237,34,271,183
66,250313,Arres,2009,68,46,22,5,53,10
67,250328,Arsèguel,2009,93,49,44,10,63,20
68,080109,Artés,2009,5433,2724,2709,838,3653,942
69,250334,Artesa de Lleida,2009,1517,794,723,251,952,314
70,250349,Artesa de Segre,2009,3869,1998,1871,557,2544,768
71,430192,Ascó,2009,1608,826,782,166,1064,378
72,250365,Aspa,2009,251,128,123,28,141,82
73,250371,"Avellanes i Santa Linya, les",2009,467,263,204,42,281,144
74,080116,Avià,2009,2206,1109,1097,341,1433,432
75,080121,Avinyó,2009,2289,1144,1145,356,1447,486
76,170123,Avinyonet de Puigventós,2009,1449,745,704,320,989,140
77,080137,Avinyonet del Penedès,2009,1690,908,782,266,1133,291
78,080155,Badalona,2009,219547,110185,109362,32665,154114,32768
79,089045,Badia del Vallès,2009,13679,6744,6935,2110,9471,2098
80,080168,Bagà,2009,2362,1159,1203,274,1552,536
81,250390,Baix Pallars,2009,413,222,191,53,259,101
82,250404,Balaguer,2009,16779,8564,8215,2683,11333,2763
83,080174,Balenyà,2009,3743,1884,1859,612,2608,523
84,080180,Balsareny,2009,3512,1800,1712,433,2396,683
85,430206,Banyeres del Penedès,2009,2945,1529,1416,554,2023,368
86,170157,Banyoles,2009,18327,9187,9140,3195,12101,3031
87,250411,Barbens,2009,892,475,417,107,540,245
88,430213,Barberà de la Conca,2009,539,296,243,75,352,112
89,082520,Barberà del Vallès,2009,31144,15544,15600,5116,22482,3546
90,080193,Barcelona,2009,1621537,771570,849967,192290,1097991,331256
91,250426,"Baronia de Rialb, la",2009,279,144,135,41,170,68
92,170160,Bàscara,2009,946,500,446,122,607,217
93,250447,Bassella,2009,252,132,120,28,159,65
94,430228,Batea,2009,2163,1118,1045,252,1368,543
95,250450,Bausen,2009,63,37,26,5,32,26
96,080207,Begues,2009,6271,3132,3139,1332,4375,564
97,170139,Begur,2009,4258,2192,2066,606,2935,717
98,250463,Belianes,2009,589,304,285,68,349,172
99,251706,Bellaguarda,2009,336,177,159,37,188,111
100,170182,Bellcaire d'Empordà,2009,664,322,342,109,426,129
101,250479,Bellcaire d'Urgell,2009,1284,632,652,147,784,353
102,250485,Bell-lloc d'Urgell,2009,2447,1206,1241,375,1579,493
103,250498,Bellmunt d'Urgell,2009,215,104,111,24,133,58
104,430234,Bellmunt del Priorat,2009,354,177,177,45,222,87
105,080214,Bellprat,2009,92,50,42,7,61,24
106,250501,Bellpuig,2009,4940,2577,2363,739,3344,857
107,430249,Bellvei,2009,2005,1055,950,372,1350,283
108,250518,Bellver de Cerdanya,2009,2231,1181,1050,291,1549,391
109,250523,Bellvís,2009,2481,1285,1196,301,1588,592
110,250539,Benavent de Segrià,2009,1489,767,722,302,1007,180
111,430252,Benifallet,2009,788,392,396,68,462,258
112,430265,Benissanet,2009,1250,663,587,149,822,279
113,080229,Berga,2009,17160,8587,8573,2333,11415,3412
114,170195,Besalú,2009,2361,1144,1217,320,1518,523
115,170209,Bescanó,2009,4450,2227,2223,845,2920,685
116,170216,Beuda,2009,163,81,82,21,117,25
117,080235,Bigues i Riells del Fai,2009,8401,4309,4092,1630,5860,911
118,250557,Biosca,2009,222,122,100,19,135,68
119,170221,"Bisbal d'Empordà, la",2009,10385,5285,5100,1672,7078,1635
120,430271,"Bisbal de Falset, la",2009,237,122,115,31,134,72
121,430287,"Bisbal del Penedès, la",2009,3397,1771,1626,530,2329,538
122,172348,Biure,2009,243,122,121,26,166,51
123,430290,Blancafort,2009,438,226,212,50,278,110
124,170237,Blanes,2009,40047,20297,19750,6178,28038,5831
125,170293,Boadella i les Escaules,2009,241,118,123,27,166,48
126,170242,Bolvir,2009,378,199,179,40,277,61
127,430304,Bonastre,2009,657,346,311,98,460,99
128,250576,"Bòrdes, Es",2009,238,126,112,28,171,39
129,170255,Bordils,2009,1732,884,848,290,1180,262
130,250582,"Borges Blanques, les",2009,6058,3100,2958,854,4004,1200
131,430311,"Borges del Camp, les",2009,2115,1048,1067,376,1372,367
132,170268,Borrassà,2009,665,353,312,88,449,128
133,080240,Borredà,2009,614,331,283,85,387,142
134,250595,Bossòst,2009,1219,635,584,162,887,170
135,430326,Bot,2009,698,362,336,51,414,233
136,430332,Botarell,2009,1047,553,494,188,743,116
137,250560,Bovera,2009,353,186,167,20,187,146
138,430347,Bràfim,2009,666,330,336,90,439,137
139,170274,Breda,2009,3784,1917,1867,554,2493,737
140,080253,"Bruc, el",2009,1904,1018,886,361,1329,214
141,080266,"Brull, el",2009,252,133,119,50,164,38
142,170280,Brunyola i Sant Martí Sapresa,2009,373,189,184,40,233,100
143,430350,Cabacés,2009,345,185,160,36,217,92
144,250609,Cabanabona,2009,109,50,59,9,50,50
145,170314,Cabanelles,2009,236,137,99,20,169,47
146,170307,Cabanes,2009,932,486,446,156,594,182
147,080272,"Cabanyes, les",2009,888,453,435,191,593,104
148,250616,Cabó,2009,95,55,40,7,58,30
149,430363,Cabra del Camp,2009,1116,597,519,192,744,180
150,080288,Cabrera d'Anoia,2009,1320,707,613,231,936,153
151,080291,Cabrera de Mar,2009,4408,2243,2165,754,3076,578
152,080305,Cabrils,2009,6964,3433,3531,1548,4729,687
153,170329,Cadaqués,2009,2860,1416,1444,444,1982,434
154,080312,Calaf,2009,3630,1933,1697,521,2476,633
155,430379,Calafell,2009,24265,12368,11897,3767,17175,3323
156,080348,Calders,2009,899,457,442,145,594,160
157,080327,Caldes d'Estrac,2009,2799,1365,1434,400,1915,484
158,170335,Caldes de Malavella,2009,6710,3337,3373,1172,4579,959
159,080333,Caldes de Montbui,2009,16885,8479,8406,2814,11592,2479
160,080351,Calella,2009,18627,9225,9402,2785,12754,3088
161,080370,Calldetenes,2009,2391,1225,1166,390,1692,309
162,080386,Callús,2009,1759,856,903,291,1135,333
163,080364,Calonge de Segarra,2009,196,104,92,24,116,56
164,170340,Calonge i Sant Antoni,2009,10637,5376,5261,1611,7365,1661
165,250621,Camarasa,2009,991,516,475,87,630,274
166,439039,Camarles,2009,3555,1820,1735,529,2301,725
167,430385,Cambrils,2009,31720,15861,15859,5405,22479,3836
168,170353,Camós,2009,692,350,342,95,439,158
169,170366,Campdevànol,2009,3505,1748,1757,444,2209,852
170,170372,Campelles,2009,125,63,62,17,85,23
171,080399,Campins,2009,390,200,190,67,278,45
172,170388,Campllong,2009,423,216,207,84,270,69
173,170391,Camprodon,2009,2542,1255,1287,313,1668,561
174,250637,Canejan,2009,104,57,47,6,64,34
175,170405,Canet d'Adri,2009,605,307,298,76,416,113
176,080403,Canet de Mar,2009,13548,6704,6844,2065,9139,2344
177,080410,Canovelles,2009,16023,8442,7581,2676,11429,1918
178,080425,Cànoves i Samalús,2009,2742,1398,1344,481,1881,380
179,170412,Cantallops,2009,319,164,155,39,202,78
180,080431,Canyelles,2009,4104,2093,2011,819,2873,412
181,430398,Capafonts,2009,119,64,55,3,72,44
182,430402,Capçanes,2009,415,207,208,37,279,99
183,080446,Capellades,2009,5525,2732,2793,849,3705,971
184,170427,Capmany,2009,593,316,277,78,379,136
185,080459,Capolat,2009,77,35,42,14,45,18
186,080462,Cardedeu,2009,16596,8182,8414,3018,11484,2094
187,080478,Cardona,2009,5187,2553,2634,604,3325,1258
188,080484,Carme,2009,832,433,399,108,559,165
189,430419,Caseres,2009,293,143,150,31,165,97
190,170448,Cassà de la Selva,2009,9537,4934,4603,1550,6417,1570
191,080497,Casserres,2009,1590,788,802,158,1030,402
192,080575,Castell de l'Areny,2009,75,43,32,11,53,11
193,259046,Castell de Mur,2009,173,89,84,18,101,54
194,250642,Castellar de la Ribera,2009,160,80,80,30,86,44
195,080522,Castellar de n'Hug,2009,198,106,92,20,140,38
196,080500,Castellar del Riu,2009,154,81,73,28,98,28
197,080517,Castellar del Vallès,2009,23002,11448,11554,4244,16006,2752
198,080538,Castellbell i el Vilar,2009,3680,1894,1786,556,2482,642
199,080543,Castellbisbal,2009,11977,6169,5808,2459,8288,1230
200,080556,Castellcir,2009,628,327,301,127,417,84
201,250674,Castelldans,2009,1015,554,461,100,680,235
202,080569,Castelldefels,2009,62080,31116,30964,10537,44810,6733
203,080581,Castellet i la Gornal,2009,2222,1145,1077,370,1502,350
204,170464,Castellfollit de la Roca,2009,1043,525,518,142,661,240
205,080608,Castellfollit de Riubregós,2009,195,102,93,14,126,55
206,080594,Castellfollit del Boix,2009,426,208,218,69,269,88
207,080615,Castellgalí,2009,1918,1009,909,353,1299,266
208,080620,Castellnou de Bages,2009,1021,540,481,192,727,102
209,250680,Castellnou de Seana,2009,739,377,362,86,441,212
210,170470,Castelló d'Empúries,2009,12111,6273,5838,1873,8359,1879
211,250693,Castelló de Farfanya,2009,572,302,270,51,368,153
212,080636,Castellolí,2009,506,247,259,91,333,82
213,170486,Castell-Platja d'Aro,2009,10376,5278,5098,1430,7468,1478
214,250707,Castellserà,2009,1131,589,542,120,700,311
215,080641,Castellterçol,2009,2375,1187,1188,352,1546,477
216,430424,Castellvell del Camp,2009,2686,1361,1325,552,1883,251
217,080654,Castellví de la Marca,2009,1661,835,826,260,1097,304
218,080667,Castellví de Rosanes,2009,1719,862,857,319,1177,223
219,430430,"Catllar, el",2009,4079,2090,1989,723,2930,426
220,250714,Cava,2009,50,30,20,0,34,16
221,171899,"Cellera de Ter, la",2009,2186,1100,1086,328,1430,428
222,170499,Celrà,2009,4513,2233,2280,926,3138,449
223,080673,Centelles,2009,7209,3540,3669,1108,4869,1232
224,082687,Cercs,2009,1334,681,653,142,839,353
225,082665,Cerdanyola del Vallès,2009,58747,29070,29677,9020,42223,7504
226,080689,Cervelló,2009,8393,4254,4139,1384,6028,981
227,250729,Cervera,2009,9328,4783,4545,1601,6309,1418
228,250735,Cervià de les Garrigues,2009,846,438,408,86,517,243
229,170502,Cervià de Ter,2009,889,448,441,164,568,157
230,170519,Cistella,2009,238,120,118,24,151,63
231,250740,Ciutadilla,2009,226,124,102,25,143,58
232,250753,Clariana de Cardener,2009,152,77,75,22,114,16
233,250766,"Cogul, el",2009,203,109,94,14,125,64
234,170545,Colera,2009,573,295,278,49,372,152
235,250772,Coll de Nargó,2009,634,323,311,64,415,155
236,080692,Collbató,2009,4040,2109,1931,898,2777,365
237,430458,Colldejou,2009,183,98,85,15,135,33
238,080706,Collsuspina,2009,351,184,167,57,240,54
239,170558,Colomers,2009,195,96,99,17,119,59
240,251636,"Coma i la Pedra, la",2009,278,169,109,25,201,52
241,251615,Conca de Dalt,2009,410,210,200,28,256,126
242,430461,Conesa,2009,124,63,61,10,81,33
243,430477,Constantí,2009,6373,3436,2937,1091,4468,814
244,080713,Copons,2009,318,153,165,57,197,64
245,430483,Corbera d'Ebre,2009,1174,625,549,142,754,278
246,080728,Corbera de Llobregat,2009,13843,7007,6836,2605,9811,1427
247,250788,Corbins,2009,1356,724,632,193,910,253
248,170577,Corçà,2009,1280,628,652,163,881,236
249,080734,Cornellà de Llobregat,2009,86519,42953,43566,12687,58785,15047
250,170561,Cornellà del Terri,2009,2176,1102,1074,331,1453,392
251,430496,Cornudella de Montsant,2009,1015,530,485,107,655,253
252,430509,Creixell,2009,3219,1672,1547,477,2154,588
253,170583,Crespià,2009,253,129,124,34,160,59
254,179011,"Cruïlles, Monells i Sant Sadurní de l'Heura",2009,1272,639,633,186,886,200
255,080749,Cubelles,2009,13711,6970,6741,2323,9667,1721
256,250791,Cubells,2009,401,209,192,50,229,122
257,430516,Cunit,2009,12279,6268,6011,1999,8400,1880
258,170600,Darnius,2009,536,272,264,53,348,135
259,170617,Das,2009,227,124,103,38,150,39
260,439018,Deltebre,2009,11751,6003,5748,1509,7972,2270
261,080752,Dosrius,2009,4937,2496,2441,927,3537,473
262,430537,Duesaigües,2009,240,138,102,23,155,62
263,170622,"Escala, l'",2009,10140,5208,4932,1352,6952,1836
264,080765,Esparreguera,2009,21855,11213,10642,3747,15378,2730
265,170638,Espinelves,2009,190,96,94,22,121,47
266,250812,"Espluga Calba, l'",2009,429,223,206,45,256,128
267,430542,"Espluga de Francolí, l'",2009,3982,1975,2007,529,2608,845
268,080771,Esplugues de Llobregat,2009,46862,22885,23977,6366,32500,7996
269,170643,Espolla,2009,404,197,207,38,262,104
270,170656,Esponellà,2009,462,223,239,83,290,89
271,250827,Espot,2009,364,194,170,52,255,57
272,080787,"Espunyola, l'",2009,260,129,131,34,155,71
273,082541,"Esquirol, l'",2009,2293,1164,1129,365,1461,467
274,250886,Estamariu,2009,115,61,54,10,65,40
275,080790,"Estany, l'",2009,390,188,202,47,241,102
276,250851,Estaràs,2009,177,98,79,13,116,48
277,250864,Esterri d'Àneu,2009,965,518,447,118,701,146
278,250870,Esterri de Cardós,2009,75,35,40,5,54,16
279,430555,Falset,2009,2864,1446,1418,425,1905,534
280,170059,"Far d'Empordà, el",2009,537,270,267,106,332,99
281,250899,Farrera,2009,133,76,57,18,98,17
282,430568,"Fatarella, la",2009,1128,567,561,106,676,346
283,430574,"Febró, la",2009,46,30,16,0,33,13
284,081347,Figaró-Montmany,2009,1057,534,523,172,672,213
285,080804,Fígols,2009,48,26,22,5,22,21
286,259084,Fígols i Alinyà,2009,284,157,127,21,169,94
287,430580,"Figuera, la",2009,148,83,65,9,103,36
288,170669,Figueres,2009,43330,21689,21641,6951,30049,6330
289,430593,Figuerola del Camp,2009,341,161,180,62,216,63
290,170675,Flaçà,2009,1072,524,548,145,711,216
291,430607,Flix,2009,4098,2081,2017,430,2772,896
292,250925,"Floresta, la",2009,179,102,77,20,106,53
293,080826,Fogars de la Selva,2009,1513,793,720,285,1035,193
294,080811,Fogars de Montclús,2009,465,250,215,92,295,78
295,170681,Foixà,2009,336,180,156,39,215,82
296,080832,Folgueroles,2009,2205,1117,1088,473,1435,297
297,250931,Fondarella,2009,821,409,412,116,587,118
298,080847,Fonollosa,2009,1399,715,684,225,991,183
299,170694,Fontanals de Cerdanya,2009,451,221,230,44,325,82
300,170708,Fontanilles,2009,173,104,69,24,110,39
301,170715,Fontcoberta,2009,1251,607,644,200,896,155
302,080850,Font-rubí,2009,1483,774,709,238,928,317
303,250946,Foradada,2009,189,110,79,15,122,52
304,179026,Forallac,2009,1737,871,866,224,1228,285
305,430614,Forès,2009,43,25,18,0,24,19
306,170736,Fornells de la Selva,2009,2295,1109,1186,483,1564,248
307,170741,Fortià,2009,639,328,311,93,406,140
308,080863,"Franqueses del Vallès, les",2009,17660,9071,8589,3023,12689,1948
309,430629,Freginals,2009,449,238,211,41,281,127
310,250962,"Fuliola, la",2009,1239,614,625,142,790,307
311,250978,Fulleda,2009,113,61,52,6,74,33
312,080902,Gaià,2009,171,92,79,33,112,26
313,430635,"Galera, la",2009,884,459,425,107,587,190
314,080879,Gallifa,2009,214,113,101,30,155,29
315,430640,Gandesa,2009,3236,1674,1562,424,2163,649
316,430653,Garcia,2009,602,296,306,58,370,174
317,430666,"Garidells, els",2009,221,111,110,32,152,37
318,080885,"Garriga, la",2009,14991,7266,7725,2731,10170,2090
319,170754,Garrigàs,2009,395,206,189,42,260,93
320,170767,Garrigoles,2009,160,91,69,16,102,42
321,170773,Garriguella,2009,825,415,410,113,540,172
322,080898,Gavà,2009,45994,22837,23157,7480,32129,6385
323,250984,Gavet de la Conca,2009,307,150,157,23,169,115
324,080919,Gelida,2009,6801,3453,3348,1188,4687,926
325,170789,Ger,2009,450,247,203,54,318,78
326,259123,Gimenells i el Pla de la Font,2009,1182,598,584,157,744,281
327,430672,Ginestar,2009,1066,567,499,122,690,254
328,170792,Girona,2009,96188,47161,49027,15480,68014,12694
329,080924,Gironella,2009,5052,2469,2583,607,3245,1200
330,080930,Gisclareny,2009,34,20,14,0,30,4
331,430688,Godall,2009,841,431,410,99,507,235
332,250997,Golmés,2009,1693,846,847,272,1141,280
333,170806,Gombrèn,2009,232,108,124,33,154,45
334,251001,Gósol,2009,219,118,101,17,149,53
335,080945,"Granada, la",2009,1976,1008,968,327,1362,287
336,251018,"Granadella, la",2009,765,401,364,72,453,240
337,080958,Granera,2009,77,48,29,4,59,14
338,251023,"Granja d'Escarp, la",2009,984,525,459,90,640,254
339,080961,Granollers,2009,60658,30504,30154,9198,42877,8583
340,251039,Granyanella,2009,160,83,77,15,105,40
341,251057,Granyena de les Garrigues,2009,172,99,73,13,111,48
342,251044,Granyena de Segarra,2009,138,70,68,3,78,57
343,430691,Gratallops,2009,266,141,125,33,171,62
344,080977,Gualba,2009,1192,603,589,215,823,154
345,170813,Gualta,2009,380,216,164,53,256,71
346,080996,Guardiola de Berguedà,2009,1007,538,469,121,646,240
347,430705,"Guiamets, els",2009,330,161,169,23,214,93
348,170828,Guils de Cerdanya,2009,479,249,230,55,360,64
349,251095,Guimerà,2009,334,179,155,15,187,132
350,259031,"Guingueta d'Àneu, la",2009,372,206,166,41,256,75
351,251109,Guissona,2009,6145,3322,2823,1108,4417,620
352,251116,Guixers,2009,138,80,58,10,95,33
353,081000,Gurb,2009,2475,1271,1204,479,1679,317
354,430712,Horta de Sant Joan,2009,1305,692,613,153,811,341
355,081017,"Hospitalet de Llobregat, l'",2009,257038,126459,130579,33230,176708,47100
356,081629,"Hostalets de Pierola, els",2009,2612,1354,1258,507,1827,278
357,170834,Hostalric,2009,3994,2059,1935,642,2768,584
358,081022,Igualada,2009,38918,19325,19593,6291,26107,6520
359,251155,Isona i Conca Dellà,2009,1163,617,546,126,684,353
360,170849,Isòvol,2009,289,169,120,25,206,58
361,251137,Ivars d'Urgell,2009,1741,928,813,204,1117,420
362,251121,Ivars de Noguera,2009,363,204,159,34,233,96
363,251142,Ivorra,2009,136,71,65,12,80,44
364,170852,Jafre,2009,419,222,197,39,281,99
365,170865,"Jonquera, la",2009,3174,1603,1571,489,2278,407
366,081038,Jorba,2009,827,407,420,151,537,139
367,259101,Josa i Tuixén,2009,155,84,71,13,112,30
368,170871,Juià,2009,326,182,144,57,204,65
369,251180,Juncosa,2009,504,265,239,52,301,151
370,251193,Juneda,2009,3417,1793,1624,455,2263,699
371,251214,Les,2009,979,486,493,145,712,122
372,251229,Linyola,2009,2836,1484,1352,432,1857,547
373,081043,"Llacuna, la",2009,925,499,426,108,609,208
374,170887,Lladó,2009,682,352,330,109,444,129
375,251235,Lladorre,2009,227,111,116,28,151,48
376,251240,Lladurs,2009,201,114,87,24,122,55
377,081056,"Llagosta, la",2009,13820,6971,6849,2184,9667,1969
378,170890,Llagostera,2009,7764,4014,3750,1248,5220,1296
379,170904,Llambilles,2009,678,351,327,122,452,104
380,170911,Llanars,2009,584,305,279,67,405,112
381,170926,Llançà,2009,5209,2609,2600,710,3486,1013
382,251253,Llardecans,2009,533,277,256,48,304,181
383,251266,Llavorsí,2009,374,193,181,49,251,74
384,251207,Lleida,2009,135919,67790,68129,20568,94630,20721
385,170932,Llers,2009,1179,601,578,172,791,216
386,251272,Lles de Cerdanya,2009,271,161,110,25,185,61
387,081075,Lliçà d'Amunt,2009,14143,7223,6920,2746,9716,1681
388,081081,Lliçà de Vall,2009,6290,3224,3066,1128,4366,796
389,251288,Llimiana,2009,168,95,73,15,104,49
390,081069,Llinars del Vallès,2009,9035,4487,4548,1517,6245,1273
391,170947,Llívia,2009,1589,870,719,209,1176,204
392,430727,"Lloar, el",2009,117,68,49,14,67,36
393,251291,Llobera,2009,211,114,97,24,136,51
394,430733,Llorac,2009,108,59,49,11,66,31
395,430748,Llorenç del Penedès,2009,2185,1091,1094,392,1471,322
396,170950,Lloret de Mar,2009,39363,20879,18484,5935,29585,3843
397,170963,"Llosses, les",2009,234,134,100,20,172,42
398,081094,Lluçà,2009,260,134,126,37,174,49
399,171024,Maçanet de Cabrenys,2009,729,366,363,73,447,209
400,171030,Maçanet de la Selva,2009,6871,3553,3318,1166,4779,926
401,170979,Madremanya,2009,238,116,122,36,149,53
402,170985,Maià de Montcal,2009,410,212,198,62,264,84
403,251333,Maials,2009,987,511,476,102,595,290
404,251305,Maldà,2009,261,141,120,24,149,88
405,081108,Malgrat de Mar,2009,18472,9206,9266,2736,12615,3121
406,081115,Malla,2009,255,129,126,28,183,44
407,081120,Manlleu,2009,20647,10459,10188,3621,13792,3234
408,081136,Manresa,2009,76558,37784,38774,11350,51071,14137
409,430764,Marçà,2009,649,332,317,97,391,161
410,430751,Margalef,2009,117,63,54,9,72,36
411,082423,Marganell,2009,308,150,158,37,203,68
412,081141,Martorell,2009,26681,13833,12848,4667,18320,3694
413,081154,Martorelles,2009,4922,2481,2441,692,3421,809
414,430770,Mas de Barberans,2009,663,332,331,70,406,187
415,171002,Masarac,2009,265,144,121,32,172,61
416,430786,Masdenverge,2009,1133,592,541,145,743,245
417,081167,"Masies de Roda, les",2009,755,373,382,96,530,129
418,081173,"Masies de Voltregà, les",2009,3232,1596,1636,586,2174,472
419,430799,Masllorenç,2009,532,274,258,78,330,124
420,081189,"Masnou, el",2009,22288,10709,11579,3324,15447,3517
421,430803,"Masó, la",2009,298,151,147,36,183,79
422,430810,Maspujols,2009,663,346,317,116,423,124
423,081192,Masquefa,2009,8168,4137,4031,1675,5574,919
424,430825,"Masroig, el",2009,566,294,272,65,349,152
425,251312,Massalcoreig,2009,593,312,281,54,386,153
426,171019,Massanes,2009,713,382,331,103,509,101
427,251327,Massoteres,2009,209,117,92,42,128,39
428,081206,Matadepera,2009,8616,4312,4304,1822,5778,1016
429,081213,Mataró,2009,121722,60975,60747,19028,84772,17922
430,081228,Mediona,2009,2360,1212,1148,391,1506,463
431,251348,Menàrguens,2009,854,448,406,90,522,242
432,170998,Meranges,2009,93,53,40,7,65,21
433,171058,Mieres,2009,344,175,169,57,214,73
434,430831,"Milà, el",2009,178,87,91,25,106,47
435,251351,Miralcamp,2009,1440,721,719,194,978,268
436,430846,Miravet,2009,814,428,386,87,529,198
437,081385,Moià,2009,5710,2888,2822,1009,3813,888
438,430859,"Molar, el",2009,302,169,133,31,181,90
439,081234,Molins de Rei,2009,24067,11753,12314,3946,16691,3430
440,251370,Mollerussa,2009,14319,7453,6866,2469,10124,1726
441,171061,Mollet de Peralada,2009,174,89,85,17,103,54
442,081249,Mollet del Vallès,2009,52484,26445,26039,8757,37325,6402
443,171077,Molló,2009,360,179,181,37,232,91
444,251364,"Molsosa, la",2009,119,61,58,7,79,33
445,081287,Monistrol de Calders,2009,683,348,335,98,448,137
446,081271,Monistrol de Montserrat,2009,3029,1558,1471,396,2098,535
447,171096,Montagut i Oix,2009,971,510,461,129,643,199
448,430862,Montblanc,2009,7305,3707,3598,1045,5022,1238
449,430884,Montbrió del Camp,2009,2219,1128,1091,329,1524,366
450,081252,Montcada i Reixac,2009,33453,16668,16785,5533,23323,4597
451,081304,Montclar,2009,112,54,58,17,66,29
452,251399,Montellà i Martinet,2009,661,346,315,80,443,138
453,081311,Montesquiu,2009,906,457,449,117,603,186
454,251403,Montferrer i Castellbò,2009,1089,595,494,147,809,133
455,430897,Montferri,2009,366,198,168,70,230,66
456,251386,Montgai,2009,727,371,356,75,431,221
457,081265,Montgat,2009,10270,5052,5218,1586,7377,1307
458,081326,Montmajor,2009,487,256,231,52,323,112
459,081332,Montmaneu,2009,192,105,87,18,119,55
460,430901,"Montmell, el",2009,1431,789,642,215,1020,196
461,081350,Montmeló,2009,8955,4441,4514,1439,6253,1263
462,251425,Montoliu de Lleida,2009,486,248,238,54,319,113
463,251410,Montoliu de Segarra,2009,193,114,79,13,123,57
464,251431,Montornès de Segarra,2009,108,54,54,5,64,39
465,081363,Montornès del Vallès,2009,15509,8002,7507,2706,10968,1835
466,430918,Mont-ral,2009,171,98,73,12,134,25
467,171100,Mont-ras,2009,1847,954,893,280,1300,267
468,430923,Mont-roig del Camp,2009,11847,6185,5662,1724,8428,1695
469,081379,Montseny,2009,319,168,151,29,217,73
470,430939,Móra d'Ebre,2009,5695,2816,2879,926,3770,999
471,430944,Móra la Nova,2009,3179,1628,1551,465,2123,591
472,430957,"Morell, el",2009,3285,1708,1577,575,2322,388
473,430960,"Morera de Montsant, la",2009,153,92,61,16,107,30
474,081290,Muntanyola,2009,570,288,282,125,391,54
475,081398,Mura,2009,238,130,108,32,166,40
476,251459,Nalec,2009,95,48,47,4,58,33
477,250254,Naut Aran,2009,1740,890,850,268,1267,205
478,081402,Navarcles,2009,5947,2944,3003,851,4052,1044
479,081419,Navàs,2009,6243,3121,3122,935,4095,1213
480,171117,Navata,2009,1128,566,562,202,718,208
481,251462,Navès,2009,266,131,135,37,167,62
482,081424,"Nou de Berguedà, la",2009,159,83,76,23,89,47
483,430976,"Nou de Gaià, la",2009,497,245,252,94,313,90
484,430982,Nulles,2009,418,217,201,51,281,86
485,251484,Odèn,2009,281,166,115,15,189,77
486,081430,Òdena,2009,3334,1703,1631,580,2270,484
487,171122,Ogassa,2009,264,156,108,27,178,59
488,081458,Olèrdola,2009,3462,1792,1670,674,2368,420
489,081461,Olesa de Bonesvalls,2009,1740,916,824,287,1232,221
490,081477,Olesa de Montserrat,2009,23301,11778,11523,4171,15990,3140
491,251497,Oliana,2009,1976,986,990,220,1301,455
492,251500,Oliola,2009,248,143,105,27,166,55
493,251517,Olius,2009,814,419,395,166,538,110
494,081483,Olivella,2009,3340,1778,1562,675,2400,265
495,081496,Olost,2009,1217,604,613,154,777,286
496,171143,Olot,2009,33524,16856,16668,4807,22325,6392
497,251522,"Oluges, les",2009,179,99,80,6,112,61
498,081445,Olvan,2009,903,444,459,103,573,227
499,251538,"Omellons, els",2009,244,130,114,20,155,69
500,251543,"Omells de na Gaia, els",2009,142,77,65,11,87,44
501,171156,Ordis,2009,372,198,174,61,248,63
502,251556,Organyà,2009,958,467,491,95,599,264
503,081509,Orís,2009,284,144,140,41,195,48
504,081516,Oristà,2009,585,287,298,49,397,139
505,081521,Orpí,2009,187,100,87,23,130,34
506,081537,Òrrius,2009,640,331,309,110,435,95
507,251569,Os de Balaguer,2009,985,522,463,154,607,224
508,171169,Osor,2009,354,181,173,25,210,119
509,251575,Ossó de Sió,2009,219,107,112,22,138,59
510,081542,Pacs del Penedès,2009,869,443,426,140,607,122
511,081555,Palafolls,2009,8584,4300,4284,1623,6045,916
512,171175,Palafrugell,2009,22365,11301,11064,3613,15252,3500
513,171181,Palamós,2009,18161,8982,9179,2768,12390,3003
514,251581,"Palau d'Anglesola, el",2009,2099,1048,1051,317,1375,407
515,171194,Palau de Santa Eulàlia,2009,112,66,46,11,81,20
516,171215,Palau-sator,2009,290,148,142,31,188,71
517,171208,Palau-saverdera,2009,1451,729,722,197,928,326
518,081568,Palau-solità i Plegamans,2009,14070,7063,7007,2568,9935,1567
519,431009,"Pallaresos, els",2009,3991,2053,1938,949,2776,266
520,081574,Pallejà,2009,11134,5632,5502,2109,7748,1277
521,430995,"Palma d'Ebre, la",2009,413,199,214,38,234,141
522,089058,"Palma de Cervelló, la",2009,3057,1519,1538,513,2200,344
523,171236,Palol de Revardit,2009,479,243,236,88,310,81
524,171241,Pals,2009,2799,1412,1387,362,1845,592
525,081580,"Papiol, el",2009,3900,1945,1955,623,2742,535
526,171254,Pardines,2009,159,88,71,20,89,50
527,081593,Parets del Vallès,2009,17632,8969,8663,3083,12487,2062
528,171267,Parlavà,2009,394,202,192,39,275,80
529,431016,Passanant i Belltall,2009,159,90,69,4,99,56
530,171289,Pau,2009,578,290,288,94,377,107
531,431021,Paüls,2009,613,306,307,60,387,166
532,171292,Pedret i Marzà,2009,160,87,73,21,104,35
533,251641,Penelles,2009,546,297,249,50,349,147
534,171306,"Pera, la",2009,443,226,217,57,284,102
535,081607,Perafita,2009,408,209,199,53,251,104
536,431037,Perafort,2009,1154,611,543,195,838,121
537,171328,Peralada,2009,1805,918,887,286,1205,314
538,251654,Peramola,2009,379,202,177,38,234,107
539,431042,"Perelló, el",2009,3235,1735,1500,405,2130,700
540,081614,Piera,2009,14324,7323,7001,2641,9599,2084
541,431055,"Piles, les",2009,215,116,99,23,151,41
542,081635,Pineda de Mar,2009,26203,13335,12868,3893,18348,3962
543,431068,"Pinell de Brai, el",2009,1130,574,556,126,698,306
544,251667,Pinell de Solsonès,2009,214,115,99,25,131,58
545,251673,Pinós,2009,308,171,137,34,202,72
546,431074,Pira,2009,510,256,254,103,306,101
547,431080,"Pla de Santa Maria, el",2009,2309,1213,1096,362,1541,406
548,081640,"Pla del Penedès, el",2009,1041,531,510,155,681,205
549,171334,"Planes d'Hostoles, les",2009,1756,892,864,209,1065,482
550,171349,Planoles,2009,279,152,127,28,185,66
551,259118,"Plans de Sió, els",2009,573,298,275,62,327,184
552,251689,"Poal, el",2009,659,343,316,71,422,166
553,251692,"Pobla de Cérvoles, la",2009,257,139,118,33,158,66
554,081653,"Pobla de Claramunt, la",2009,2286,1172,1114,407,1523,356
555,081666,"Pobla de Lillet, la",2009,1312,652,660,90,838,384
556,431093,"Pobla de Mafumet, la",2009,2403,1234,1169,410,1805,188
557,431107,"Pobla de Massaluca, la",2009,399,206,193,36,227,136
558,431114,"Pobla de Montornès, la",2009,2852,1511,1341,473,1948,431
559,251713,"Pobla de Segur, la",2009,3237,1612,1625,400,2048,789
560,431129,Poboleda,2009,371,203,168,28,253,90
561,081672,Polinyà,2009,7676,3929,3747,1489,5610,577
562,431135,"Pont d'Armentera, el",2009,620,324,296,70,389,161
563,250306,"Pont de Bar, el",2009,197,112,85,27,121,49
564,171352,Pont de Molins,2009,486,257,229,57,346,83
565,251734,"Pont de Suert, el",2009,2570,1336,1234,345,1741,484
566,081825,"Pont de Vilomara i Rocafort, el",2009,3714,1918,1796,619,2565,530
567,431418,Pontils,2009,147,83,64,8,103,36
568,081688,Pontons,2009,530,290,240,75,363,92
569,171365,Pontós,2009,238,131,107,32,151,55
570,251728,Ponts,2009,2803,1421,1382,395,1843,565
571,171371,Porqueres,2009,4380,2184,2196,773,2998,609
572,431140,Porrera,2009,480,258,222,57,307,116
573,171404,"Port de la Selva, el",2009,1015,528,487,121,686,208
574,171387,Portbou,2009,1325,659,666,96,835,394
575,251749,"Portella, la",2009,775,417,358,66,575,134
576,431153,Pradell de la Teixeta,2009,182,82,100,17,117,48
577,431166,Prades,2009,676,353,323,84,438,154
578,431172,Prat de Comte,2009,205,108,97,25,118,62
579,081691,"Prat de Llobregat, el",2009,63418,31601,31817,9255,44850,9313
580,431188,Pratdip,2009,843,452,391,93,516,234
581,081712,Prats de Lluçanès,2009,2722,1344,1378,365,1787,570
582,081705,"Prats de Rei, els",2009,538,281,257,44,370,124
583,251752,Prats i Sansor,2009,237,131,106,29,168,40
584,251765,Preixana,2009,433,222,211,50,248,135
585,251771,Preixens,2009,506,258,248,67,273,166
586,082303,Premià de Dalt,2009,9944,4991,4953,1669,6970,1305
587,081727,Premià de Mar,2009,27399,13567,13832,4205,19129,4065
588,171390,"Preses, les",2009,1731,845,886,288,1151,292
589,251790,Prullans,2009,232,122,110,23,146,63
590,171411,Puigcerdà,2009,9022,4611,4411,1521,6247,1254
591,081748,Puigdàlber,2009,508,248,260,74,357,77
592,251804,Puiggròs,2009,309,166,143,48,190,71
593,431191,Puigpelat,2009,977,514,463,188,681,108
594,081751,Puig-reig,2009,4403,2155,2248,496,2831,1076
595,251811,Puigverd d'Agramunt,2009,278,158,120,31,182,65
596,251826,Puigverd de Lleida,2009,1391,713,678,231,907,253
597,081764,Pujalt,2009,203,106,97,19,138,46
598,081770,"Quar, la",2009,61,36,25,3,43,15
599,171426,Quart,2009,2852,1445,1407,484,2037,331
600,170433,Queralbs,2009,199,115,84,23,121,55
601,431205,Querol,2009,539,287,252,68,385,86
602,171432,Rabós,2009,217,112,105,30,142,45
603,081786,Rajadell,2009,496,262,234,69,336,91
604,431212,Rasquera,2009,955,478,477,109,579,267
605,171447,Regencós,2009,326,181,145,47,210,69
606,081799,Rellinars,2009,713,363,350,116,495,102
607,431227,Renau,2009,90,46,44,11,66,13
608,431233,Reus,2009,107118,53182,53936,17950,73953,15215
609,251832,Rialp,2009,656,342,314,88,482,86
610,431248,"Riba, la",2009,722,391,331,81,481,160
611,431251,Riba-roja d'Ebre,2009,1348,717,631,114,881,353
612,259059,Ribera d'Ondara,2009,445,231,214,42,280,123
613,251850,Ribera d'Urgellet,2009,954,508,446,131,623,200
614,171450,Ribes de Freser,2009,1976,973,1003,190,1248,538
615,171463,Riells i Viabrea,2009,3779,1974,1805,733,2711,335
616,431264,"Riera de Gaià, la",2009,1587,826,761,276,1098,213
617,251863,Riner,2009,300,148,152,43,194,63
618,171479,Ripoll,2009,11057,5477,5580,1368,7350,2339
619,081803,Ripollet,2009,37088,18787,18301,6425,26113,4550
620,259139,Riu de Cerdanya,2009,110,60,50,9,87,14
621,171485,Riudarenes,2009,2070,1077,993,349,1399,322
622,171498,Riudaura,2009,443,215,228,53,303,87
623,431270,Riudecanyes,2009,1083,555,528,180,702,201
624,431286,Riudecols,2009,1296,684,612,177,895,224
625,171501,Riudellots de la Selva,2009,1984,1021,963,319,1375,290
626,431299,Riudoms,2009,6436,3294,3142,1080,4294,1062
627,171518,Riumors,2009,233,115,118,35,145,53
628,081810,"Roca del Vallès, la",2009,10214,5170,5044,1896,7124,1194
629,431303,Rocafort de Queralt,2009,278,149,129,36,170,72
630,431310,Roda de Berà,2009,6186,3238,2948,978,4330,878
631,081831,Roda de Ter,2009,6015,2961,3054,966,3989,1060
632,431325,Rodonyà,2009,508,278,230,81,318,109
633,431331,Roquetes,2009,8223,4339,3884,1276,5630,1317
634,171523,Roses,2009,20197,10298,9899,3311,13976,2910
635,251898,Rosselló,2009,2912,1485,1427,515,2006,391
636,431346,"Rourell, el",2009,380,197,183,69,239,72
637,081846,Rubí,2009,72987,36694,36293,12195,51980,8812
638,081859,Rubió,2009,202,105,97,29,132,41
639,171539,Rupià,2009,243,126,117,34,156,53
640,089019,Rupit i Pruit,2009,325,161,164,32,218,75
641,081878,Sabadell,2009,206493,101295,105198,31862,140540,34091
642,081884,Sagàs,2009,134,67,67,24,78,32
643,251902,Salàs de Pallars,2009,342,168,174,16,219,107
644,081901,Saldes,2009,348,197,151,35,249,64
645,171544,Sales de Llierca,2009,141,75,66,22,107,12
646,081918,Sallent,2009,7129,3454,3675,941,4560,1628
647,431359,Salomó,2009,501,271,230,73,319,109
648,439057,Salou,2009,26649,14429,12220,3866,20525,2258
649,171557,Salt,2009,29985,16132,13853,5519,21128,3338
650,251919,Sanaüja,2009,457,238,219,62,265,130
651,081944,Sant Adrià de Besòs,2009,33761,16622,17139,5553,22621,5587
652,081957,Sant Agustí de Lluçanès,2009,101,53,48,7,74,20
653,081960,Sant Andreu de la Barca,2009,26401,13423,12978,4980,18765,2656
654,081976,Sant Andreu de Llavaneres,2009,10181,5083,5098,1886,6940,1355
655,171576,Sant Andreu Salou,2009,152,75,77,26,90,36
656,171833,Sant Aniol de Finestres,2009,327,173,154,48,219,60
657,081982,Sant Antoni de Vilamajor,2009,5444,2726,2718,1022,3745,677
658,081995,Sant Bartomeu del Grau,2009,957,493,464,148,666,143
659,082009,Sant Boi de Llobregat,2009,82428,40937,41491,12439,57609,12380
660,082016,Sant Boi de Lluçanès,2009,569,291,278,61,359,149
661,431362,Sant Carles de la Ràpita,2009,15511,7767,7744,2273,10408,2830
662,082037,Sant Cebrià de Vallalta,2009,3309,1716,1593,597,2374,338
663,082021,Sant Celoni,2009,16860,8441,8419,2769,11516,2575
664,082042,Sant Climent de Llobregat,2009,3779,1898,1881,723,2629,427
665,171582,Sant Climent Sescebes,2009,513,273,240,62,320,131
666,082055,Sant Cugat del Vallès,2009,79253,38789,40464,16936,54205,8112
667,082068,Sant Cugat Sesgarrigues,2009,932,475,457,159,607,166
668,251961,Sant Esteve de la Sarga,2009,143,89,54,4,98,41
669,082074,Sant Esteve de Palautordera,2009,2458,1210,1248,545,1648,265
670,082080,Sant Esteve Sesrovires,2009,7202,3660,3542,1353,5005,844
671,171595,Sant Feliu de Buixalleu,2009,811,430,381,113,556,142
672,082107,Sant Feliu de Codines,2009,5702,2915,2787,969,3849,884
673,171609,Sant Feliu de Guíxols,2009,21977,10997,10980,3347,15028,3602
674,082114,Sant Feliu de Llobregat,2009,42919,20937,21982,6975,29902,6042
675,171616,Sant Feliu de Pallerols,2009,1397,682,715,234,890,273
676,082129,Sant Feliu Sasserra,2009,641,324,317,84,416,141
677,171621,Sant Ferriol,2009,216,124,92,36,139,41
678,082093,Sant Fost de Campsentelles,2009,8234,4142,4092,1332,5714,1188
679,082135,Sant Fruitós de Bages,2009,7961,4031,3930,1392,5598,971
680,171637,Sant Gregori,2009,3167,1610,1557,575,2159,433
681,251924,Sant Guim de Freixenet,2009,1126,563,563,152,729,245
682,251977,Sant Guim de la Plana,2009,191,103,88,29,111,51
683,171642,Sant Hilari Sacalm,2009,5763,3006,2757,788,3933,1042
684,082153,Sant Hipòlit de Voltregà,2009,3447,1743,1704,544,2243,660
685,081939,Sant Iscle de Vallalta,2009,1267,659,608,228,848,191
686,439023,Sant Jaume d'Enveja,2009,3528,1799,1729,464,2288,776
687,082166,Sant Jaume de Frontanyà,2009,29,14,15,4,20,5
688,171655,Sant Jaume de Llierca,2009,809,414,395,82,497,230
689,431378,Sant Jaume dels Domenys,2009,2388,1249,1139,396,1626,366
690,171674,Sant Joan de les Abadesses,2009,3556,1779,1777,394,2269,893
691,171680,Sant Joan de Mollet,2009,517,257,260,86,327,104
692,082188,Sant Joan de Vilatorrada,2009,10779,5472,5307,1778,7373,1628
693,082172,Sant Joan Despí,2009,32030,15701,16329,5606,22241,4183
694,171851,Sant Joan les Fonts,2009,2787,1421,1366,308,1868,611
695,171668,Sant Jordi Desvalls,2009,649,325,324,87,416,146
696,089030,Sant Julià de Cerdanyola,2009,273,146,127,45,168,60
697,171693,Sant Julià de Ramis,2009,3233,1637,1596,609,2250,374
698,082205,Sant Julià de Vilatorta,2009,2955,1446,1509,546,2002,407
699,179032,Sant Julià del Llor i Bonmatí,2009,1276,637,639,202,887,187
700,082212,Sant Just Desvern,2009,15811,7549,8262,2629,10720,2462
701,082227,Sant Llorenç d'Hortons,2009,2419,1233,1186,432,1669,318
702,171714,Sant Llorenç de la Muga,2009,213,109,104,28,136,49
703,251930,Sant Llorenç de Morunys,2009,1084,557,527,133,696,255
704,082233,Sant Llorenç Savall,2009,2402,1207,1195,378,1551,473
705,082251,Sant Martí d'Albars,2009,113,59,54,11,75,27
706,082248,Sant Martí de Centelles,2009,1001,532,469,172,687,142
707,171729,Sant Martí de Llémena,2009,545,287,258,92,365,88
708,259025,Sant Martí de Riucorb,2009,697,360,337,70,417,210
709,082264,Sant Martí de Tous,2009,1160,580,580,225,708,227
710,082270,Sant Martí Sarroca,2009,3142,1579,1563,504,2089,549
711,082286,Sant Martí Sesgueioles,2009,371,186,185,55,242,74
712,171735,Sant Martí Vell,2009,250,131,119,54,151,45
713,082299,Sant Mateu de Bages,2009,658,346,312,61,397,200
714,171740,Sant Miquel de Campmajor,2009,252,129,123,31,179,42
715,171753,Sant Miquel de Fluvià,2009,782,408,374,113,532,137
716,171766,Sant Mori,2009,180,89,91,18,140,22
717,171772,Sant Pau de Segúries,2009,717,361,356,76,460,181
718,082310,Sant Pere de Ribes,2009,28353,14365,13988,4908,20259,3186
719,082325,Sant Pere de Riudebitlles,2009,2376,1198,1178,388,1554,434
720,082331,Sant Pere de Torelló,2009,2389,1204,1185,327,1613,449
721,082346,Sant Pere de Vilamajor,2009,4021,2013,2008,798,2724,499
722,171788,Sant Pere Pescador,2009,2029,1099,930,297,1423,309
723,081897,Sant Pere Sallavinera,2009,171,88,83,17,107,47
724,082359,Sant Pol de Mar,2009,5102,2568,2534,828,3486,788
725,082362,Sant Quintí de Mediona,2009,2167,1104,1063,369,1391,407
726,082378,Sant Quirze de Besora,2009,2257,1106,1151,295,1430,532
727,082384,Sant Quirze del Vallès,2009,18462,9107,9355,3636,13159,1667
728,082397,Sant Quirze Safaja,2009,645,322,323,126,459,60
729,251945,Sant Ramon,2009,563,306,257,54,346,163
730,082401,Sant Sadurní d'Anoia,2009,12237,6067,6170,2089,8311,1837
731,082418,Sant Sadurní d'Osormort,2009,101,56,45,14,66,21
732,080983,Sant Salvador de Guardiola,2009,3082,1577,1505,581,2084,417
733,082628,Sant Vicenç de Castellet,2009,8564,4277,4287,1175,5826,1563
734,082649,Sant Vicenç de Montalt,2009,5627,2858,2769,1251,3733,643
735,082652,Sant Vicenç de Torelló,2009,1996,966,1030,332,1277,387
736,082634,Sant Vicenç dels Horts,2009,27701,13897,13804,4752,19264,3685
737,431384,Santa Bàrbara,2009,3955,2041,1914,575,2548,832
738,082439,Santa Cecília de Voltregà,2009,190,97,93,25,128,37
739,082444,Santa Coloma de Cervelló,2009,7744,3844,3900,1636,5321,787
740,171805,Santa Coloma de Farners,2009,11739,6057,5682,1930,8064,1745
741,082457,Santa Coloma de Gramenet,2009,119717,60889,58828,16752,83551,19414
742,431397,Santa Coloma de Queralt,2009,3167,1617,1550,551,2008,608
743,171812,Santa Cristina d'Aro,2009,5017,2559,2458,894,3444,679
744,082460,Santa Eugènia de Berga,2009,2231,1156,1075,299,1610,322
745,082476,Santa Eulàlia de Riuprimer,2009,1052,540,512,158,726,168
746,082482,Santa Eulàlia de Ronçana,2009,6802,3426,3376,1209,4608,985
747,082495,Santa Fe del Penedès,2009,389,197,192,81,257,51
748,171827,Santa Llogaia d'Àlguema,2009,335,181,154,60,235,40
749,082508,Santa Margarida de Montbui,2009,9834,4952,4882,1652,6787,1395
750,082515,Santa Margarida i els Monjos,2009,6989,3615,3374,1288,4936,765
751,082589,Santa Maria d'Oló,2009,1086,560,526,149,709,228
752,082536,Santa Maria de Besora,2009,163,82,81,12,104,47
753,082567,Santa Maria de Martorelles,2009,850,431,419,142,600,108
754,082554,Santa Maria de Merlès,2009,163,83,80,32,101,30
755,082573,Santa Maria de Miralles,2009,130,65,65,13,91,26
756,082592,Santa Maria de Palautordera,2009,8823,4546,4277,1568,6084,1171
757,431401,Santa Oliva,2009,3240,1674,1566,560,2173,507
758,171848,Santa Pau,2009,1610,810,800,208,1101,301
759,082606,Santa Perpètua de Mogoda,2009,25048,12889,12159,4586,17805,2657
760,082613,Santa Susanna,2009,3251,1670,1581,594,2245,412
761,081923,Santpedor,2009,6875,3464,3411,1133,4766,976
762,431423,Sarral,2009,1715,891,824,260,1124,331
763,171864,Sarrià de Ter,2009,4468,2223,2245,672,3035,761
764,252017,Sarroca de Bellera,2009,133,77,56,4,86,43
765,252000,Sarroca de Lleida,2009,432,229,203,33,276,123
766,171870,"Saus, Camallera i Llampaies",2009,768,370,398,103,516,149
767,431439,Savallà del Comtat,2009,71,36,35,6,43,22
768,431444,"Secuita, la",2009,1522,780,742,248,1066,208
769,171886,"Selva de Mar, la",2009,226,116,110,21,156,49
770,431457,"Selva del Camp, la",2009,5376,2730,2646,1022,3579,775
771,431460,Senan,2009,59,36,23,11,37,11
772,430445,"Sénia, la",2009,6179,3161,3018,905,4247,1027
773,252022,Senterada,2009,145,77,68,13,108,24
774,250352,"Sentiu de Sió, la",2009,496,245,251,34,329,133
775,082671,Sentmenat,2009,7870,3983,3887,1401,5553,916
776,171903,Serinyà,2009,1095,556,539,169,743,183
777,252043,Seròs,2009,1864,1042,822,210,1217,437
778,171910,Serra de Daró,2009,194,111,83,26,117,51
779,171925,Setcases,2009,173,96,77,11,114,48
780,252038,"Seu d'Urgell, la",2009,13063,6452,6611,1993,8982,2088
781,082690,Seva,2009,3370,1737,1633,585,2274,511
782,252056,Sidamon,2009,756,376,380,122,510,124
783,171931,Sils,2009,5127,2631,2496,926,3564,637
784,082704,Sitges,2009,27668,13801,13867,4336,19404,3928
785,170524,Siurana,2009,206,107,99,28,125,53
786,082711,Sobremunt,2009,98,51,47,12,66,20
787,252069,"Soleràs, el",2009,398,210,188,51,233,114
788,431476,Solivella,2009,685,346,339,111,384,190
789,252075,Solsona,2009,9233,4687,4546,1551,6115,1567
790,082726,Sora,2009,180,101,79,24,121,35
791,252081,Soriguera,2009,370,201,169,40,256,74
792,252094,Sort,2009,2382,1218,1164,374,1627,381
793,252108,Soses,2009,1716,907,809,240,1179,297
794,082732,Subirats,2009,3099,1566,1533,523,1999,577
795,252115,Sudanell,2009,887,488,399,98,617,172
796,252120,Sunyer,2009,296,153,143,33,186,77
797,082747,Súria,2009,6438,3162,3276,832,4157,1449
798,171946,Susqueda,2009,130,73,57,13,89,28
799,082763,Tagamanent,2009,308,163,145,54,200,54
800,082779,Talamanca,2009,162,91,71,25,120,17
801,252154,Talarn,2009,397,197,200,58,251,88
802,252167,Talavera,2009,297,162,135,33,188,76
803,171959,"Tallada d'Empordà, la",2009,420,213,207,54,262,104
804,082785,Taradell,2009,5964,3046,2918,989,3990,985
805,431482,Tarragona,2009,140323,69512,70811,22385,97381,20557
806,252173,Tàrrega,2009,16539,8335,8204,2769,11375,2395
807,252189,Tarrés,2009,108,54,54,7,70,31
808,252192,Tarroja de Segarra,2009,178,91,87,21,106,51
809,082750,Tavèrnoles,2009,302,153,149,44,213,45
810,082802,Tavertet,2009,158,86,72,10,114,34
811,082819,Teià,2009,6087,3055,3032,942,4252,893
812,252206,Térmens,2009,1536,795,741,182,1020,334
813,171962,Terrades,2009,301,149,152,47,200,54
814,082798,Terrassa,2009,210941,105046,105895,34876,145294,30771
815,082824,Tiana,2009,7590,3715,3875,1396,5330,864
816,252213,Tírvia,2009,143,74,69,14,99,30
817,252228,Tiurana,2009,85,40,45,12,49,24
818,431495,Tivenys,2009,959,489,470,118,569,272
819,431508,Tivissa,2009,1815,929,886,196,1149,470
820,082830,Tona,2009,7955,3975,3980,1421,5353,1181
821,252234,Torà,2009,1367,705,662,186,912,269
822,082845,Tordera,2009,15345,7865,7480,2508,10588,2249
823,082858,Torelló,2009,13808,6869,6939,2066,9443,2299
824,252249,"Torms, els",2009,174,93,81,18,96,60
825,252252,Tornabous,2009,857,463,394,86,538,233
826,252271,"Torre de Cabdella, la",2009,811,409,402,54,533,224
827,082861,"Torre de Claramunt, la",2009,3726,1956,1770,689,2630,407
828,431515,"Torre de Fontaubella, la",2009,147,76,71,16,84,47
829,431520,"Torre de l'Espanyol, la",2009,678,353,325,78,422,178
830,252265,Torrebesses,2009,300,155,145,27,184,89
831,431536,Torredembarra,2009,15272,7641,7631,2394,10594,2284
832,252287,Torrefarrera,2009,3911,2004,1907,764,2760,387
833,259078,Torrefeta i Florejacs,2009,633,331,302,75,380,178
834,252304,Torregrossa,2009,2255,1148,1107,271,1424,560
835,252311,Torrelameu,2009,685,386,299,69,470,146
836,082877,Torrelavit,2009,1372,741,631,169,943,260
837,082883,Torrelles de Foix,2009,2463,1290,1173,404,1628,431
838,082896,Torrelles de Llobregat,2009,5430,2722,2708,1096,3821,513
839,171978,Torrent,2009,193,101,92,18,136,39
840,252326,Torres de Segre,2009,2052,1062,990,276,1366,410
841,252332,Torre-serona,2009,358,187,171,36,233,89
842,171984,Torroella de Fluvià,2009,678,352,326,106,478,94
843,171997,Torroella de Montgrí,2009,11598,5880,5718,1867,7986,1745
844,431541,Torroja del Priorat,2009,165,96,69,12,104,49
845,172001,Tortellà,2009,760,377,383,96,457,207
846,431554,Tortosa,2009,35143,17905,17238,5006,23826,6311
847,172018,Toses,2009,160,98,62,17,107,36
848,172023,Tossa de Mar,2009,5948,3047,2901,826,4154,968
849,252347,Tremp,2009,6228,3118,3110,854,3943,1431
850,172044,Ullà,2009,1076,616,460,162,777,137
851,082900,Ullastrell,2009,1864,950,914,382,1270,212
852,172057,Ullastret,2009,239,124,115,39,150,50
853,431567,Ulldecona,2009,7236,3759,3477,1019,4915,1302
854,431573,Ulldemolins,2009,481,266,215,38,281,162
855,172039,Ultramort,2009,196,110,86,14,123,59
856,172060,Urús,2009,201,103,98,23,140,38
857,082917,Vacarisses,2009,5872,3029,2843,1271,4010,591
858,170144,"Vajol, la",2009,98,58,40,8,71,19
859,172076,"Vall d'en Bas, la",2009,2780,1395,1385,388,1795,597
860,172082,"Vall de Bianya, la",2009,1321,668,653,217,885,219
861,250432,"Vall de Boí, la",2009,1090,586,504,118,818,154
862,259010,Vall de Cardós,2009,420,224,196,53,275,92
863,082922,Vallbona d'Anoia,2009,1427,736,691,220,993,214
864,252385,Vallbona de les Monges,2009,251,129,122,18,147,86
865,082938,Vallcebre,2009,264,150,114,19,168,77
866,431589,Vallclara,2009,123,70,53,15,74,34
867,252402,Vallfogona de Balaguer,2009,1769,896,873,229,1238,302
868,171707,Vallfogona de Ripollès,2009,221,120,101,21,147,53
869,431592,Vallfogona de Riucorb,2009,119,69,50,1,67,51
870,082943,Vallgorguina,2009,2465,1269,1196,494,1720,251
871,082956,Vallirana,2009,14066,7033,7033,2588,9697,1781
872,172095,Vall-llobrega,2009,853,432,421,193,585,75
873,431606,Vallmoll,2009,1630,853,777,238,1167,225
874,082969,Vallromanes,2009,2283,1166,1117,527,1535,221
875,431613,Valls,2009,25092,12672,12420,3939,17196,3957
876,259062,"Valls d'Aguilar, les",2009,307,166,141,20,203,84
877,252398,"Valls de Valira, les",2009,832,456,376,62,609,161
878,431628,Vandellòs i l'Hospitalet de l'Infant,2009,5754,2865,2889,878,4008,868
879,259097,"Vansa i Fórnols, la",2009,213,116,97,18,138,57
880,082975,Veciana,2009,172,92,80,24,101,47
881,431634,"Vendrell, el",2009,35821,18039,17782,6084,25005,4732
882,172109,Ventalló,2009,780,410,370,103,513,164
883,252424,Verdú,2009,1025,492,533,124,603,298
884,172116,Verges,2009,1162,576,586,150,742,270
885,431649,Vespella de Gaià,2009,404,225,179,57,295,52
886,082981,Vic,2009,39844,19940,19904,6744,26957,6143
887,172121,Vidrà,2009,173,89,84,25,118,30
888,172137,Vidreres,2009,7430,3843,3587,1285,5069,1076
889,252430,Vielha e Mijaran,2009,5710,3016,2694,818,4383,509
890,431652,Vilabella,2009,799,412,387,95,519,185
891,172142,Vilabertran,2009,882,469,413,124,580,178
892,172155,Vilablareix,2009,2283,1123,1160,383,1662,238
893,082994,Vilada,2009,520,257,263,40,339,141
894,172174,Viladamat,2009,466,241,225,62,310,94
895,172168,Viladasens,2009,217,111,106,26,147,44
896,083015,Viladecans,2009,63489,31891,31598,10834,44794,7861
897,083008,Viladecavalls,2009,7322,3674,3648,1407,5223,692
898,172180,Vilademuls,2009,786,408,378,113,507,166
899,172207,Viladrau,2009,1100,567,533,178,750,172
900,172214,Vilafant,2009,5416,2676,2740,924,3835,657
901,083054,Vilafranca del Penedès,2009,38425,19145,19280,6199,26543,5683
902,252445,Vilagrassa,2009,455,233,222,68,284,103
903,172235,Vilajuïga,2009,1149,561,588,204,749,196
904,431750,Vilalba dels Arcs,2009,724,380,344,72,429,223
905,083067,Vilalba Sasserra,2009,636,331,305,104,448,84
906,252458,Vilaller,2009,715,412,303,66,528,121
907,172240,Vilallonga de Ter,2009,478,256,222,45,315,118
908,431665,Vilallonga del Camp,2009,1889,959,930,293,1347,249
909,172253,Vilamacolum,2009,322,167,155,43,215,64
910,172266,Vilamalla,2009,1134,607,527,193,804,137
911,172272,Vilamaniscle,2009,169,91,78,28,112,29
912,252477,Vilamòs,2009,174,95,79,20,134,20
913,172288,Vilanant,2009,356,175,181,53,237,66
914,431671,Vilanova d'Escornalbou,2009,559,308,251,79,389,91
915,252483,Vilanova de Bellpuig,2009,1170,602,568,128,731,311
916,252496,Vilanova de l'Aguda,2009,234,117,117,32,127,75
917,252542,Vilanova de la Barca,2009,1273,643,630,157,860,256
918,252509,Vilanova de Meià,2009,418,219,199,33,253,132
919,431687,Vilanova de Prades,2009,144,77,67,15,92,37
920,083036,Vilanova de Sau,2009,336,160,176,40,235,61
921,252516,Vilanova de Segrià,2009,845,446,399,96,600,149
922,083020,Vilanova del Camí,2009,12649,6419,6230,2265,8837,1547
923,089024,Vilanova del Vallès,2009,4654,2389,2265,1013,3159,482
924,083073,Vilanova i la Geltrú,2009,65890,32431,33459,10213,45297,10380
925,431690,Vilaplana,2009,614,311,303,63,408,143
926,431704,Vila-rodona,2009,1260,644,616,189,837,234
927,172305,Vila-sacra,2009,598,287,311,82,419,97
928,252521,Vila-sana,2009,696,347,349,96,456,144
929,431711,Vila-seca,2009,20866,10671,10195,3433,15306,2127
930,082140,Vilassar de Dalt,2009,8672,4265,4407,1341,5966,1365
931,082191,Vilassar de Mar,2009,19482,9453,10029,3329,13243,2910
932,172229,Vilaür,2009,140,68,72,17,90,33
933,431726,Vilaverd,2009,494,243,251,71,313,110
934,431732,"Vilella Alta, la",2009,114,65,49,14,68,32
935,431747,"Vilella Baixa, la",2009,206,113,93,29,134,43
936,172333,Vilobí d'Onyar,2009,2956,1548,1408,479,2026,451
937,083041,Vilobí del Penedès,2009,1112,574,538,178,750,184
938,172327,Vilopriu,2009,221,120,101,37,135,49
939,252537,"Vilosell, el",2009,200,98,102,8,129,63
940,431763,Vimbodí i Poblet,2009,1077,599,478,131,674,272
941,252555,Vinaixa,2009,607,313,294,58,398,151
942,431779,Vinebre,2009,483,238,245,58,312,113
943,431785,Vinyols i els Arcs,2009,1829,949,880,280,1287,262
944,083089,Viver i Serrateix,2009,186,98,88,30,114,42
945,430521,Xerta,2009,1300,641,659,166,793,341
946,000000,Catalunya,2009,7475420,3713765,3761655,1119851,5138050,1217519
0,250019,Abella de la Conca,2010,181,104,77,24,117,40
1,080018,Abrera,2010,11469,5905,5564,2065,8098,1306
2,250024,Àger,2010,584,313,271,48,357,179
3,250030,Agramunt,2010,5618,2868,2750,874,3744,1000
4,080023,Aguilar de Segarra,2010,253,133,120,35,161,57
5,170010,Agullana,2010,840,438,402,109,543,188
6,080142,Aiguafreda,2010,2505,1207,1298,380,1621,504
7,430017,Aiguamúrcia,2010,914,482,432,116,632,166
8,170025,Aiguaviva,2010,727,368,359,153,480,94
9,250387,Aitona,2010,2393,1258,1135,296,1540,557
10,250045,"Alamús, els",2010,739,384,355,83,485,171
11,250058,Alàs i Cerc,2010,386,208,178,41,247,98
12,250061,"Albagés, l'",2010,462,250,212,48,280,134
13,170031,Albanyà,2010,149,83,66,25,106,18
14,250077,Albatàrrec,2010,1979,1040,939,321,1420,238
15,250083,Albesa,2010,1679,891,788,233,1104,342
16,250096,"Albi, l'",2010,847,437,410,111,519,217
17,430022,Albinyana,2010,2314,1163,1151,367,1531,416
18,430038,"Albiol, l'",2010,418,214,204,89,284,45
19,170046,Albons,2010,710,369,341,112,483,115
20,430043,Alcanar,2010,10545,5429,5116,1440,7184,1921
21,250100,Alcanó,2010,235,113,122,20,147,68
22,250117,Alcarràs,2010,8029,4165,3864,1223,5732,1074
23,250122,Alcoletge,2010,2816,1467,1349,422,2033,361
24,430056,Alcover,2010,5143,2618,2525,876,3473,794
25,439044,"Aldea, l'",2010,4376,2319,2057,596,2924,856
26,430069,Aldover,2010,977,486,491,122,601,254
27,430075,"Aleixar, l'",2010,911,453,458,164,583,164
28,080039,Alella,2010,9557,4702,4855,1554,6667,1336
29,430081,Alfara de Carles,2010,398,209,189,36,253,109
30,250138,Alfarràs,2010,3158,1639,1519,467,2022,669
31,250143,Alfés,2010,337,178,159,33,222,82
32,430094,Alforja,2010,1897,984,913,265,1274,358
33,250156,Algerri,2010,462,241,221,37,259,166
34,250169,Alguaire,2010,3140,1659,1481,431,2105,604
35,250175,Alins,2010,313,166,147,34,193,86
36,430108,Alió,2010,386,195,191,44,265,77
37,250194,Almacelles,2010,6577,3451,3126,915,4445,1217
38,250208,Almatret,2010,399,211,188,22,228,149
39,250215,Almenar,2010,3631,1914,1717,455,2393,783
40,430115,Almoster,2010,1384,692,692,266,967,151
41,250220,Alòs de Balaguer,2010,144,85,59,10,75,59
42,170062,Alp,2010,1733,928,805,252,1304,177
43,080044,Alpens,2010,303,164,139,45,203,55
44,250236,Alpicat,2010,6116,3052,3064,1183,4214,719
45,250241,Alt Àneu,2010,446,255,191,45,320,81
46,430120,Altafulla,2010,4711,2355,2356,820,3286,605
47,170078,Amer,2010,2306,1144,1162,265,1514,527
48,430136,"Ametlla de Mar, l'",2010,7594,3868,3726,1141,4993,1460
49,080057,"Ametlla del Vallès, l'",2010,8112,4073,4039,1625,5618,869
50,439060,"Ampolla, l'",2010,3540,1839,1701,420,2405,715
51,430141,Amposta,2010,21365,10855,10510,3382,14633,3350
52,170084,Anglès,2010,5560,2801,2759,914,3645,1001
53,250273,Anglesola,2010,1355,682,673,187,845,323
54,250292,Arbeca,2010,2469,1275,1194,293,1562,614
55,430167,"Arboç, l'",2010,5469,2861,2608,1011,3681,777
56,430154,Arbolí,2010,113,62,51,5,82,26
57,170097,Arbúcies,2010,6647,3515,3132,1127,4516,1004
58,080060,Arenys de Mar,2010,14688,7202,7486,2116,9821,2751
59,080076,Arenys de Munt,2010,8335,4181,4154,1475,5652,1208
60,170101,Argelaguer,2010,425,227,198,62,281,82
61,080082,Argençola,2010,245,142,103,34,172,39
62,430173,"Argentera, l'",2010,135,77,58,4,92,39
63,080095,Argentona,2010,11718,5805,5913,2100,7921,1697
64,170118,"Armentera, l'",2010,865,420,445,119,545,201
65,430189,Arnes,2010,505,266,239,48,276,181
66,250313,Arres,2010,63,41,22,7,44,12
67,250328,Arsèguel,2010,103,57,46,13,72,18
68,080109,Artés,2010,5515,2769,2746,849,3716,950
69,250334,Artesa de Lleida,2010,1525,800,725,262,956,307
70,250349,Artesa de Segre,2010,3839,1966,1873,567,2518,754
71,430192,Ascó,2010,1634,845,789,162,1103,369
72,250365,Aspa,2010,242,127,115,25,136,81
73,250371,"Avellanes i Santa Linya, les",2010,463,259,204,44,269,150
74,080116,Avià,2010,2223,1107,1116,341,1447,435
75,080121,Avinyó,2010,2336,1173,1163,369,1486,481
76,170123,Avinyonet de Puigventós,2010,1517,768,749,324,1056,137
77,080137,Avinyonet del Penedès,2010,1685,907,778,286,1108,291
78,080155,Badalona,2010,218886,109460,109426,33477,151928,33481
79,089045,Badia del Vallès,2010,13703,6746,6957,2168,9344,2191
80,080168,Bagà,2010,2361,1176,1185,261,1558,542
81,250390,Baix Pallars,2010,406,215,191,57,251,98
82,250404,Balaguer,2010,16766,8535,8231,2750,11239,2777
83,080174,Balenyà,2010,3702,1850,1852,616,2553,533
84,080180,Balsareny,2010,3485,1758,1727,442,2361,682
85,430206,Banyeres del Penedès,2010,2952,1534,1418,560,2006,386
86,170157,Banyoles,2010,18780,9410,9370,3355,12380,3045
87,250411,Barbens,2010,887,479,408,107,543,237
88,430213,Barberà de la Conca,2010,537,294,243,77,342,118
89,082520,Barberà del Vallès,2010,31688,15771,15917,5297,22703,3688
90,080193,Barcelona,2010,1619337,770044,849293,195175,1091111,333051
91,250426,"Baronia de Rialb, la",2010,261,138,123,33,163,65
92,170160,Bàscara,2010,963,505,458,140,604,219
93,250447,Bassella,2010,259,137,122,32,164,63
94,430228,Batea,2010,2174,1117,1057,254,1363,557
95,250450,Bausen,2010,61,35,26,4,30,27
96,080207,Begues,2010,6348,3161,3187,1336,4423,589
97,170139,Begur,2010,4209,2143,2066,577,2892,740
98,250463,Belianes,2010,584,299,285,72,338,174
99,251706,Bellaguarda,2010,334,178,156,37,186,111
100,170182,Bellcaire d'Empordà,2010,673,333,340,113,431,129
101,250479,Bellcaire d'Urgell,2010,1341,671,670,164,818,359
102,250485,Bell-lloc d'Urgell,2010,2448,1204,1244,371,1585,492
103,250498,Bellmunt d'Urgell,2010,211,98,113,27,128,56
104,430234,Bellmunt del Priorat,2010,350,175,175,44,218,88
105,080214,Bellprat,2010,97,54,43,9,61,27
106,250501,Bellpuig,2010,4942,2573,2369,762,3313,867
107,430249,Bellvei,2010,2110,1101,1009,413,1405,292
108,250518,Bellver de Cerdanya,2010,2260,1181,1079,290,1571,399
109,250523,Bellvís,2010,2506,1289,1217,302,1620,584
110,250539,Benavent de Segrià,2010,1522,784,738,311,1026,185
111,430252,Benifallet,2010,788,388,400,65,468,255
112,430265,Benissanet,2010,1263,669,594,152,828,283
113,080229,Berga,2010,17161,8533,8628,2398,11300,3463
114,170195,Besalú,2010,2360,1133,1227,335,1513,512
115,170209,Bescanó,2010,4555,2269,2286,866,3001,688
116,170216,Beuda,2010,161,83,78,20,114,27
117,080235,Bigues i Riells del Fai,2010,8664,4446,4218,1696,5997,971
118,250557,Biosca,2010,216,122,94,15,134,67
119,170221,"Bisbal d'Empordà, la",2010,10397,5259,5138,1753,6983,1661
120,430271,"Bisbal de Falset, la",2010,237,125,112,30,136,71
121,430287,"Bisbal del Penedès, la",2010,3343,1729,1614,519,2267,557
122,172348,Biure,2010,242,124,118,26,164,52
123,430290,Blancafort,2010,433,222,211,50,274,109
124,170237,Blanes,2010,40010,20184,19826,6251,27790,5969
125,170293,Boadella i les Escaules,2010,255,126,129,32,175,48
126,170242,Bolvir,2010,395,209,186,48,285,62
127,430304,Bonastre,2010,640,337,303,96,446,98
128,250576,"Bòrdes, Es",2010,245,131,114,26,178,41
129,170255,Bordils,2010,1715,860,855,289,1159,267
130,250582,"Borges Blanques, les",2010,6049,3087,2962,858,3979,1212
131,430311,"Borges del Camp, les",2010,2141,1066,1075,397,1386,358
132,170268,Borrassà,2010,684,354,330,110,451,123
133,080240,Borredà,2010,604,325,279,83,376,145
134,250595,Bossòst,2010,1184,608,576,168,847,169
135,430326,Bot,2010,683,356,327,54,402,227
136,430332,Botarell,2010,1085,580,505,187,776,122
137,250560,Bovera,2010,341,177,164,20,185,136
138,430347,Bràfim,2010,680,337,343,84,455,141
139,170274,Breda,2010,3771,1914,1857,542,2496,733
140,080253,"Bruc, el",2010,1956,1053,903,381,1353,222
141,080266,"Brull, el",2010,255,138,117,52,165,38
142,170280,Brunyola i Sant Martí Sapresa,2010,367,183,184,41,232,94
143,430350,Cabacés,2010,347,180,167,41,219,87
144,250609,Cabanabona,2010,110,49,61,11,52,47
145,170314,Cabanelles,2010,237,136,101,21,171,45
146,170307,Cabanes,2010,915,481,434,150,583,182
147,080272,"Cabanyes, les",2010,902,453,449,191,608,103
148,250616,Cabó,2010,95,51,44,6,59,30
149,430363,Cabra del Camp,2010,1146,616,530,203,749,194
150,080288,Cabrera d'Anoia,2010,1343,720,623,231,949,163
151,080291,Cabrera de Mar,2010,4504,2264,2240,787,3128,589
152,080305,Cabrils,2010,7108,3490,3618,1546,4839,723
153,170329,Cadaqués,2010,2892,1432,1460,454,1996,442
154,080312,Calaf,2010,3611,1918,1693,541,2434,636
155,430379,Calafell,2010,24423,12358,12065,3810,17103,3510
156,080348,Calders,2010,934,480,454,155,618,161
157,080327,Caldes d'Estrac,2010,2783,1355,1428,399,1892,492
158,170335,Caldes de Malavella,2010,6920,3431,3489,1242,4689,989
159,080333,Caldes de Montbui,2010,17019,8535,8484,2863,11625,2531
160,080351,Calella,2010,18625,9244,9381,2797,12671,3157
161,080370,Calldetenes,2010,2425,1241,1184,384,1734,307
162,080386,Callús,2010,1845,896,949,339,1170,336
163,080364,Calonge de Segarra,2010,194,103,91,25,112,57
164,170340,Calonge i Sant Antoni,2010,10789,5433,5356,1637,7409,1743
165,250621,Camarasa,2010,979,509,470,93,626,260
166,439039,Camarles,2010,3617,1854,1763,524,2353,740
167,430385,Cambrils,2010,32422,16174,16248,5597,22820,4005
168,170353,Camós,2010,681,349,332,93,427,161
169,170366,Campdevànol,2010,3499,1731,1768,460,2175,864
170,170372,Campelles,2010,127,65,62,15,82,30
171,080399,Campins,2010,413,210,203,76,290,47
172,170388,Campllong,2010,467,241,226,98,302,67
173,170391,Camprodon,2010,2479,1226,1253,300,1624,555
174,250637,Canejan,2010,103,56,47,8,63,32
175,170405,Canet d'Adri,2010,618,314,304,78,427,113
176,080403,Canet de Mar,2010,13915,6860,7055,2161,9299,2455
177,439076,"Canonja, la",2010,0,0,0,0,0,0
178,080410,Canovelles,2010,16076,8402,7674,2832,11304,1940
179,080425,Cànoves i Samalús,2010,2809,1444,1365,486,1931,392
180,170412,Cantallops,2010,319,163,156,36,206,77
181,080431,Canyelles,2010,4196,2135,2061,833,2938,425
182,430398,Capafonts,2010,126,67,59,4,78,44
183,430402,Capçanes,2010,431,217,214,44,279,108
184,080446,Capellades,2010,5498,2720,2778,845,3656,997
185,170427,Capmany,2010,620,333,287,90,392,138
186,080459,Capolat,2010,82,37,45,16,49,17
187,080462,Cardedeu,2010,16897,8325,8572,3098,11622,2177
188,080478,Cardona,2010,5182,2551,2631,625,3293,1264
189,080484,Carme,2010,828,434,394,111,557,160
190,430419,Caseres,2010,294,144,150,29,169,96
191,170448,Cassà de la Selva,2010,9637,4981,4656,1568,6495,1574
192,080497,Casserres,2010,1583,789,794,153,1023,407
193,080575,Castell de l'Areny,2010,75,42,33,10,55,10
194,259046,Castell de Mur,2010,182,95,87,21,109,52
195,250642,Castellar de la Ribera,2010,156,78,78,25,88,43
196,080522,Castellar de n'Hug,2010,187,102,85,20,130,37
197,080500,Castellar del Riu,2010,163,86,77,30,103,30
198,080517,Castellar del Vallès,2010,23129,11489,11640,4286,16014,2829
199,080538,Castellbell i el Vilar,2010,3731,1895,1836,593,2490,648
200,080543,Castellbisbal,2010,12223,6278,5945,2531,8419,1273
201,080556,Castellcir,2010,664,351,313,131,428,105
202,250674,Castelldans,2010,1009,548,461,101,672,236
203,080569,Castelldefels,2010,62250,31087,31163,10735,44430,7085
204,080581,Castellet i la Gornal,2010,2240,1148,1092,361,1526,353
205,170464,Castellfollit de la Roca,2010,1048,530,518,142,662,244
206,080608,Castellfollit de Riubregós,2010,197,104,93,14,128,55
207,080594,Castellfollit del Boix,2010,410,202,208,64,256,90
208,080615,Castellgalí,2010,1958,1027,931,369,1308,281
209,080620,Castellnou de Bages,2010,1069,553,516,208,753,108
210,250680,Castellnou de Seana,2010,735,377,358,83,453,199
211,170470,Castelló d'Empúries,2010,12220,6300,5920,1940,8344,1936
212,250693,Castelló de Farfanya,2010,564,306,258,49,360,155
213,080636,Castellolí,2010,519,252,267,95,338,86
214,170486,Castell-Platja d'Aro,2010,10445,5280,5165,1457,7488,1500
215,250707,Castellserà,2010,1114,573,541,115,679,320
216,080641,Castellterçol,2010,2387,1182,1205,362,1547,478
217,430424,Castellvell del Camp,2010,2757,1387,1370,583,1908,266
218,080654,Castellví de la Marca,2010,1635,817,818,273,1063,299
219,080667,Castellví de Rosanes,2010,1755,884,871,326,1206,223
220,430430,"Catllar, el",2010,4124,2109,2015,728,2961,435
221,250714,Cava,2010,57,34,23,1,34,22
222,171899,"Cellera de Ter, la",2010,2141,1076,1065,326,1397,418
223,170499,Celrà,2010,4638,2301,2337,961,3225,452
224,080673,Centelles,2010,7259,3559,3700,1131,4869,1259
225,082687,Cercs,2010,1326,672,654,138,831,357
226,082665,Cerdanyola del Vallès,2010,58407,28867,29540,9088,41527,7792
227,080689,Cervelló,2010,8566,4322,4244,1434,6081,1051
228,250729,Cervera,2010,9361,4787,4574,1644,6288,1429
229,250735,Cervià de les Garrigues,2010,816,423,393,82,490,244
230,170502,Cervià de Ter,2010,895,450,445,167,573,155
231,170519,Cistella,2010,251,125,126,29,159,63
232,250740,Ciutadilla,2010,220,120,100,23,135,62
233,250753,Clariana de Cardener,2010,150,78,72,23,110,17
234,250766,"Cogul, el",2010,193,106,87,13,118,62
235,170545,Colera,2010,576,298,278,48,375,153
236,250772,Coll de Nargó,2010,619,312,307,61,411,147
237,080692,Collbató,2010,4114,2146,1968,955,2780,379
238,430458,Colldejou,2010,181,99,82,16,130,35
239,080706,Collsuspina,2010,347,185,162,55,236,56
240,170558,Colomers,2010,201,98,103,23,122,56
241,251636,"Coma i la Pedra, la",2010,271,165,106,26,196,49
242,251615,Conca de Dalt,2010,407,204,203,30,253,124
243,430461,Conesa,2010,120,64,56,6,86,28
244,430477,Constantí,2010,6356,3396,2960,1128,4388,840
245,080713,Copons,2010,320,156,164,62,203,55
246,430483,Corbera d'Ebre,2010,1171,629,542,144,751,276
247,080728,Corbera de Llobregat,2010,14000,7040,6960,2647,9813,1540
248,250788,Corbins,2010,1380,739,641,211,915,254
249,170577,Corçà,2010,1296,640,656,172,876,248
250,080734,Cornellà de Llobregat,2010,87240,43355,43885,13099,58822,15319
251,170561,Cornellà del Terri,2010,2210,1130,1080,336,1477,397
252,430496,Cornudella de Montsant,2010,1028,542,486,114,663,251
253,430509,Creixell,2010,3319,1712,1607,502,2212,605
254,170583,Crespià,2010,253,127,126,37,159,57
255,179011,"Cruïlles, Monells i Sant Sadurní de l'Heura",2010,1250,636,614,181,860,209
256,080749,Cubelles,2010,13995,7100,6895,2407,9767,1821
257,250791,Cubells,2010,407,213,194,50,234,123
258,430516,Cunit,2010,12464,6299,6165,2090,8311,2063
259,170600,Darnius,2010,529,269,260,51,342,136
260,170617,Das,2010,224,125,99,35,146,43
261,439018,Deltebre,2010,12098,6154,5944,1683,8011,2404
262,080752,Dosrius,2010,5010,2530,2480,961,3559,490
263,430537,Duesaigües,2010,240,138,102,24,154,62
264,170622,"Escala, l'",2010,10387,5324,5063,1378,7092,1917
265,080765,Esparreguera,2010,22042,11269,10773,3804,15414,2824
266,170638,Espinelves,2010,192,95,97,22,123,47
267,250812,"Espluga Calba, l'",2010,427,222,205,46,254,127
268,430542,"Espluga de Francolí, l'",2010,3949,1944,2005,550,2565,834
269,080771,Esplugues de Llobregat,2010,46649,22769,23880,6313,32028,8308
270,170643,Espolla,2010,408,201,207,43,255,110
271,170656,Esponellà,2010,461,225,236,86,283,92
272,250827,Espot,2010,360,191,169,49,257,54
273,080787,"Espunyola, l'",2010,262,132,130,35,155,72
274,082541,"Esquirol, l'",2010,2262,1147,1115,350,1437,475
275,250886,Estamariu,2010,118,67,51,11,67,40
276,080790,"Estany, l'",2010,389,194,195,47,239,103
277,250851,Estaràs,2010,177,96,81,15,115,47
278,250864,Esterri d'Àneu,2010,946,519,427,112,682,152
279,250870,Esterri de Cardós,2010,75,36,39,5,53,17
280,430555,Falset,2010,2935,1482,1453,453,1900,582
281,170059,"Far d'Empordà, el",2010,545,269,276,110,334,101
282,250899,Farrera,2010,133,78,55,18,96,19
283,430568,"Fatarella, la",2010,1130,568,562,108,675,347
284,430574,"Febró, la",2010,42,28,14,0,33,9
285,081347,Figaró-Montmany,2010,1083,543,540,177,690,216
286,080804,Fígols,2010,54,31,23,6,27,21
287,259084,Fígols i Alinyà,2010,282,155,127,22,165,95
288,430580,"Figuera, la",2010,135,75,60,7,94,34
289,170669,Figueres,2010,44255,22093,22162,7440,30419,6396
290,430593,Figuerola del Camp,2010,346,167,179,63,220,63
291,170675,Flaçà,2010,1070,528,542,141,714,215
292,430607,Flix,2010,4061,2065,1996,415,2730,916
293,250925,"Floresta, la",2010,179,100,79,22,106,51
294,080826,Fogars de la Selva,2010,1513,792,721,279,1035,199
295,080811,Fogars de Montclús,2010,455,242,213,90,284,81
296,170681,Foixà,2010,327,173,154,40,202,85
297,080832,Folgueroles,2010,2216,1126,1090,487,1431,298
298,250931,Fondarella,2010,830,423,407,117,590,123
299,080847,Fonollosa,2010,1401,720,681,221,986,194
300,170694,Fontanals de Cerdanya,2010,457,218,239,44,327,86
301,170708,Fontanilles,2010,160,94,66,23,96,41
302,170715,Fontcoberta,2010,1280,612,668,198,916,166
303,080850,Font-rubí,2010,1466,771,695,233,914,319
304,250946,Foradada,2010,188,109,79,15,120,53
305,179026,Forallac,2010,1749,863,886,225,1228,296
306,430614,Forès,2010,43,24,19,0,23,20
307,170736,Fornells de la Selva,2010,2343,1143,1200,501,1594,248
308,170741,Fortià,2010,642,328,314,96,402,144
309,080863,"Franqueses del Vallès, les",2010,18114,9315,8799,3227,12876,2011
310,430629,Freginals,2010,414,222,192,35,260,119
311,250962,"Fuliola, la",2010,1270,634,636,161,803,306
312,250978,Fulleda,2010,102,53,49,7,63,32
313,080902,Gaià,2010,177,95,82,32,119,26
314,430635,"Galera, la",2010,897,464,433,109,596,192
315,080879,Gallifa,2010,215,114,101,27,158,30
316,430640,Gandesa,2010,3222,1655,1567,432,2146,644
317,430653,Garcia,2010,594,294,300,61,363,170
318,430666,"Garidells, els",2010,201,103,98,21,145,35
319,080885,"Garriga, la",2010,15069,7319,7750,2692,10220,2157
320,170754,Garrigàs,2010,382,205,177,46,249,87
321,170767,Garrigoles,2010,157,87,70,17,98,42
322,170773,Garriguella,2010,858,428,430,131,555,172
323,080898,Gavà,2010,46383,23021,23362,7628,32188,6567
324,250984,Gavet de la Conca,2010,309,154,155,24,170,115
325,080919,Gelida,2010,6945,3517,3428,1232,4778,935
326,170789,Ger,2010,461,254,207,60,320,81
327,259123,Gimenells i el Pla de la Font,2010,1183,601,582,163,744,276
328,430672,Ginestar,2010,1022,535,487,122,651,249
329,170792,Girona,2010,96236,46883,49353,15820,67488,12928
330,080924,Gironella,2010,5067,2519,2548,605,3268,1194
331,080930,Gisclareny,2010,33,19,14,0,28,5
332,430688,Godall,2010,815,426,389,96,487,232
333,250997,Golmés,2010,1685,839,846,275,1133,277
334,170806,Gombrèn,2010,224,102,122,34,150,40
335,251001,Gósol,2010,225,122,103,16,154,55
336,080945,"Granada, la",2010,1963,1001,962,332,1346,285
337,251018,"Granadella, la",2010,772,412,360,83,465,224
338,080958,Granera,2010,79,50,29,5,59,15
339,251023,"Granja d'Escarp, la",2010,986,525,461,97,644,245
340,080961,Granollers,2010,59691,29747,29944,9220,41700,8771
341,251039,Granyanella,2010,156,80,76,16,100,40
342,251057,Granyena de les Garrigues,2010,177,102,75,16,111,50
343,251044,Granyena de Segarra,2010,139,69,70,5,75,59
344,430691,Gratallops,2010,263,140,123,35,164,64
345,080977,Gualba,2010,1235,627,608,244,833,158
346,170813,Gualta,2010,365,202,163,59,236,70
347,080996,Guardiola de Berguedà,2010,1024,547,477,127,658,239
348,430705,"Guiamets, els",2010,329,156,173,24,216,89
349,170828,Guils de Cerdanya,2010,519,273,246,60,391,68
350,251095,Guimerà,2010,330,178,152,15,186,129
351,259031,"Guingueta d'Àneu, la",2010,356,192,164,41,246,69
352,251109,Guissona,2010,6267,3358,2909,1181,4487,599
353,251116,Guixers,2010,135,78,57,11,92,32
354,081000,Gurb,2010,2526,1298,1228,484,1719,323
355,430712,Horta de Sant Joan,2010,1307,693,614,166,801,340
356,081017,"Hospitalet de Llobregat, l'",2010,258642,127125,131517,34403,176347,47892
357,081629,"Hostalets de Pierola, els",2010,2743,1422,1321,539,1924,280
358,170834,Hostalric,2010,3998,2038,1960,642,2752,604
359,081022,Igualada,2010,39149,19335,19814,6488,26052,6609
360,251155,Isona i Conca Dellà,2010,1150,612,538,124,674,352
361,170849,Isòvol,2010,309,179,130,27,226,56
362,251137,Ivars d'Urgell,2010,1716,922,794,214,1081,421
363,251121,Ivars de Noguera,2010,360,196,164,39,227,94
364,251142,Ivorra,2010,122,65,57,9,71,42
365,170852,Jafre,2010,432,232,200,46,283,103
366,170865,"Jonquera, la",2010,3106,1566,1540,501,2190,415
367,081038,Jorba,2010,823,407,416,153,529,141
368,259101,Josa i Tuixén,2010,141,78,63,7,102,32
369,170871,Juià,2010,325,181,144,64,199,62
370,251180,Juncosa,2010,479,253,226,48,286,145
371,251193,Juneda,2010,3487,1836,1651,468,2310,709
372,251214,Les,2010,983,493,490,137,720,126
373,251229,Linyola,2010,2774,1446,1328,430,1794,550
374,081043,"Llacuna, la",2010,937,507,430,113,610,214
375,170887,Lladó,2010,697,353,344,117,453,127
376,251235,Lladorre,2010,232,115,117,29,153,50
377,251240,Lladurs,2010,193,109,84,19,120,54
378,081056,"Llagosta, la",2010,13713,6884,6829,2257,9452,2004
379,170890,Llagostera,2010,7915,4075,3840,1302,5290,1323
380,170904,Llambilles,2010,690,358,332,129,457,104
381,170911,Llanars,2010,571,297,274,62,393,116
382,170926,Llançà,2010,5214,2611,2603,720,3474,1020
383,251253,Llardecans,2010,521,268,253,46,297,178
384,251266,Llavorsí,2010,380,199,181,42,259,79
385,251207,Lleida,2010,137387,68290,69097,21057,95241,21089
386,170932,Llers,2010,1172,597,575,172,779,221
387,251272,Lles de Cerdanya,2010,268,163,105,23,180,65
388,081075,Lliçà d'Amunt,2010,14356,7310,7046,2793,9790,1773
389,081081,Lliçà de Vall,2010,6365,3249,3116,1123,4419,823
390,251288,Llimiana,2010,173,96,77,18,108,47
391,081069,Llinars del Vallès,2010,9170,4536,4634,1518,6330,1322
392,170947,Llívia,2010,1608,868,740,213,1189,206
393,430727,"Lloar, el",2010,124,71,53,14,75,35
394,251291,Llobera,2010,209,112,97,25,132,52
395,430733,Llorac,2010,107,58,49,12,68,27
396,430748,Llorenç del Penedès,2010,2251,1110,1141,399,1458,394
397,170950,Lloret de Mar,2010,39794,20968,18826,6005,29745,4044
398,170963,"Llosses, les",2010,221,126,95,22,160,39
399,081094,Lluçà,2010,265,140,125,39,177,49
400,171024,Maçanet de Cabrenys,2010,728,369,359,77,442,209
401,171030,Maçanet de la Selva,2010,7020,3619,3401,1222,4839,959
402,170979,Madremanya,2010,250,120,130,40,158,52
403,170985,Maià de Montcal,2010,433,225,208,74,267,92
404,251333,Maials,2010,1006,522,484,114,600,292
405,251305,Maldà,2010,258,136,122,26,152,80
406,081108,Malgrat de Mar,2010,18596,9288,9308,2766,12661,3169
407,081115,Malla,2010,255,127,128,28,182,45
408,081120,Manlleu,2010,20450,10324,10126,3672,13519,3259
409,081136,Manresa,2010,76209,37529,38680,11580,50339,14290
410,430764,Marçà,2010,653,334,319,104,391,158
411,430751,Margalef,2010,115,60,55,8,71,36
412,082423,Marganell,2010,317,153,164,40,209,68
413,081141,Martorell,2010,26815,13887,12928,4823,18230,3762
414,081154,Martorelles,2010,4900,2460,2440,692,3383,825
415,430770,Mas de Barberans,2010,645,324,321,68,394,183
416,171002,Masarac,2010,276,150,126,38,178,60
417,430786,Masdenverge,2010,1144,595,549,147,758,239
418,081167,"Masies de Roda, les",2010,758,374,384,97,536,125
419,081173,"Masies de Voltregà, les",2010,3226,1605,1621,578,2170,478
420,430799,Masllorenç,2010,526,278,248,73,334,119
421,081189,"Masnou, el",2010,22536,10830,11706,3393,15540,3603
422,430803,"Masó, la",2010,300,151,149,37,185,78
423,430810,Maspujols,2010,710,367,343,130,460,120
424,081192,Masquefa,2010,8295,4199,4096,1695,5633,967
425,430825,"Masroig, el",2010,558,293,265,67,336,155
426,251312,Massalcoreig,2010,590,304,286,60,380,150
427,171019,Massanes,2010,726,381,345,106,517,103
428,251327,Massoteres,2010,212,114,98,42,134,36
429,081206,Matadepera,2010,8606,4319,4287,1788,5747,1071
430,081213,Mataró,2010,122905,61528,61377,19578,85017,18310
431,081228,Mediona,2010,2363,1214,1149,404,1512,447
432,251348,Menàrguens,2010,867,467,400,84,552,231
433,170998,Meranges,2010,89,50,39,10,56,23
434,171058,Mieres,2010,330,171,159,48,211,71
435,430831,"Milà, el",2010,180,88,92,24,106,50
436,251351,Miralcamp,2010,1424,719,705,198,960,266
437,430846,Miravet,2010,798,417,381,91,508,199
438,081385,Moià,2010,5713,2886,2827,1019,3791,903
439,430859,"Molar, el",2010,297,165,132,29,177,91
440,081234,Molins de Rei,2010,24236,11831,12405,4139,16610,3487
441,251370,Mollerussa,2010,14733,7645,7088,2655,10297,1781
442,171061,Mollet de Peralada,2010,170,86,84,20,96,54
443,081249,Mollet del Vallès,2010,52459,26336,26123,8964,36873,6622
444,171077,Molló,2010,354,176,178,34,227,93
445,251364,"Molsosa, la",2010,117,60,57,6,79,32
446,081287,Monistrol de Calders,2010,690,353,337,104,450,136
447,081271,Monistrol de Montserrat,2010,3027,1549,1478,406,2078,543
448,171096,Montagut i Oix,2010,989,513,476,139,652,198
449,430862,Montblanc,2010,7382,3735,3647,1084,5033,1265
450,430884,Montbrió del Camp,2010,2298,1173,1125,355,1583,360
451,081252,Montcada i Reixac,2010,33656,16762,16894,5652,23326,4678
452,081304,Montclar,2010,112,54,58,18,63,31
453,251399,Montellà i Martinet,2010,671,348,323,80,457,134
454,081311,Montesquiu,2010,897,452,445,122,592,183
455,251403,Montferrer i Castellbò,2010,1086,587,499,150,803,133
456,430897,Montferri,2010,391,205,186,84,243,64
457,251386,Montgai,2010,718,367,351,77,424,217
458,081265,Montgat,2010,10584,5217,5367,1711,7520,1353
459,081326,Montmajor,2010,483,256,227,52,324,107
460,081332,Montmaneu,2010,184,102,82,16,114,54
461,430901,"Montmell, el",2010,1449,791,658,226,1016,207
462,081350,Montmeló,2010,9001,4469,4532,1479,6235,1287
463,251425,Montoliu de Lleida,2010,495,250,245,59,322,114
464,251410,Montoliu de Segarra,2010,197,117,80,16,121,60
465,251431,Montornès de Segarra,2010,104,53,51,4,59,41
466,081363,Montornès del Vallès,2010,15790,8093,7697,2802,11091,1897
467,430918,Mont-ral,2010,172,101,71,14,134,24
468,171100,Mont-ras,2010,1821,933,888,272,1281,268
469,430923,Mont-roig del Camp,2010,12193,6360,5833,1768,8598,1827
470,081379,Montseny,2010,312,163,149,27,208,77
471,430939,Móra d'Ebre,2010,5795,2866,2929,946,3849,1000
472,430944,Móra la Nova,2010,3238,1657,1581,477,2165,596
473,430957,"Morell, el",2010,3395,1776,1619,607,2388,400
474,430960,"Morera de Montsant, la",2010,160,95,65,15,113,32
475,081290,Muntanyola,2010,587,296,291,124,403,60
476,081398,Mura,2010,233,122,111,33,163,37
477,251459,Nalec,2010,98,52,46,4,59,35
478,250254,Naut Aran,2010,1729,883,846,247,1277,205
479,081402,Navarcles,2010,5964,2912,3052,863,4045,1056
480,081419,Navàs,2010,6194,3079,3115,948,4033,1213
481,171117,Navata,2010,1158,575,583,216,729,213
482,251462,Navès,2010,276,137,139,38,175,63
483,081424,"Nou de Berguedà, la",2010,155,82,73,21,88,46
484,430976,"Nou de Gaià, la",2010,510,251,259,95,318,97
485,430982,Nulles,2010,451,227,224,60,300,91
486,251484,Odèn,2010,264,160,104,15,175,74
487,081430,Òdena,2010,3442,1742,1700,606,2332,504
488,171122,Ogassa,2010,256,149,107,29,174,53
489,081458,Olèrdola,2010,3533,1830,1703,686,2420,427
490,081461,Olesa de Bonesvalls,2010,1702,889,813,283,1192,227
491,081477,Olesa de Montserrat,2010,23646,11943,11703,4277,16157,3212
492,251497,Oliana,2010,1945,980,965,217,1259,469
493,251500,Oliola,2010,232,133,99,22,154,56
494,251517,Olius,2010,841,440,401,179,550,112
495,081483,Olivella,2010,3405,1794,1611,704,2418,283
496,081496,Olost,2010,1202,598,604,147,769,286
497,171143,Olot,2010,33589,16820,16769,4923,22291,6375
498,251522,"Oluges, les",2010,176,98,78,6,110,60
499,081445,Olvan,2010,902,449,453,103,576,223
500,251538,"Omellons, els",2010,254,137,117,24,155,75
501,251543,"Omells de na Gaia, els",2010,144,76,68,12,87,45
502,171156,Ordis,2010,385,201,184,64,254,67
503,251556,Organyà,2010,942,463,479,97,582,263
504,081509,Orís,2010,296,150,146,40,209,47
505,081516,Oristà,2010,583,290,293,45,398,140
506,081521,Orpí,2010,179,96,83,19,128,32
507,081537,Òrrius,2010,654,331,323,114,444,96
508,251569,Os de Balaguer,2010,987,518,469,157,613,217
509,171169,Osor,2010,426,214,212,46,265,115
510,251575,Ossó de Sió,2010,226,114,112,24,140,62
511,081542,Pacs del Penedès,2010,881,447,434,147,612,122
512,081555,Palafolls,2010,8773,4404,4369,1713,6095,965
513,171175,Palafrugell,2010,22622,11385,11237,3779,15275,3568
514,171181,Palamós,2010,18057,8910,9147,2728,12295,3034
515,251581,"Palau d'Anglesola, el",2010,2120,1053,1067,316,1391,413
516,171194,Palau de Santa Eulàlia,2010,105,61,44,11,77,17
517,171215,Palau-sator,2010,290,153,137,35,185,70
518,171208,Palau-saverdera,2010,1475,737,738,233,920,322
519,081568,Palau-solità i Plegamans,2010,14190,7152,7038,2596,9959,1635
520,431009,"Pallaresos, els",2010,4126,2126,2000,992,2850,284
521,081574,Pallejà,2010,11263,5697,5566,2156,7769,1338
522,430995,"Palma d'Ebre, la",2010,425,202,223,48,236,141
523,089058,"Palma de Cervelló, la",2010,3035,1506,1529,503,2185,347
524,171236,Palol de Revardit,2010,482,247,235,89,306,87
525,171241,Pals,2010,2745,1394,1351,366,1785,594
526,081580,"Papiol, el",2010,3937,1952,1985,667,2735,535
527,171254,Pardines,2010,164,94,70,26,88,50
528,081593,Parets del Vallès,2010,17805,9056,8749,3165,12521,2119
529,171267,Parlavà,2010,402,207,195,42,282,78
530,431016,Passanant i Belltall,2010,164,92,72,7,104,53
531,171289,Pau,2010,563,283,280,87,368,108
532,431021,Paüls,2010,598,297,301,57,373,168
533,171292,Pedret i Marzà,2010,173,93,80,28,110,35
534,251641,Penelles,2010,502,288,214,48,312,142
535,171306,"Pera, la",2010,446,227,219,64,281,101
536,081607,Perafita,2010,396,200,196,44,246,106
537,431037,Perafort,2010,1218,629,589,222,865,131
538,171328,Peralada,2010,1826,928,898,290,1216,320
539,251654,Peramola,2010,387,203,184,42,239,106
540,431042,"Perelló, el",2010,3303,1771,1532,420,2166,717
541,081614,Piera,2010,14576,7459,7117,2669,9751,2156
542,431055,"Piles, les",2010,218,115,103,24,154,40
543,081635,Pineda de Mar,2010,25893,13112,12781,3895,17866,4132
544,431068,"Pinell de Brai, el",2010,1135,581,554,126,698,311
545,251667,Pinell de Solsonès,2010,215,116,99,26,130,59
546,251673,Pinós,2010,315,172,143,39,203,73
547,431074,Pira,2010,502,258,244,103,298,101
548,431080,"Pla de Santa Maria, el",2010,2371,1250,1121,371,1584,416
549,081640,"Pla del Penedès, el",2010,1103,558,545,177,716,210
550,171334,"Planes d'Hostoles, les",2010,1727,882,845,204,1041,482
551,171349,Planoles,2010,288,158,130,26,191,71
552,259118,"Plans de Sió, els",2010,571,302,269,61,328,182
553,251689,"Poal, el",2010,622,323,299,70,387,165
554,251692,"Pobla de Cérvoles, la",2010,240,129,111,31,143,66
555,081653,"Pobla de Claramunt, la",2010,2295,1178,1117,412,1517,366
556,081666,"Pobla de Lillet, la",2010,1303,648,655,92,825,386
557,431093,"Pobla de Mafumet, la",2010,2628,1344,1284,469,1966,193
558,431107,"Pobla de Massaluca, la",2010,391,203,188,32,228,131
559,431114,"Pobla de Montornès, la",2010,2888,1532,1356,483,1955,450
560,251713,"Pobla de Segur, la",2010,3266,1619,1647,423,2044,799
561,431129,Poboleda,2010,382,211,171,35,258,89
562,081672,Polinyà,2010,7798,3989,3809,1552,5653,593
563,431135,"Pont d'Armentera, el",2010,597,318,279,69,369,159
564,250306,"Pont de Bar, el",2010,194,111,83,26,118,50
565,171352,Pont de Molins,2010,498,262,236,62,349,87
566,251734,"Pont de Suert, el",2010,2506,1300,1206,330,1699,477
567,081825,"Pont de Vilomara i Rocafort, el",2010,3760,1943,1817,634,2576,550
568,431418,Pontils,2010,131,72,59,2,99,30
569,081688,Pontons,2010,539,293,246,74,379,86
570,171365,Pontós,2010,242,131,111,37,146,59
571,251728,Ponts,2010,2744,1391,1353,395,1784,565
572,171371,Porqueres,2010,4400,2182,2218,787,2982,631
573,431140,Porrera,2010,482,257,225,51,314,117
574,171404,"Port de la Selva, el",2010,993,526,467,122,656,215
575,171387,Portbou,2010,1302,652,650,94,826,382
576,251749,"Portella, la",2010,773,427,346,69,573,131
577,431153,Pradell de la Teixeta,2010,188,85,103,18,122,48
578,431166,Prades,2010,655,340,315,80,422,153
579,431172,Prat de Comte,2010,198,107,91,24,115,59
580,081691,"Prat de Llobregat, el",2010,63434,31469,31965,9511,44347,9576
581,431188,Pratdip,2010,835,450,385,91,500,244
582,081712,Prats de Lluçanès,2010,2739,1355,1384,358,1799,582
583,081705,"Prats de Rei, els",2010,549,288,261,51,374,124
584,251752,Prats i Sansor,2010,245,139,106,34,174,37
585,251765,Preixana,2010,437,225,212,55,239,143
586,251771,Preixens,2010,478,237,241,63,257,158
587,082303,Premià de Dalt,2010,10064,5050,5014,1683,7025,1356
588,081727,Premià de Mar,2010,27802,13707,14095,4314,19295,4193
589,171390,"Preses, les",2010,1724,833,891,284,1146,294
590,251790,Prullans,2010,245,118,127,22,155,68
591,171411,Puigcerdà,2010,8746,4421,4325,1456,6047,1243
592,081748,Puigdàlber,2010,522,252,270,80,360,82
593,251804,Puiggròs,2010,311,165,146,50,192,69
594,431191,Puigpelat,2010,1001,525,476,204,685,112
595,081751,Puig-reig,2010,4333,2127,2206,479,2768,1086
596,251811,Puigverd d'Agramunt,2010,275,155,120,33,175,67
597,251826,Puigverd de Lleida,2010,1390,716,674,231,902,257
598,081764,Pujalt,2010,205,104,101,21,135,49
599,081770,"Quar, la",2010,59,36,23,3,41,15
600,171426,Quart,2010,2983,1499,1484,546,2101,336
601,170433,Queralbs,2010,190,109,81,20,117,53
602,431205,Querol,2010,536,291,245,71,380,85
603,171432,Rabós,2010,192,100,92,21,127,44
604,081786,Rajadell,2010,514,271,243,70,348,96
605,431212,Rasquera,2010,966,487,479,104,592,270
606,171447,Regencós,2010,315,175,140,52,196,67
607,081799,Rellinars,2010,727,370,357,118,507,102
608,431227,Renau,2010,101,53,48,13,75,13
609,431233,Reus,2010,106622,52541,54081,18416,72758,15448
610,251832,Rialp,2010,654,347,307,87,476,91
611,431248,"Riba, la",2010,705,376,329,82,466,157
612,431251,Riba-roja d'Ebre,2010,1336,713,623,106,873,357
613,259059,Ribera d'Ondara,2010,454,232,222,53,282,119
614,251850,Ribera d'Urgellet,2010,982,517,465,140,649,193
615,171450,Ribes de Freser,2010,1930,951,979,194,1205,531
616,171463,Riells i Viabrea,2010,3868,2000,1868,761,2739,368
617,431264,"Riera de Gaià, la",2010,1661,847,814,317,1126,218
618,251863,Riner,2010,292,141,151,39,187,66
619,171479,Ripoll,2010,10991,5437,5554,1382,7245,2364
620,081803,Ripollet,2010,37151,18671,18480,6603,25916,4632
621,259139,Riu de Cerdanya,2010,111,63,48,11,84,16
622,171485,Riudarenes,2010,2123,1093,1030,361,1418,344
623,171498,Riudaura,2010,441,217,224,60,293,88
624,431270,Riudecanyes,2010,1118,576,542,198,715,205
625,431286,Riudecols,2010,1277,668,609,180,879,218
626,171501,Riudellots de la Selva,2010,1975,1015,960,320,1368,287
627,431299,Riudoms,2010,6473,3330,3143,1091,4298,1084
628,171518,Riumors,2010,224,114,110,29,142,53
629,081810,"Roca del Vallès, la",2010,10291,5191,5100,1953,7113,1225
630,431303,Rocafort de Queralt,2010,258,139,119,25,161,72
631,431310,Roda de Berà,2010,6232,3261,2971,983,4286,963
632,081831,Roda de Ter,2010,6118,3006,3112,983,4053,1082
633,431325,Rodonyà,2010,527,288,239,96,324,107
634,431331,Roquetes,2010,8231,4345,3886,1302,5613,1316
635,171523,Roses,2010,20418,10377,10041,3437,13991,2990
636,251898,Rosselló,2010,2950,1507,1443,511,2042,397
637,431346,"Rourell, el",2010,384,198,186,64,247,73
638,081846,Rubí,2010,73591,36945,36646,12531,51968,9092
639,081859,Rubió,2010,218,116,102,27,147,44
640,171539,Rupià,2010,243,122,121,38,153,52
641,089019,Rupit i Pruit,2010,312,157,155,28,216,68
642,081878,Sabadell,2010,207338,101462,105876,32633,140035,34670
643,081884,Sagàs,2010,141,73,68,28,84,29
644,251902,Salàs de Pallars,2010,334,169,165,13,212,109
645,081901,Saldes,2010,340,197,143,29,241,70
646,171544,Sales de Llierca,2010,136,73,63,20,100,16
647,081918,Sallent,2010,7029,3394,3635,950,4467,1612
648,431359,Salomó,2010,505,269,236,77,322,106
649,439057,Salou,2010,27016,14534,12482,4059,20559,2398
650,171557,Salt,2010,30304,16159,14145,5817,21123,3364
651,251919,Sanaüja,2010,458,240,218,64,268,126
652,081944,Sant Adrià de Besòs,2010,34104,16859,17245,5655,22787,5662
653,081957,Sant Agustí de Lluçanès,2010,101,52,49,7,68,26
654,081960,Sant Andreu de la Barca,2010,26682,13506,13176,5154,18672,2856
655,081976,Sant Andreu de Llavaneres,2010,10303,5134,5169,1909,6974,1420
656,171576,Sant Andreu Salou,2010,155,75,80,20,97,38
657,171833,Sant Aniol de Finestres,2010,342,184,158,50,234,58
658,081982,Sant Antoni de Vilamajor,2010,5479,2749,2730,1003,3782,694
659,081995,Sant Bartomeu del Grau,2010,967,503,464,139,686,142
660,082009,Sant Boi de Llobregat,2010,82411,40910,41501,12636,57051,12724
661,082016,Sant Boi de Lluçanès,2010,564,282,282,71,353,140
662,431362,Sant Carles de la Ràpita,2010,15583,7732,7851,2323,10340,2920
663,082037,Sant Cebrià de Vallalta,2010,3388,1761,1627,631,2399,358
664,082021,Sant Celoni,2010,16905,8451,8454,2829,11452,2624
665,082042,Sant Climent de Llobregat,2010,3819,1923,1896,748,2642,429
666,171582,Sant Climent Sescebes,2010,521,280,241,65,322,134
667,082055,Sant Cugat del Vallès,2010,81745,39965,41780,17374,55853,8518
668,082068,Sant Cugat Sesgarrigues,2010,973,499,474,176,629,168
669,251961,Sant Esteve de la Sarga,2010,144,86,58,7,94,43
670,082074,Sant Esteve de Palautordera,2010,2500,1231,1269,547,1679,274
671,082080,Sant Esteve Sesrovires,2010,7329,3727,3602,1378,5067,884
672,171595,Sant Feliu de Buixalleu,2010,793,417,376,117,532,144
673,082107,Sant Feliu de Codines,2010,5836,2980,2856,1021,3938,877
674,171609,Sant Feliu de Guíxols,2010,21975,10923,11052,3367,14949,3659
675,082114,Sant Feliu de Llobregat,2010,43112,21051,22061,7106,29729,6277
676,171616,Sant Feliu de Pallerols,2010,1363,666,697,224,864,275
677,082129,Sant Feliu Sasserra,2010,661,334,327,90,436,135
678,171621,Sant Ferriol,2010,236,138,98,40,159,37
679,082093,Sant Fost de Campsentelles,2010,8292,4150,4142,1346,5702,1244
680,082135,Sant Fruitós de Bages,2010,8184,4122,4062,1472,5713,999
681,171637,Sant Gregori,2010,3243,1647,1596,607,2192,444
682,251924,Sant Guim de Freixenet,2010,1114,560,554,147,714,253
683,251977,Sant Guim de la Plana,2010,192,103,89,27,109,56
684,171642,Sant Hilari Sacalm,2010,5729,2959,2770,796,3883,1050
685,082153,Sant Hipòlit de Voltregà,2010,3512,1761,1751,570,2283,659
686,081939,Sant Iscle de Vallalta,2010,1280,669,611,238,849,193
687,439023,Sant Jaume d'Enveja,2010,3538,1797,1741,493,2267,778
688,082166,Sant Jaume de Frontanyà,2010,24,13,11,3,17,4
689,171655,Sant Jaume de Llierca,2010,780,393,387,74,487,219
690,431378,Sant Jaume dels Domenys,2010,2450,1267,1183,429,1651,370
691,171674,Sant Joan de les Abadesses,2010,3529,1759,1770,396,2229,904
692,171680,Sant Joan de Mollet,2010,513,255,258,85,322,106
693,082188,Sant Joan de Vilatorrada,2010,10856,5478,5378,1822,7338,1696
694,082172,Sant Joan Despí,2010,32338,15851,16487,5741,22244,4353
695,171851,Sant Joan les Fonts,2010,2831,1434,1397,332,1875,624
696,171668,Sant Jordi Desvalls,2010,653,317,336,85,423,145
697,089030,Sant Julià de Cerdanyola,2010,267,143,124,38,168,61
698,171693,Sant Julià de Ramis,2010,3281,1649,1632,619,2280,382
699,082205,Sant Julià de Vilatorta,2010,2974,1449,1525,568,1998,408
700,179032,Sant Julià del Llor i Bonmatí,2010,1291,646,645,213,890,188
701,082212,Sant Just Desvern,2010,15923,7598,8325,2640,10689,2594
702,082227,Sant Llorenç d'Hortons,2010,2416,1214,1202,448,1646,322
703,171714,Sant Llorenç de la Muga,2010,222,110,112,33,141,48
704,251930,Sant Llorenç de Morunys,2010,1077,551,526,136,684,257
705,082233,Sant Llorenç Savall,2010,2402,1208,1194,361,1561,480
706,082251,Sant Martí d'Albars,2010,107,56,51,13,70,24
707,082248,Sant Martí de Centelles,2010,1034,541,493,166,715,153
708,171729,Sant Martí de Llémena,2010,566,292,274,95,388,83
709,259025,Sant Martí de Riucorb,2010,685,356,329,72,400,213
710,082264,Sant Martí de Tous,2010,1164,586,578,240,700,224
711,082270,Sant Martí Sarroca,2010,3161,1579,1582,513,2078,570
712,082286,Sant Martí Sesgueioles,2010,381,190,191,58,249,74
713,171735,Sant Martí Vell,2010,265,141,124,58,158,49
714,082299,Sant Mateu de Bages,2010,663,349,314,60,398,205
715,171740,Sant Miquel de Campmajor,2010,243,126,117,32,165,46
716,171753,Sant Miquel de Fluvià,2010,765,396,369,105,520,140
717,171766,Sant Mori,2010,166,83,83,16,126,24
718,171772,Sant Pau de Segúries,2010,710,359,351,75,457,178
719,082310,Sant Pere de Ribes,2010,28399,14385,14014,4971,20135,3293
720,082325,Sant Pere de Riudebitlles,2010,2381,1199,1182,398,1541,442
721,082331,Sant Pere de Torelló,2010,2417,1228,1189,342,1626,449
722,082346,Sant Pere de Vilamajor,2010,4147,2078,2069,843,2778,526
723,171788,Sant Pere Pescador,2010,2033,1091,942,310,1413,310
724,081897,Sant Pere Sallavinera,2010,168,88,80,19,102,47
725,082359,Sant Pol de Mar,2010,5076,2563,2513,823,3428,825
726,082362,Sant Quintí de Mediona,2010,2188,1123,1065,397,1390,401
727,082378,Sant Quirze de Besora,2010,2240,1108,1132,301,1392,547
728,082384,Sant Quirze del Vallès,2010,18702,9221,9481,3736,13254,1712
729,082397,Sant Quirze Safaja,2010,640,330,310,124,449,67
730,251945,Sant Ramon,2010,569,310,259,58,350,161
731,082401,Sant Sadurní d'Anoia,2010,12323,6076,6247,2147,8313,1863
732,082418,Sant Sadurní d'Osormort,2010,94,52,42,11,65,18
733,080983,Sant Salvador de Guardiola,2010,3078,1567,1511,583,2075,420
734,082628,Sant Vicenç de Castellet,2010,8688,4318,4370,1231,5865,1592
735,082649,Sant Vicenç de Montalt,2010,5776,2934,2842,1289,3787,700
736,082652,Sant Vicenç de Torelló,2010,2028,999,1029,337,1294,397
737,082634,Sant Vicenç dels Horts,2010,28024,14071,13953,4809,19379,3836
738,431384,Santa Bàrbara,2010,3965,2040,1925,582,2563,820
739,082439,Santa Cecília de Voltregà,2010,183,92,91,21,123,39
740,082444,Santa Coloma de Cervelló,2010,7845,3872,3973,1706,5324,815
741,171805,Santa Coloma de Farners,2010,11948,6111,5837,2038,8135,1775
742,082457,Santa Coloma de Gramenet,2010,120060,60779,59281,17487,82582,19991
743,431397,Santa Coloma de Queralt,2010,3153,1595,1558,562,1963,628
744,171812,Santa Cristina d'Aro,2010,5067,2603,2464,895,3456,716
745,082460,Santa Eugènia de Berga,2010,2261,1174,1087,314,1624,323
746,082476,Santa Eulàlia de Riuprimer,2010,1079,557,522,180,726,173
747,082482,Santa Eulàlia de Ronçana,2010,6829,3407,3422,1242,4573,1014
748,082495,Santa Fe del Penedès,2010,384,193,191,78,255,51
749,171827,Santa Llogaia d'Àlguema,2010,325,172,153,51,232,42
750,082508,Santa Margarida de Montbui,2010,9811,4933,4878,1700,6707,1404
751,082515,Santa Margarida i els Monjos,2010,6933,3553,3380,1321,4816,796
752,082589,Santa Maria d'Oló,2010,1079,549,530,153,695,231
753,082536,Santa Maria de Besora,2010,168,84,84,17,100,51
754,082567,Santa Maria de Martorelles,2010,839,430,409,145,587,107
755,082554,Santa Maria de Merlès,2010,162,78,84,31,101,30
756,082573,Santa Maria de Miralles,2010,133,65,68,13,93,27
757,082592,Santa Maria de Palautordera,2010,9040,4645,4395,1641,6213,1186
758,431401,Santa Oliva,2010,3327,1730,1597,594,2211,522
759,171848,Santa Pau,2010,1600,809,791,197,1091,312
760,082606,Santa Perpètua de Mogoda,2010,25191,12958,12233,4691,17751,2749
761,082613,Santa Susanna,2010,3308,1688,1620,597,2273,438
762,081923,Santpedor,2010,7071,3535,3536,1223,4832,1016
763,431423,Sarral,2010,1720,886,834,279,1115,326
764,171864,Sarrià de Ter,2010,4596,2289,2307,712,3097,787
765,252017,Sarroca de Bellera,2010,136,79,57,4,92,40
766,252000,Sarroca de Lleida,2010,433,231,202,36,279,118
767,171870,"Saus, Camallera i Llampaies",2010,765,369,396,106,513,146
768,431439,Savallà del Comtat,2010,71,35,36,6,46,19
769,431444,"Secuita, la",2010,1547,790,757,248,1084,215
770,171886,"Selva de Mar, la",2010,220,115,105,18,152,50
771,431457,"Selva del Camp, la",2010,5477,2775,2702,1022,3668,787
772,431460,Senan,2010,56,34,22,8,37,11
773,430445,"Sénia, la",2010,6087,3118,2969,950,4103,1034
774,252022,Senterada,2010,142,77,65,13,107,22
775,250352,"Sentiu de Sió, la",2010,502,249,253,42,326,134
776,082671,Sentmenat,2010,8112,4112,4000,1443,5713,956
777,171903,Serinyà,2010,1104,557,547,176,742,186
778,252043,Seròs,2010,1867,1038,829,219,1222,426
779,171910,Serra de Daró,2010,209,114,95,31,127,51
780,171925,Setcases,2010,181,96,85,13,123,45
781,252038,"Seu d'Urgell, la",2010,13060,6432,6628,1997,8958,2105
782,082690,Seva,2010,3418,1760,1658,596,2278,544
783,252056,Sidamon,2010,758,384,374,128,509,121
784,171931,Sils,2010,5356,2725,2631,971,3693,692
785,082704,Sitges,2010,28130,14066,14064,4413,19597,4120
786,170524,Siurana,2010,190,100,90,26,116,48
787,082711,Sobremunt,2010,95,46,49,15,60,20
788,252069,"Soleràs, el",2010,376,201,175,47,210,119
789,431476,Solivella,2010,678,342,336,101,386,191
790,252075,Solsona,2010,9219,4668,4551,1559,6071,1589
791,082726,Sora,2010,190,105,85,23,132,35
792,252081,Soriguera,2010,377,204,173,47,257,73
793,252094,Sort,2010,2387,1211,1176,392,1604,391
794,252108,Soses,2010,1763,926,837,265,1193,305
795,082732,Subirats,2010,3076,1546,1530,513,1987,576
796,252115,Sudanell,2010,878,487,391,97,606,175
797,252120,Sunyer,2010,307,163,144,33,198,76
798,082747,Súria,2010,6359,3118,3241,800,4113,1446
799,171946,Susqueda,2010,118,68,50,9,82,27
800,082763,Tagamanent,2010,306,163,143,57,197,52
801,082779,Talamanca,2010,143,80,63,20,101,22
802,252154,Talarn,2010,395,190,205,57,247,91
803,252167,Talavera,2010,302,170,132,34,191,77
804,171959,"Tallada d'Empordà, la",2010,435,227,208,53,279,103
805,082785,Taradell,2010,6098,3086,3012,1019,4051,1028
806,431482,Tarragona,2010,140184,69235,70949,22745,96535,20904
807,252173,Tàrrega,2010,17189,8694,8495,3021,11726,2442
808,252189,Tarrés,2010,109,55,54,9,73,27
809,252192,Tarroja de Segarra,2010,169,87,82,18,101,50
810,082750,Tavèrnoles,2010,304,153,151,44,213,47
811,082802,Tavertet,2010,148,80,68,12,102,34
812,082819,Teià,2010,6081,3028,3053,950,4223,908
813,252206,Térmens,2010,1528,786,742,189,1003,336
814,171962,Terrades,2010,317,157,160,50,214,53
815,082798,Terrassa,2010,212724,105690,107034,36072,145278,31374
816,082824,Tiana,2010,7774,3788,3986,1432,5410,932
817,252213,Tírvia,2010,159,83,76,15,114,30
818,252228,Tiurana,2010,81,39,42,12,44,25
819,431495,Tivenys,2010,925,473,452,99,553,273
820,431508,Tivissa,2010,1812,925,887,204,1131,477
821,082830,Tona,2010,7984,4001,3983,1425,5353,1206
822,252234,Torà,2010,1367,698,669,180,906,281
823,082845,Tordera,2010,15641,8022,7619,2582,10703,2356
824,082858,Torelló,2010,13944,6913,7031,2134,9479,2331
825,252249,"Torms, els",2010,171,94,77,18,95,58
826,252252,Tornabous,2010,863,461,402,101,526,236
827,252271,"Torre de Cabdella, la",2010,791,401,390,44,524,223
828,082861,"Torre de Claramunt, la",2010,3757,1961,1796,703,2628,426
829,431515,"Torre de Fontaubella, la",2010,147,74,73,17,84,46
830,431520,"Torre de l'Espanyol, la",2010,679,350,329,85,415,179
831,252265,Torrebesses,2010,299,156,143,28,181,90
832,431536,Torredembarra,2010,15406,7692,7714,2413,10625,2368
833,252287,Torrefarrera,2010,4151,2100,2051,840,2907,404
834,259078,Torrefeta i Florejacs,2010,617,319,298,70,366,181
835,252304,Torregrossa,2010,2251,1144,1107,283,1419,549
836,252311,Torrelameu,2010,690,393,297,70,470,150
837,082877,Torrelavit,2010,1383,749,634,181,941,261
838,082883,Torrelles de Foix,2010,2545,1331,1214,427,1688,430
839,082896,Torrelles de Llobregat,2010,5526,2762,2764,1130,3862,534
840,171978,Torrent,2010,190,98,92,19,131,40
841,252326,Torres de Segre,2010,2080,1078,1002,277,1385,418
842,252332,Torre-serona,2010,350,180,170,33,223,94
843,171984,Torroella de Fluvià,2010,686,349,337,106,484,96
844,171997,Torroella de Montgrí,2010,11522,5857,5665,1863,7901,1758
845,431541,Torroja del Priorat,2010,165,93,72,12,101,52
846,172001,Tortellà,2010,771,387,384,100,464,207
847,431554,Tortosa,2010,34473,17344,17129,5188,22978,6307
848,172018,Toses,2010,155,96,59,13,108,34
849,172023,Tossa de Mar,2010,5976,3064,2912,821,4151,1004
850,252347,Tremp,2010,6368,3161,3207,911,4048,1409
851,172044,Ullà,2010,1019,571,448,159,724,136
852,082900,Ullastrell,2010,1892,968,924,408,1260,224
853,172057,Ullastret,2010,250,125,125,45,156,49
854,431567,Ulldecona,2010,7335,3788,3547,1071,4948,1316
855,431573,Ulldemolins,2010,470,265,205,38,274,158
856,172039,Ultramort,2010,213,118,95,24,129,60
857,172060,Urús,2010,208,105,103,23,147,38
858,082917,Vacarisses,2010,6017,3112,2905,1346,4047,624
859,170144,"Vajol, la",2010,98,59,39,8,72,18
860,172076,"Vall d'en Bas, la",2010,2833,1422,1411,422,1817,594
861,172082,"Vall de Bianya, la",2010,1320,667,653,219,883,218
862,250432,"Vall de Boí, la",2010,1076,584,492,110,809,157
863,259010,Vall de Cardós,2010,422,223,199,51,279,92
864,082922,Vallbona d'Anoia,2010,1423,731,692,221,987,215
865,252385,Vallbona de les Monges,2010,251,134,117,16,148,87
866,082938,Vallcebre,2010,268,156,112,21,168,79
867,431589,Vallclara,2010,117,66,51,15,71,31
868,252402,Vallfogona de Balaguer,2010,1788,893,895,249,1238,301
869,171707,Vallfogona de Ripollès,2010,234,130,104,24,154,56
870,431592,Vallfogona de Riucorb,2010,114,66,48,1,69,44
871,082943,Vallgorguina,2010,2591,1332,1259,536,1791,264
872,082956,Vallirana,2010,14200,7097,7103,2665,9717,1818
873,172095,Vall-llobrega,2010,866,443,423,189,600,77
874,431606,Vallmoll,2010,1637,853,784,243,1160,234
875,082969,Vallromanes,2010,2367,1200,1167,548,1593,226
876,431613,Valls,2010,25158,12693,12465,4000,17152,4006
877,259062,"Valls d'Aguilar, les",2010,304,169,135,21,198,85
878,252398,"Valls de Valira, les",2010,826,444,382,60,611,155
879,431628,Vandellòs i l'Hospitalet de l'Infant,2010,5839,2891,2948,919,4031,889
880,259097,"Vansa i Fórnols, la",2010,219,121,98,18,143,58
881,082975,Veciana,2010,173,94,79,27,98,48
882,431634,"Vendrell, el",2010,36068,18116,17952,6211,24914,4943
883,172109,Ventalló,2010,792,412,380,112,522,158
884,252424,Verdú,2010,1005,482,523,124,588,293
885,172116,Verges,2010,1166,574,592,156,741,269
886,431649,Vespella de Gaià,2010,418,236,182,61,301,56
887,082981,Vic,2010,40422,20134,20288,6998,27153,6271
888,172121,Vidrà,2010,168,88,80,25,113,30
889,172137,Vidreres,2010,7629,3941,3688,1340,5179,1110
890,252430,Vielha e Mijaran,2010,5636,2942,2694,801,4313,522
891,431652,Vilabella,2010,824,426,398,107,526,191
892,172142,Vilabertran,2010,907,480,427,131,595,181
893,172155,Vilablareix,2010,2297,1133,1164,383,1660,254
894,082994,Vilada,2010,516,261,255,35,338,143
895,172174,Viladamat,2010,458,240,218,55,307,96
896,172168,Viladasens,2010,216,111,105,21,151,44
897,083015,Viladecans,2010,64077,32104,31973,11159,44738,8180
898,083008,Viladecavalls,2010,7323,3641,3682,1405,5220,698
899,172180,Vilademuls,2010,766,401,365,111,482,173
900,172207,Viladrau,2010,1098,562,536,173,751,174
901,172214,Vilafant,2010,5429,2687,2742,918,3829,682
902,083054,Vilafranca del Penedès,2010,38218,18941,19277,6302,26117,5799
903,252445,Vilagrassa,2010,458,233,225,65,291,102
904,172235,Vilajuïga,2010,1155,565,590,197,754,204
905,431750,Vilalba dels Arcs,2010,721,379,342,69,425,227
906,083067,Vilalba Sasserra,2010,689,354,335,130,470,89
907,252458,Vilaller,2010,696,405,291,70,509,117
908,172240,Vilallonga de Ter,2010,477,259,218,59,300,118
909,431665,Vilallonga del Camp,2010,2000,1023,977,339,1404,257
910,172253,Vilamacolum,2010,328,177,151,51,217,60
911,172266,Vilamalla,2010,1100,585,515,188,765,147
912,172272,Vilamaniscle,2010,181,99,82,31,119,31
913,252477,Vilamòs,2010,202,108,94,31,150,21
914,172288,Vilanant,2010,363,177,186,54,244,65
915,431671,Vilanova d'Escornalbou,2010,573,322,251,83,396,94
916,252483,Vilanova de Bellpuig,2010,1194,623,571,129,740,325
917,252496,Vilanova de l'Aguda,2010,235,117,118,27,131,77
918,252542,Vilanova de la Barca,2010,1235,636,599,169,811,255
919,252509,Vilanova de Meià,2010,420,218,202,36,254,130
920,431687,Vilanova de Prades,2010,143,74,69,16,87,40
921,083036,Vilanova de Sau,2010,330,160,170,38,232,60
922,252516,Vilanova de Segrià,2010,862,454,408,105,599,158
923,083020,Vilanova del Camí,2010,12644,6387,6257,2306,8759,1579
924,089024,Vilanova del Vallès,2010,4797,2460,2337,1056,3232,509
925,083073,Vilanova i la Geltrú,2010,66532,32739,33793,10416,45548,10568
926,431690,Vilaplana,2010,631,317,314,69,423,139
927,431704,Vila-rodona,2010,1276,661,615,201,840,235
928,172305,Vila-sacra,2010,627,301,326,94,433,100
929,252521,Vila-sana,2010,688,343,345,94,454,140
930,431711,Vila-seca,2010,21373,10965,10408,3624,15568,2181
931,082140,Vilassar de Dalt,2010,8746,4302,4444,1382,5970,1394
932,082191,Vilassar de Mar,2010,19574,9421,10153,3355,13192,3027
933,172229,Vilaür,2010,146,71,75,24,84,38
934,431726,Vilaverd,2010,503,245,258,86,313,104
935,431732,"Vilella Alta, la",2010,136,71,65,21,82,33
936,431747,"Vilella Baixa, la",2010,213,115,98,33,132,48
937,172333,Vilobí d'Onyar,2010,3032,1596,1436,526,2039,467
938,083041,Vilobí del Penedès,2010,1129,586,543,187,747,195
939,172327,Vilopriu,2010,208,112,96,29,129,50
940,252537,"Vilosell, el",2010,200,102,98,9,126,65
941,431763,Vimbodí i Poblet,2010,1038,584,454,121,641,276
942,252555,Vinaixa,2010,609,310,299,56,400,153
943,431779,Vinebre,2010,459,233,226,60,289,110
944,431785,Vinyols i els Arcs,2010,1887,971,916,295,1316,276
945,083089,Viver i Serrateix,2010,188,98,90,25,119,44
946,430521,Xerta,2010,1304,643,661,167,806,331
947,000000,Catalunya,2010,7512381,3724515,3787866,1146950,5126268,1239163
0,250019,Abella de la Conca,2011,181,103,78,20,119,42
1,080018,Abrera,2011,11611,5926,5685,2168,8067,1376
2,250024,Àger,2011,590,316,274,48,364,178
3,250030,Agramunt,2011,5653,2884,2769,893,3754,1006
4,080023,Aguilar de Segarra,2011,245,131,114,33,154,58
5,170010,Agullana,2011,839,430,409,118,540,181
6,080142,Aiguafreda,2011,2481,1200,1281,377,1604,500
7,430017,Aiguamúrcia,2011,917,479,438,116,637,164
8,170025,Aiguaviva,2011,754,380,374,161,488,105
9,250387,Aitona,2011,2405,1259,1146,313,1526,566
10,250045,"Alamús, els",2011,748,403,345,83,499,166
11,250058,Alàs i Cerc,2011,366,194,172,44,226,96
12,250061,"Albagés, l'",2011,449,238,211,49,268,132
13,170031,Albanyà,2011,150,84,66,27,104,19
14,250077,Albatàrrec,2011,2040,1063,977,326,1469,245
15,250083,Albesa,2011,1656,892,764,232,1091,333
16,250096,"Albi, l'",2011,860,454,406,121,524,215
17,430022,Albinyana,2011,2347,1180,1167,379,1519,449
18,430038,"Albiol, l'",2011,451,225,226,96,302,53
19,170046,Albons,2011,709,368,341,117,482,110
20,430043,Alcanar,2011,10601,5497,5104,1425,7197,1979
21,250100,Alcanó,2011,233,113,120,19,145,69
22,250117,Alcarràs,2011,8350,4307,4043,1300,5970,1080
23,250122,Alcoletge,2011,3015,1577,1438,455,2201,359
24,430056,Alcover,2011,5140,2602,2538,888,3443,809
25,439044,"Aldea, l'",2011,4513,2411,2102,625,3035,853
26,430069,Aldover,2011,978,483,495,126,592,260
27,430075,"Aleixar, l'",2011,914,458,456,168,587,159
28,080039,Alella,2011,9570,4705,4865,1574,6588,1408
29,430081,Alfara de Carles,2011,400,212,188,41,248,111
30,250138,Alfarràs,2011,3107,1599,1508,466,1987,654
31,250143,Alfés,2011,331,176,155,30,216,85
32,430094,Alforja,2011,1866,960,906,256,1269,341
33,250156,Algerri,2011,450,232,218,34,256,160
34,250169,Alguaire,2011,3097,1616,1481,438,2072,587
35,250175,Alins,2011,305,162,143,36,185,84
36,430108,Alió,2011,380,188,192,45,254,81
37,250194,Almacelles,2011,6662,3485,3177,946,4481,1235
38,250208,Almatret,2011,378,199,179,15,219,144
39,250215,Almenar,2011,3605,1887,1718,463,2375,767
40,430115,Almoster,2011,1362,681,681,253,961,148
41,250220,Alòs de Balaguer,2011,138,81,57,10,75,53
42,170062,Alp,2011,1743,927,816,265,1294,184
43,080044,Alpens,2011,302,165,137,45,201,56
44,250236,Alpicat,2011,6190,3092,3098,1216,4243,731
45,250241,Alt Àneu,2011,450,256,194,42,325,83
46,430120,Altafulla,2011,4776,2364,2412,854,3298,624
47,170078,Amer,2011,2277,1127,1150,267,1477,533
48,430136,"Ametlla de Mar, l'",2011,7649,3888,3761,1135,4957,1557
49,080057,"Ametlla del Vallès, l'",2011,8111,4081,4030,1630,5584,897
50,439060,"Ampolla, l'",2011,3529,1801,1728,408,2387,734
51,430141,Amposta,2011,21445,10860,10585,3422,14617,3406
52,170084,Anglès,2011,5637,2828,2809,968,3658,1011
53,250273,Anglesola,2011,1389,699,690,196,861,332
54,250292,Arbeca,2011,2493,1295,1198,292,1576,625
55,430167,"Arboç, l'",2011,5548,2880,2668,1037,3706,805
56,430154,Arbolí,2011,114,63,51,8,82,24
57,170097,Arbúcies,2011,6713,3541,3172,1173,4508,1032
58,080060,Arenys de Mar,2011,14863,7307,7556,2160,9887,2816
59,080076,Arenys de Munt,2011,8500,4260,4240,1514,5756,1230
60,170101,Argelaguer,2011,424,226,198,59,285,80
61,080082,Argençola,2011,238,138,100,27,169,42
62,430173,"Argentera, l'",2011,159,91,68,8,110,41
63,080095,Argentona,2011,11776,5821,5955,2130,7888,1758
64,170118,"Armentera, l'",2011,863,417,446,128,548,187
65,430189,Arnes,2011,496,259,237,45,271,180
66,250313,Arres,2011,64,42,22,6,49,9
67,250328,Arsèguel,2011,100,54,46,15,68,17
68,080109,Artés,2011,5575,2809,2766,887,3741,947
69,250334,Artesa de Lleida,2011,1524,797,727,259,953,312
70,250349,Artesa de Segre,2011,3828,1962,1866,572,2505,751
71,430192,Ascó,2011,1665,866,799,163,1131,371
72,250365,Aspa,2011,224,115,109,20,127,77
73,250371,"Avellanes i Santa Linya, les",2011,470,264,206,45,272,153
74,080116,Avià,2011,2245,1124,1121,353,1453,439
75,080121,Avinyó,2011,2321,1167,1154,365,1464,492
76,170123,Avinyonet de Puigventós,2011,1509,768,741,323,1046,140
77,080137,Avinyonet del Penedès,2011,1710,912,798,283,1125,302
78,080155,Badalona,2011,219786,109725,110061,34455,150957,34374
79,089045,Badia del Vallès,2011,13643,6690,6953,2185,9182,2276
80,080168,Bagà,2011,2372,1200,1172,260,1573,539
81,250390,Baix Pallars,2011,382,201,181,52,237,93
82,250404,Balaguer,2011,16877,8627,8250,2827,11240,2810
83,080174,Balenyà,2011,3695,1846,1849,633,2520,542
84,080180,Balsareny,2011,3494,1756,1738,432,2366,696
85,430206,Banyeres del Penedès,2011,2995,1546,1449,583,2018,394
86,170157,Banyoles,2011,19159,9618,9541,3529,12543,3087
87,250411,Barbens,2011,896,484,412,112,540,244
88,430213,Barberà de la Conca,2011,540,294,246,80,342,118
89,082520,Barberà del Vallès,2011,32033,15907,16126,5437,22745,3851
90,080193,Barcelona,2011,1615448,767915,847533,197011,1082422,336015
91,250426,"Baronia de Rialb, la",2011,257,136,121,30,155,72
92,170160,Bàscara,2011,985,514,471,158,601,226
93,250447,Bassella,2011,255,134,121,32,161,62
94,430228,Batea,2011,2150,1104,1046,260,1337,553
95,250450,Bausen,2011,59,35,24,4,27,28
96,080207,Begues,2011,6426,3207,3219,1334,4481,611
97,170139,Begur,2011,4219,2143,2076,575,2890,754
98,250463,Belianes,2011,578,295,283,71,330,177
99,251706,Bellaguarda,2011,325,174,151,31,182,112
100,170182,Bellcaire d'Empordà,2011,664,333,331,109,416,139
101,250479,Bellcaire d'Urgell,2011,1356,681,675,171,839,346
102,250485,Bell-lloc d'Urgell,2011,2446,1214,1232,375,1589,482
103,250498,Bellmunt d'Urgell,2011,202,95,107,26,124,52
104,430234,Bellmunt del Priorat,2011,337,169,168,40,214,83
105,080214,Bellprat,2011,91,52,39,8,59,24
106,250501,Bellpuig,2011,5000,2615,2385,790,3344,866
107,430249,Bellvei,2011,2082,1073,1009,413,1356,313
108,250518,Bellver de Cerdanya,2011,2260,1175,1085,299,1544,417
109,250523,Bellvís,2011,2404,1212,1192,303,1529,572
110,250539,Benavent de Segrià,2011,1553,809,744,319,1042,192
111,430252,Benifallet,2011,803,400,403,62,483,258
112,430265,Benissanet,2011,1249,672,577,152,808,289
113,080229,Berga,2011,17018,8418,8600,2411,11121,3486
114,170195,Besalú,2011,2372,1130,1242,342,1516,514
115,170209,Bescanó,2011,4601,2284,2317,892,3019,690
116,170216,Beuda,2011,170,86,84,25,115,30
117,080235,Bigues i Riells del Fai,2011,8755,4485,4270,1721,6020,1014
118,250557,Biosca,2011,222,123,99,18,142,62
119,170221,"Bisbal d'Empordà, la",2011,10435,5267,5168,1796,6963,1676
120,430271,"Bisbal de Falset, la",2011,225,124,101,24,130,71
121,430287,"Bisbal del Penedès, la",2011,3373,1740,1633,506,2257,610
122,172348,Biure,2011,248,127,121,28,167,53
123,430290,Blancafort,2011,415,211,204,43,263,109
124,170237,Blanes,2011,39834,20064,19770,6273,27368,6193
125,170293,Boadella i les Escaules,2011,253,121,132,30,176,47
126,170242,Bolvir,2011,393,213,180,48,282,63
127,430304,Bonastre,2011,642,336,306,102,439,101
128,250576,"Bòrdes, Es",2011,242,129,113,26,175,41
129,170255,Bordils,2011,1736,869,867,312,1168,256
130,250582,"Borges Blanques, les",2011,6034,3078,2956,869,3951,1214
131,430311,"Borges del Camp, les",2011,2146,1072,1074,402,1378,366
132,170268,Borrassà,2011,709,365,344,116,467,126
133,080240,Borredà,2011,595,315,280,76,373,146
134,250595,Bossòst,2011,1168,601,567,154,844,170
135,430326,Bot,2011,693,358,335,60,407,226
136,430332,Botarell,2011,1109,596,513,198,782,129
137,250560,Bovera,2011,332,175,157,21,174,137
138,430347,Bràfim,2011,670,338,332,88,438,144
139,170274,Breda,2011,3781,1905,1876,552,2493,736
140,080253,"Bruc, el",2011,1992,1064,928,389,1366,237
141,080266,"Brull, el",2011,249,136,113,52,159,38
142,170280,Brunyola i Sant Martí Sapresa,2011,388,187,201,51,242,95
143,430350,Cabacés,2011,340,174,166,42,208,90
144,250609,Cabanabona,2011,112,47,65,10,52,50
145,170314,Cabanelles,2011,247,141,106,28,169,50
146,170307,Cabanes,2011,912,482,430,150,581,181
147,080272,"Cabanyes, les",2011,927,468,459,195,624,108
148,250616,Cabó,2011,94,49,45,5,61,28
149,430363,Cabra del Camp,2011,1152,615,537,211,746,195
150,080288,Cabrera d'Anoia,2011,1355,726,629,225,955,175
151,080291,Cabrera de Mar,2011,4528,2279,2249,789,3135,604
152,080305,Cabrils,2011,7196,3525,3671,1556,4878,762
153,170329,Cadaqués,2011,2902,1431,1471,438,2000,464
154,080312,Calaf,2011,3522,1857,1665,546,2328,648
155,430379,Calafell,2011,24984,12661,12323,3983,17300,3701
156,080348,Calders,2011,955,493,462,164,628,163
157,080327,Caldes d'Estrac,2011,2776,1338,1438,391,1850,535
158,170335,Caldes de Malavella,2011,6998,3481,3517,1236,4723,1039
159,080333,Caldes de Montbui,2011,17186,8616,8570,2892,11715,2579
160,080351,Calella,2011,18694,9305,9389,2853,12574,3267
161,080370,Calldetenes,2011,2426,1247,1179,388,1716,322
162,080386,Callús,2011,1940,945,995,358,1228,354
163,080364,Calonge de Segarra,2011,198,103,95,23,118,57
164,170340,Calonge i Sant Antoni,2011,10761,5395,5366,1623,7306,1832
165,250621,Camarasa,2011,949,494,455,79,606,264
166,439039,Camarles,2011,3600,1846,1754,526,2334,740
167,430385,Cambrils,2011,33008,16414,16594,5803,23026,4179
168,170353,Camós,2011,684,348,336,96,426,162
169,170366,Campdevànol,2011,3477,1716,1761,459,2162,856
170,170372,Campelles,2011,136,67,69,21,88,27
171,080399,Campins,2011,480,249,231,93,333,54
172,170388,Campllong,2011,497,254,243,117,319,61
173,170391,Camprodon,2011,2450,1201,1249,311,1582,557
174,250637,Canejan,2011,104,57,47,8,65,31
175,170405,Canet d'Adri,2011,609,307,302,81,409,119
176,080403,Canet de Mar,2011,14072,6927,7145,2209,9316,2547
177,439076,"Canonja, la",2011,5673,2837,2836,1027,3892,754
178,080410,Canovelles,2011,15851,8233,7618,2891,10951,2009
179,080425,Cànoves i Samalús,2011,2818,1449,1369,481,1916,421
180,170412,Cantallops,2011,326,168,158,36,210,80
181,080431,Canyelles,2011,4282,2177,2105,850,2993,439
182,430398,Capafonts,2011,123,67,56,5,77,41
183,430402,Capçanes,2011,420,210,210,44,271,105
184,080446,Capellades,2011,5494,2717,2777,842,3614,1038
185,170427,Capmany,2011,623,336,287,81,400,142
186,080459,Capolat,2011,85,35,50,14,54,17
187,080462,Cardedeu,2011,17241,8483,8758,3188,11784,2269
188,080478,Cardona,2011,5116,2518,2598,626,3250,1240
189,080484,Carme,2011,836,433,403,113,556,167
190,430419,Caseres,2011,292,143,149,30,171,91
191,170448,Cassà de la Selva,2011,9789,5075,4714,1623,6572,1594
192,080497,Casserres,2011,1595,802,793,154,1034,407
193,080575,Castell de l'Areny,2011,70,39,31,10,50,10
194,259046,Castell de Mur,2011,186,96,90,23,112,51
195,250642,Castellar de la Ribera,2011,156,80,76,27,90,39
196,080522,Castellar de n'Hug,2011,169,93,76,15,118,36
197,080500,Castellar del Riu,2011,174,95,79,28,112,34
198,080517,Castellar del Vallès,2011,23238,11530,11708,4346,15970,2922
199,080538,Castellbell i el Vilar,2011,3711,1895,1816,616,2459,636
200,080543,Castellbisbal,2011,12267,6277,5990,2524,8413,1330
201,080556,Castellcir,2011,665,342,323,130,424,111
202,250674,Castelldans,2011,1006,546,460,106,658,242
203,080569,Castelldefels,2011,63139,31431,31708,10915,44787,7437
204,080581,Castellet i la Gornal,2011,2223,1127,1096,366,1488,369
205,170464,Castellfollit de la Roca,2011,1002,512,490,139,628,235
206,080608,Castellfollit de Riubregós,2011,190,101,89,10,124,56
207,080594,Castellfollit del Boix,2011,409,205,204,67,255,87
208,080615,Castellgalí,2011,1966,1032,934,364,1318,284
209,080620,Castellnou de Bages,2011,1091,557,534,215,761,115
210,250680,Castellnou de Seana,2011,745,385,360,102,450,193
211,170470,Castelló d'Empúries,2011,11885,6081,5804,1908,8014,1963
212,250693,Castelló de Farfanya,2011,559,305,254,49,345,165
213,080636,Castellolí,2011,550,265,285,103,359,88
214,170486,Castell-Platja d'Aro,2011,10420,5198,5222,1480,7387,1553
215,250707,Castellserà,2011,1116,575,541,119,673,324
216,080641,Castellterçol,2011,2376,1188,1188,346,1527,503
217,430424,Castellvell del Camp,2011,2792,1404,1388,595,1912,285
218,080654,Castellví de la Marca,2011,1649,831,818,273,1066,310
219,080667,Castellví de Rosanes,2011,1792,894,898,334,1226,232
220,430430,"Catllar, el",2011,4148,2133,2015,720,2976,452
221,250714,Cava,2011,61,36,25,2,38,21
222,171899,"Cellera de Ter, la",2011,2105,1055,1050,313,1364,428
223,170499,Celrà,2011,4772,2378,2394,990,3323,459
224,080673,Centelles,2011,7360,3602,3758,1192,4863,1305
225,082687,Cercs,2011,1303,657,646,129,805,369
226,082665,Cerdanyola del Vallès,2011,58247,28737,29510,9148,40915,8184
227,080689,Cervelló,2011,8651,4352,4299,1472,6084,1095
228,250729,Cervera,2011,9390,4792,4598,1668,6277,1445
229,250735,Cervià de les Garrigues,2011,808,419,389,94,480,234
230,170502,Cervià de Ter,2011,895,449,446,162,571,162
231,170519,Cistella,2011,272,136,136,35,174,63
232,250740,Ciutadilla,2011,210,117,93,19,132,59
233,250753,Clariana de Cardener,2011,157,81,76,26,111,20
234,250766,"Cogul, el",2011,188,104,84,15,112,61
235,170545,Colera,2011,593,308,285,51,387,155
236,250772,Coll de Nargó,2011,607,311,296,64,404,139
237,080692,Collbató,2011,4242,2203,2039,973,2864,405
238,430458,Colldejou,2011,181,101,80,18,130,33
239,080706,Collsuspina,2011,347,185,162,58,229,60
240,170558,Colomers,2011,196,97,99,23,118,55
241,251636,"Coma i la Pedra, la",2011,275,163,112,33,198,44
242,251615,Conca de Dalt,2011,420,218,202,36,261,123
243,430461,Conesa,2011,129,65,64,9,89,31
244,430477,Constantí,2011,6592,3499,3093,1208,4531,853
245,080713,Copons,2011,332,162,170,65,209,58
246,430483,Corbera d'Ebre,2011,1180,632,548,156,763,261
247,080728,Corbera de Llobregat,2011,14064,7078,6986,2698,9806,1560
248,250788,Corbins,2011,1377,737,640,221,908,248
249,170577,Corçà,2011,1317,635,682,186,879,252
250,080734,Cornellà de Llobregat,2011,87243,43121,44122,13323,58221,15699
251,170561,Cornellà del Terri,2011,2233,1129,1104,346,1484,403
252,430496,Cornudella de Montsant,2011,1026,544,482,116,666,244
253,430509,Creixell,2011,3386,1747,1639,517,2214,655
254,170583,Crespià,2011,260,133,127,41,161,58
255,179011,"Cruïlles, Monells i Sant Sadurní de l'Heura",2011,1282,651,631,190,881,211
256,080749,Cubelles,2011,14293,7274,7019,2498,9881,1914
257,250791,Cubells,2011,400,211,189,44,239,117
258,430516,Cunit,2011,12551,6339,6212,2098,8233,2220
259,170600,Darnius,2011,528,273,255,49,342,137
260,170617,Das,2011,219,126,93,32,142,45
261,439018,Deltebre,2011,12302,6264,6038,1787,8092,2423
262,080752,Dosrius,2011,5123,2603,2520,996,3603,524
263,430537,Duesaigües,2011,236,135,101,22,155,59
264,170622,"Escala, l'",2011,10554,5404,5150,1419,7136,1999
265,080765,Esparreguera,2011,21986,11237,10749,3870,15207,2909
266,170638,Espinelves,2011,199,95,104,25,125,49
267,250812,"Espluga Calba, l'",2011,430,230,200,45,255,130
268,430542,"Espluga de Francolí, l'",2011,3923,1921,2002,555,2532,836
269,080771,Esplugues de Llobregat,2011,46687,22678,24009,6318,31707,8662
270,170643,Espolla,2011,417,207,210,46,259,112
271,170656,Esponellà,2011,451,219,232,80,277,94
272,250827,Espot,2011,350,191,159,47,248,55
273,080787,"Espunyola, l'",2011,268,137,131,37,154,77
274,082541,"Esquirol, l'",2011,2216,1124,1092,331,1413,472
275,250886,Estamariu,2011,123,70,53,11,70,42
276,080790,"Estany, l'",2011,393,197,196,46,242,105
277,250851,Estaràs,2011,170,91,79,14,110,46
278,250864,Esterri d'Àneu,2011,924,487,437,112,662,150
279,250870,Esterri de Cardós,2011,77,38,39,6,55,16
280,430555,Falset,2011,2952,1482,1470,449,1914,589
281,170059,"Far d'Empordà, el",2011,555,274,281,109,343,103
282,250899,Farrera,2011,140,81,59,23,94,23
283,430568,"Fatarella, la",2011,1111,555,556,108,658,345
284,430574,"Febró, la",2011,51,33,18,1,39,11
285,081347,Figaró-Montmany,2011,1112,565,547,183,711,218
286,080804,Fígols,2011,52,30,22,5,27,20
287,259084,Fígols i Alinyà,2011,282,157,125,23,163,96
288,430580,"Figuera, la",2011,133,74,59,5,91,37
289,170669,Figueres,2011,44765,22286,22479,7584,30694,6487
290,430593,Figuerola del Camp,2011,349,172,177,61,220,68
291,170675,Flaçà,2011,1059,513,546,158,685,216
292,430607,Flix,2011,3969,1996,1973,397,2642,930
293,250925,"Floresta, la",2011,168,92,76,22,97,49
294,080826,Fogars de la Selva,2011,1498,801,697,261,1035,202
295,080811,Fogars de Montclús,2011,453,242,211,85,288,80
296,170681,Foixà,2011,318,167,151,39,192,87
297,080832,Folgueroles,2011,2229,1130,1099,497,1420,312
298,250931,Fondarella,2011,834,419,415,119,586,129
299,080847,Fonollosa,2011,1417,736,681,227,995,195
300,170694,Fontanals de Cerdanya,2011,465,228,237,45,332,88
301,170708,Fontanilles,2011,167,97,70,25,101,41
302,170715,Fontcoberta,2011,1349,651,698,224,953,172
303,080850,Font-rubí,2011,1466,771,695,240,915,311
304,250946,Foradada,2011,183,106,77,14,116,53
305,179026,Forallac,2011,1785,875,910,255,1224,306
306,430614,Forès,2011,59,34,25,0,36,23
307,170736,Fornells de la Selva,2011,2380,1163,1217,507,1612,261
308,170741,Fortià,2011,658,333,325,101,410,147
309,080863,"Franqueses del Vallès, les",2011,18693,9619,9074,3404,13190,2099
310,430629,Freginals,2011,464,246,218,33,307,124
311,250962,"Fuliola, la",2011,1286,656,630,175,799,312
312,250978,Fulleda,2011,105,53,52,3,67,35
313,080902,Gaià,2011,172,92,80,27,121,24
314,430635,"Galera, la",2011,846,435,411,105,549,192
315,080879,Gallifa,2011,204,107,97,25,149,30
316,430640,Gandesa,2011,3219,1662,1557,439,2125,655
317,430653,Garcia,2011,580,291,289,60,364,156
318,430666,"Garidells, els",2011,191,99,92,19,139,33
319,080885,"Garriga, la",2011,15236,7389,7847,2718,10308,2210
320,170754,Garrigàs,2011,386,201,185,49,252,85
321,170767,Garrigoles,2011,164,89,75,17,106,41
322,170773,Garriguella,2011,863,431,432,130,562,171
323,080898,Gavà,2011,46250,22921,23329,7615,31858,6777
324,250984,Gavet de la Conca,2011,302,149,153,22,166,114
325,080919,Gelida,2011,7085,3556,3529,1289,4826,970
326,170789,Ger,2011,467,253,214,61,321,85
327,259123,Gimenells i el Pla de la Font,2011,1179,592,587,173,729,277
328,430672,Ginestar,2011,986,520,466,124,616,246
329,170792,Girona,2011,96722,46675,50047,16338,67175,13209
330,080924,Gironella,2011,5083,2523,2560,636,3264,1183
331,080930,Gisclareny,2011,31,16,15,0,26,5
332,430688,Godall,2011,822,429,393,91,498,233
333,250997,Golmés,2011,1691,831,860,284,1115,292
334,170806,Gombrèn,2011,209,100,109,31,139,39
335,251001,Gósol,2011,230,128,102,14,156,60
336,080945,"Granada, la",2011,1995,1004,991,350,1353,292
337,251018,"Granadella, la",2011,759,405,354,83,455,221
338,080958,Granera,2011,80,51,29,4,60,16
339,251023,"Granja d'Escarp, la",2011,968,519,449,97,635,236
340,080961,Granollers,2011,60000,29893,30107,9385,41572,9043
341,251039,Granyanella,2011,149,79,70,14,95,40
342,251057,Granyena de les Garrigues,2011,172,101,71,11,110,51
343,251044,Granyena de Segarra,2011,137,68,69,7,71,59
344,430691,Gratallops,2011,264,140,124,33,168,63
345,080977,Gualba,2011,1312,671,641,263,880,169
346,170813,Gualta,2011,358,196,162,58,228,72
347,080996,Guardiola de Berguedà,2011,1027,544,483,126,664,237
348,430705,"Guiamets, els",2011,322,148,174,24,210,88
349,170828,Guils de Cerdanya,2011,565,294,271,69,427,69
350,251095,Guimerà,2011,320,170,150,17,175,128
351,259031,"Guingueta d'Àneu, la",2011,347,182,165,40,238,69
352,251109,Guissona,2011,6552,3495,3057,1275,4686,591
353,251116,Guixers,2011,134,79,55,10,88,36
354,081000,Gurb,2011,2538,1318,1220,474,1727,337
355,430712,Horta de Sant Joan,2011,1295,690,605,153,796,346
356,081017,"Hospitalet de Llobregat, l'",2011,256065,125118,130947,34720,172210,49135
357,081629,"Hostalets de Pierola, els",2011,2827,1473,1354,575,1946,306
358,170834,Hostalric,2011,4030,2045,1985,669,2742,619
359,081022,Igualada,2011,39191,19322,19869,6622,25843,6726
360,251155,Isona i Conca Dellà,2011,1100,584,516,108,649,343
361,170849,Isòvol,2011,322,180,142,31,231,60
362,251137,Ivars d'Urgell,2011,1702,902,800,211,1067,424
363,251121,Ivars de Noguera,2011,357,193,164,37,230,90
364,251142,Ivorra,2011,120,63,57,9,71,40
365,170852,Jafre,2011,413,217,196,42,270,101
366,170865,"Jonquera, la",2011,3094,1564,1530,516,2164,414
367,081038,Jorba,2011,820,411,409,161,522,137
368,259101,Josa i Tuixén,2011,136,78,58,5,98,33
369,170871,Juià,2011,338,191,147,65,212,61
370,251180,Juncosa,2011,470,255,215,43,285,142
371,251193,Juneda,2011,3482,1818,1664,476,2287,719
372,251214,Les,2011,1005,511,494,153,721,131
373,251229,Linyola,2011,2712,1389,1323,433,1740,539
374,081043,"Llacuna, la",2011,935,506,429,110,608,217
375,170887,Lladó,2011,713,352,361,128,455,130
376,251235,Lladorre,2011,244,118,126,31,161,52
377,251240,Lladurs,2011,197,110,87,18,122,57
378,081056,"Llagosta, la",2011,13721,6859,6862,2331,9311,2079
379,170890,Llagostera,2011,8105,4183,3922,1385,5376,1344
380,170904,Llambilles,2011,717,373,344,146,462,109
381,170911,Llanars,2011,561,291,270,61,384,116
382,170926,Llançà,2011,5140,2576,2564,703,3427,1010
383,251253,Llardecans,2011,515,265,250,44,294,177
384,251266,Llavorsí,2011,373,194,179,46,247,80
385,251207,Lleida,2011,138416,68652,69764,21456,95474,21486
386,170932,Llers,2011,1193,608,585,180,779,234
387,251272,Lles de Cerdanya,2011,268,164,104,25,178,65
388,081075,Lliçà d'Amunt,2011,14456,7332,7124,2763,9798,1895
389,081081,Lliçà de Vall,2011,6404,3252,3152,1111,4421,872
390,251288,Llimiana,2011,183,106,77,17,116,50
391,081069,Llinars del Vallès,2011,9293,4611,4682,1566,6372,1355
392,170947,Llívia,2011,1665,901,764,218,1230,217
393,430727,"Lloar, el",2011,119,67,52,15,68,36
394,251291,Llobera,2011,210,114,96,26,135,49
395,430733,Llorac,2011,112,59,53,10,73,29
396,430748,Llorenç del Penedès,2011,2245,1112,1133,394,1455,396
397,170950,Lloret de Mar,2011,40282,21164,19118,6137,29893,4252
398,170963,"Llosses, les",2011,221,128,93,21,160,40
399,081094,Lluçà,2011,254,135,119,39,171,44
400,171024,Maçanet de Cabrenys,2011,735,372,363,79,437,219
401,171030,Maçanet de la Selva,2011,7099,3653,3446,1228,4857,1014
402,170979,Madremanya,2011,260,123,137,45,162,53
403,170985,Maià de Montcal,2011,432,225,207,75,264,93
404,251333,Maials,2011,969,509,460,110,577,282
405,251305,Maldà,2011,250,127,123,24,151,75
406,081108,Malgrat de Mar,2011,18444,9233,9211,2770,12446,3228
407,081115,Malla,2011,259,128,131,31,180,48
408,081120,Manlleu,2011,20445,10249,10196,3773,13366,3306
409,081136,Manresa,2011,76589,37610,38979,11839,50326,14424
410,430764,Marçà,2011,638,335,303,99,387,152
411,430751,Margalef,2011,115,64,51,6,71,38
412,082423,Marganell,2011,311,147,164,40,202,69
413,081141,Martorell,2011,27457,14249,13208,5048,18500,3909
414,081154,Martorelles,2011,4903,2463,2440,704,3367,832
415,430770,Mas de Barberans,2011,635,317,318,67,394,174
416,171002,Masarac,2011,296,161,135,36,197,63
417,430786,Masdenverge,2011,1131,588,543,143,753,235
418,081167,"Masies de Roda, les",2011,763,377,386,111,520,132
419,081173,"Masies de Voltregà, les",2011,3174,1565,1609,559,2125,490
420,430799,Masllorenç,2011,538,288,250,79,342,117
421,081189,"Masnou, el",2011,22523,10794,11729,3402,15402,3719
422,430803,"Masó, la",2011,293,150,143,34,178,81
423,430810,Maspujols,2011,730,381,349,126,481,123
424,081192,Masquefa,2011,8310,4200,4110,1686,5611,1013
425,430825,"Masroig, el",2011,562,296,266,73,336,153
426,251312,Massalcoreig,2011,581,308,273,52,382,147
427,171019,Massanes,2011,700,364,336,106,490,104
428,251327,Massoteres,2011,205,106,99,41,129,35
429,081206,Matadepera,2011,8584,4318,4266,1733,5731,1120
430,081213,Mataró,2011,123868,61960,61908,20055,85002,18811
431,081228,Mediona,2011,2347,1192,1155,412,1463,472
432,251348,Menàrguens,2011,903,488,415,94,580,229
433,170998,Meranges,2011,96,54,42,15,62,19
434,171058,Mieres,2011,335,172,163,45,219,71
435,430831,"Milà, el",2011,183,89,94,27,107,49
436,251351,Miralcamp,2011,1429,727,702,204,949,276
437,430846,Miravet,2011,770,408,362,95,480,195
438,081385,Moià,2011,5730,2900,2830,1025,3802,903
439,430859,"Molar, el",2011,305,166,139,30,183,92
440,081234,Molins de Rei,2011,24572,11997,12575,4310,16644,3618
441,251370,Mollerussa,2011,14705,7598,7107,2687,10208,1810
442,171061,Mollet de Peralada,2011,178,87,91,21,103,54
443,081249,Mollet del Vallès,2011,52409,26236,26173,9088,36432,6889
444,171077,Molló,2011,358,175,183,40,230,88
445,251364,"Molsosa, la",2011,116,59,57,5,79,32
446,081287,Monistrol de Calders,2011,689,352,337,96,456,137
447,081271,Monistrol de Montserrat,2011,3009,1550,1459,411,2045,553
448,171096,Montagut i Oix,2011,983,517,466,135,650,198
449,430862,Montblanc,2011,7354,3725,3629,1080,5018,1256
450,430884,Montbrió del Camp,2011,2461,1245,1216,393,1702,366
451,081252,Montcada i Reixac,2011,34232,17026,17206,5896,23503,4833
452,081304,Montclar,2011,112,54,58,17,65,30
453,251399,Montellà i Martinet,2011,683,356,327,75,466,142
454,081311,Montesquiu,2011,901,465,436,130,587,184
455,251403,Montferrer i Castellbò,2011,1083,589,494,150,800,133
456,430897,Montferri,2011,405,213,192,87,257,61
457,251386,Montgai,2011,720,372,348,76,426,218
458,081265,Montgat,2011,10739,5291,5448,1736,7610,1393
459,081326,Montmajor,2011,475,245,230,56,311,108
460,081332,Montmaneu,2011,196,110,86,18,123,55
461,430901,"Montmell, el",2011,1509,821,688,251,1019,239
462,081350,Montmeló,2011,8913,4403,4510,1477,6125,1311
463,251425,Montoliu de Lleida,2011,505,256,249,62,323,120
464,251410,Montoliu de Segarra,2011,196,114,82,19,119,58
465,251431,Montornès de Segarra,2011,98,47,51,4,53,41
466,081363,Montornès del Vallès,2011,16042,8186,7856,2924,11132,1986
467,430918,Mont-ral,2011,175,102,73,17,131,27
468,171100,Mont-ras,2011,1833,927,906,276,1275,282
469,430923,Mont-roig del Camp,2011,12476,6485,5991,1857,8685,1934
470,081379,Montseny,2011,314,164,150,29,212,73
471,430939,Móra d'Ebre,2011,5699,2814,2885,935,3771,993
472,430944,Móra la Nova,2011,3289,1681,1608,484,2205,600
473,430957,"Morell, el",2011,3445,1784,1661,612,2420,413
474,430960,"Morera de Montsant, la",2011,164,99,65,18,113,33
475,081290,Muntanyola,2011,568,291,277,112,395,61
476,081398,Mura,2011,230,119,111,35,158,37
477,251459,Nalec,2011,99,53,46,3,59,37
478,250254,Naut Aran,2011,1760,908,852,258,1301,201
479,081402,Navarcles,2011,5965,2926,3039,880,4026,1059
480,081419,Navàs,2011,6171,3068,3103,950,3986,1235
481,171117,Navata,2011,1227,613,614,228,787,212
482,251462,Navès,2011,277,135,142,44,174,59
483,081424,"Nou de Berguedà, la",2011,147,78,69,19,87,41
484,430976,"Nou de Gaià, la",2011,535,263,272,112,314,109
485,430982,Nulles,2011,461,237,224,61,303,97
486,251484,Odèn,2011,273,162,111,17,180,76
487,081430,Òdena,2011,3469,1773,1696,600,2343,526
488,171122,Ogassa,2011,251,148,103,30,170,51
489,081458,Olèrdola,2011,3584,1856,1728,719,2414,451
490,081461,Olesa de Bonesvalls,2011,1762,919,843,298,1221,243
491,081477,Olesa de Montserrat,2011,23924,12060,11864,4408,16222,3294
492,251497,Oliana,2011,1942,976,966,221,1256,465
493,251500,Oliola,2011,230,131,99,19,150,61
494,251517,Olius,2011,870,449,421,186,566,118
495,081483,Olivella,2011,3589,1909,1680,737,2538,314
496,081496,Olost,2011,1191,595,596,143,762,286
497,171143,Olot,2011,33725,16814,16911,5018,22265,6442
498,251522,"Oluges, les",2011,174,98,76,5,108,61
499,081445,Olvan,2011,908,458,450,103,584,221
500,251538,"Omellons, els",2011,241,129,112,16,147,78
501,251543,"Omells de na Gaia, els",2011,146,78,68,13,89,44
502,171156,Ordis,2011,379,204,175,60,251,68
503,251556,Organyà,2011,929,452,477,92,580,257
504,081509,Orís,2011,291,149,142,39,209,43
505,081516,Oristà,2011,569,282,287,47,387,135
506,081521,Orpí,2011,172,95,77,15,125,32
507,081537,Òrrius,2011,644,327,317,107,443,94
508,251569,Os de Balaguer,2011,987,513,474,170,605,212
509,171169,Osor,2011,456,227,229,54,291,111
510,251575,Ossó de Sió,2011,218,110,108,26,132,60
511,081542,Pacs del Penedès,2011,872,437,435,148,601,123
512,081555,Palafolls,2011,8966,4494,4472,1762,6193,1011
513,171175,Palafrugell,2011,22816,11444,11372,3870,15322,3624
514,171181,Palamós,2011,17918,8822,9096,2712,12117,3089
515,251581,"Palau d'Anglesola, el",2011,2172,1075,1097,339,1407,426
516,171194,Palau de Santa Eulàlia,2011,104,63,41,11,74,19
517,171215,Palau-sator,2011,294,155,139,36,187,71
518,171208,Palau-saverdera,2011,1488,740,748,265,925,298
519,081568,Palau-solità i Plegamans,2011,14352,7173,7179,2625,9978,1749
520,431009,"Pallaresos, els",2011,4265,2180,2085,1035,2930,300
521,081574,Pallejà,2011,11272,5695,5577,2188,7673,1411
522,430995,"Palma d'Ebre, la",2011,417,199,218,39,239,139
523,089058,"Palma de Cervelló, la",2011,3019,1507,1512,500,2156,363
524,171236,Palol de Revardit,2011,471,245,226,81,302,88
525,171241,Pals,2011,2725,1379,1346,380,1752,593
526,081580,"Papiol, el",2011,3941,1947,1994,672,2702,567
527,171254,Pardines,2011,159,91,68,22,90,47
528,081593,Parets del Vallès,2011,18113,9190,8923,3195,12698,2220
529,171267,Parlavà,2011,383,198,185,45,261,77
530,431016,Passanant i Belltall,2011,168,91,77,10,108,50
531,171289,Pau,2011,589,294,295,96,376,117
532,431021,Paüls,2011,605,301,304,57,373,175
533,171292,Pedret i Marzà,2011,175,92,83,28,112,35
534,251641,Penelles,2011,505,296,209,42,316,147
535,171306,"Pera, la",2011,435,217,218,59,274,102
536,081607,Perafita,2011,400,204,196,52,244,104
537,431037,Perafort,2011,1230,646,584,252,841,137
538,171328,Peralada,2011,1846,931,915,300,1212,334
539,251654,Peramola,2011,384,194,190,39,236,109
540,431042,"Perelló, el",2011,3336,1784,1552,423,2175,738
541,081614,Piera,2011,14867,7581,7286,2765,9883,2219
542,431055,"Piles, les",2011,219,117,102,29,150,40
543,081635,Pineda de Mar,2011,26040,13156,12884,3991,17708,4341
544,431068,"Pinell de Brai, el",2011,1133,575,558,127,688,318
545,251667,Pinell de Solsonès,2011,217,119,98,26,132,59
546,251673,Pinós,2011,307,169,138,39,202,66
547,431074,Pira,2011,500,260,240,94,309,97
548,431080,"Pla de Santa Maria, el",2011,2385,1257,1128,366,1591,428
549,081640,"Pla del Penedès, el",2011,1145,578,567,183,747,215
550,171334,"Planes d'Hostoles, les",2011,1708,865,843,210,1023,475
551,171349,Planoles,2011,309,167,142,34,208,67
552,259118,"Plans de Sió, els",2011,559,300,259,56,327,176
553,251689,"Poal, el",2011,645,332,313,73,401,171
554,251692,"Pobla de Cérvoles, la",2011,245,136,109,34,145,66
555,081653,"Pobla de Claramunt, la",2011,2269,1146,1123,419,1477,373
556,081666,"Pobla de Lillet, la",2011,1295,642,653,89,829,377
557,431093,"Pobla de Mafumet, la",2011,2810,1460,1350,510,2093,207
558,431107,"Pobla de Massaluca, la",2011,377,198,179,30,221,126
559,431114,"Pobla de Montornès, la",2011,2902,1539,1363,496,1942,464
560,251713,"Pobla de Segur, la",2011,3246,1594,1652,430,2022,794
561,431129,Poboleda,2011,383,209,174,36,258,89
562,081672,Polinyà,2011,7984,4068,3916,1655,5699,630
563,431135,"Pont d'Armentera, el",2011,583,306,277,68,362,153
564,250306,"Pont de Bar, el",2011,190,108,82,27,116,47
565,171352,Pont de Molins,2011,509,267,242,61,356,92
566,251734,"Pont de Suert, el",2011,2517,1310,1207,347,1703,467
567,081825,"Pont de Vilomara i Rocafort, el",2011,3741,1940,1801,646,2531,564
568,431418,Pontils,2011,134,76,58,7,95,32
569,081688,Pontons,2011,572,309,263,90,391,91
570,171365,Pontós,2011,233,127,106,32,144,57
571,251728,Ponts,2011,2714,1376,1338,407,1740,567
572,171371,Porqueres,2011,4431,2185,2246,822,2951,658
573,431140,Porrera,2011,468,251,217,47,307,114
574,171404,"Port de la Selva, el",2011,1009,539,470,118,660,231
575,171387,Portbou,2011,1290,644,646,93,818,379
576,251749,"Portella, la",2011,754,415,339,77,541,136
577,431153,Pradell de la Teixeta,2011,204,91,113,20,136,48
578,431166,Prades,2011,662,348,314,83,427,152
579,431172,Prat de Comte,2011,190,105,85,24,110,56
580,081691,"Prat de Llobregat, el",2011,63499,31528,31971,9703,43871,9925
581,431188,Pratdip,2011,848,457,391,90,502,256
582,081712,Prats de Lluçanès,2011,2676,1322,1354,337,1768,571
583,081705,"Prats de Rei, els",2011,532,284,248,51,361,120
584,251752,Prats i Sansor,2011,284,151,133,40,201,43
585,251765,Preixana,2011,426,218,208,53,228,145
586,251771,Preixens,2011,477,236,241,61,255,161
587,082303,Premià de Dalt,2011,10168,5095,5073,1712,7031,1425
588,081727,Premià de Mar,2011,28310,13963,14347,4438,19497,4375
589,171390,"Preses, les",2011,1745,843,902,304,1137,304
590,251790,Prullans,2011,234,111,123,23,147,64
591,171411,Puigcerdà,2011,8802,4440,4362,1493,6063,1246
592,081748,Puigdàlber,2011,525,259,266,82,364,79
593,251804,Puiggròs,2011,314,166,148,48,198,68
594,431191,Puigpelat,2011,1022,533,489,209,701,112
595,081751,Puig-reig,2011,4347,2150,2197,494,2749,1104
596,251811,Puigverd d'Agramunt,2011,281,160,121,33,179,69
597,251826,Puigverd de Lleida,2011,1422,735,687,246,908,268
598,081764,Pujalt,2011,208,107,101,25,133,50
599,081770,"Quar, la",2011,66,40,26,6,43,17
600,171426,Quart,2011,3150,1597,1553,583,2218,349
601,170433,Queralbs,2011,186,104,82,15,118,53
602,431205,Querol,2011,544,295,249,71,380,93
603,171432,Rabós,2011,196,102,94,23,125,48
604,081786,Rajadell,2011,524,273,251,68,356,100
605,431212,Rasquera,2011,962,482,480,107,577,278
606,171447,Regencós,2011,301,162,139,49,181,71
607,081799,Rellinars,2011,738,381,357,123,510,105
608,431227,Renau,2011,138,71,67,25,100,13
609,431233,Reus,2011,106709,52399,54310,18644,72376,15689
610,251832,Rialp,2011,664,341,323,97,469,98
611,431248,"Riba, la",2011,681,363,318,75,451,155
612,431251,Riba-roja d'Ebre,2011,1321,706,615,105,859,357
613,259059,Ribera d'Ondara,2011,459,238,221,52,285,122
614,251850,Ribera d'Urgellet,2011,975,505,470,140,643,192
615,171450,Ribes de Freser,2011,1941,956,985,195,1206,540
616,171463,Riells i Viabrea,2011,3993,2063,1930,800,2792,401
617,431264,"Riera de Gaià, la",2011,1677,858,819,338,1114,225
618,251863,Riner,2011,283,141,142,34,182,67
619,171479,Ripoll,2011,10913,5393,5520,1400,7156,2357
620,081803,Ripollet,2011,37348,18696,18652,6790,25749,4809
621,259139,Riu de Cerdanya,2011,113,64,49,11,87,15
622,171485,Riudarenes,2011,2183,1113,1070,372,1459,352
623,171498,Riudaura,2011,439,218,221,61,289,89
624,431270,Riudecanyes,2011,1154,592,562,214,725,215
625,431286,Riudecols,2011,1294,666,628,192,879,223
626,171501,Riudellots de la Selva,2011,2022,1047,975,332,1392,298
627,431299,Riudoms,2011,6466,3320,3146,1105,4271,1090
628,171518,Riumors,2011,247,127,120,37,158,52
629,081810,"Roca del Vallès, la",2011,10303,5193,5110,1979,7028,1296
630,431303,Rocafort de Queralt,2011,244,129,115,26,147,71
631,431310,Roda de Berà,2011,6284,3277,3007,1003,4291,990
632,081831,Roda de Ter,2011,6151,3021,3130,1023,4041,1087
633,431325,Rodonyà,2011,500,266,234,80,312,108
634,431331,Roquetes,2011,8280,4344,3936,1369,5578,1333
635,171523,Roses,2011,19731,9947,9784,3394,13447,2890
636,251898,Rosselló,2011,3030,1558,1472,534,2082,414
637,431346,"Rourell, el",2011,386,201,185,63,256,67
638,081846,Rubí,2011,73979,37046,36933,12806,51750,9423
639,081859,Rubió,2011,222,121,101,26,149,47
640,171539,Rupià,2011,241,120,121,35,155,51
641,089019,Rupit i Pruit,2011,309,159,150,27,212,70
642,081878,Sabadell,2011,207721,101490,106231,33149,139164,35408
643,081884,Sagàs,2011,140,74,66,26,85,29
644,251902,Salàs de Pallars,2011,353,180,173,24,222,107
645,081901,Saldes,2011,324,180,144,27,229,68
646,171544,Sales de Llierca,2011,144,77,67,22,106,16
647,081918,Sallent,2011,6892,3317,3575,927,4322,1643
648,431359,Salomó,2011,525,285,240,84,335,106
649,439057,Salou,2011,26193,14073,12120,4062,19670,2461
650,171557,Salt,2011,30389,16216,14173,6036,20964,3389
651,251919,Sanaüja,2011,460,236,224,63,269,128
652,081944,Sant Adrià de Besòs,2011,34157,16809,17348,5744,22581,5832
653,081957,Sant Agustí de Lluçanès,2011,96,50,46,4,69,23
654,081960,Sant Andreu de la Barca,2011,27094,13692,13402,5328,18724,3042
655,081976,Sant Andreu de Llavaneres,2011,10406,5188,5218,1908,7036,1462
656,171576,Sant Andreu Salou,2011,152,76,76,20,93,39
657,171833,Sant Aniol de Finestres,2011,345,184,161,50,229,66
658,081982,Sant Antoni de Vilamajor,2011,5555,2784,2771,1021,3806,728
659,081995,Sant Bartomeu del Grau,2011,963,498,465,143,680,140
660,082009,Sant Boi de Llobregat,2011,82860,41117,41743,12880,56799,13181
661,082016,Sant Boi de Lluçanès,2011,523,267,256,59,335,129
662,431362,Sant Carles de la Ràpita,2011,15338,7595,7743,2307,10066,2965
663,082037,Sant Cebrià de Vallalta,2011,3426,1781,1645,648,2394,384
664,082021,Sant Celoni,2011,16949,8462,8487,2890,11394,2665
665,082042,Sant Climent de Llobregat,2011,3907,1969,1938,777,2686,444
666,171582,Sant Climent Sescebes,2011,545,290,255,68,340,137
667,082055,Sant Cugat del Vallès,2011,83337,40744,42593,17524,56808,9005
668,082068,Sant Cugat Sesgarrigues,2011,992,504,488,183,629,180
669,251961,Sant Esteve de la Sarga,2011,138,83,55,7,92,39
670,082074,Sant Esteve de Palautordera,2011,2516,1234,1282,543,1684,289
671,082080,Sant Esteve Sesrovires,2011,7439,3747,3692,1390,5117,932
672,171595,Sant Feliu de Buixalleu,2011,768,403,365,108,521,139
673,082107,Sant Feliu de Codines,2011,5990,3030,2960,1065,4029,896
674,171609,Sant Feliu de Guíxols,2011,21814,10830,10984,3372,14705,3737
675,082114,Sant Feliu de Llobregat,2011,43096,21026,22070,7219,29288,6589
676,171616,Sant Feliu de Pallerols,2011,1330,647,683,218,832,280
677,082129,Sant Feliu Sasserra,2011,669,343,326,83,448,138
678,171621,Sant Ferriol,2011,228,134,94,40,154,34
679,082093,Sant Fost de Campsentelles,2011,8421,4227,4194,1354,5742,1325
680,082135,Sant Fruitós de Bages,2011,8198,4117,4081,1525,5660,1013
681,171637,Sant Gregori,2011,3280,1662,1618,630,2189,461
682,251924,Sant Guim de Freixenet,2011,1111,558,553,156,700,255
683,251977,Sant Guim de la Plana,2011,195,103,92,25,113,57
684,171642,Sant Hilari Sacalm,2011,5724,2939,2785,793,3862,1069
685,082153,Sant Hipòlit de Voltregà,2011,3547,1795,1752,586,2301,660
686,081939,Sant Iscle de Vallalta,2011,1281,672,609,240,853,188
687,439023,Sant Jaume d'Enveja,2011,3541,1800,1741,487,2261,793
688,082166,Sant Jaume de Frontanyà,2011,19,11,8,0,15,4
689,171655,Sant Jaume de Llierca,2011,774,389,385,81,473,220
690,431378,Sant Jaume dels Domenys,2011,2505,1285,1220,449,1670,386
691,171674,Sant Joan de les Abadesses,2011,3492,1736,1756,413,2181,898
692,171680,Sant Joan de Mollet,2011,522,264,258,86,333,103
693,082188,Sant Joan de Vilatorrada,2011,10767,5411,5356,1826,7200,1741
694,082172,Sant Joan Despí,2011,32406,15889,16517,5815,22044,4547
695,171851,Sant Joan les Fonts,2011,2877,1456,1421,347,1884,646
696,171668,Sant Jordi Desvalls,2011,667,323,344,93,427,147
697,089030,Sant Julià de Cerdanyola,2011,263,145,118,37,166,60
698,171693,Sant Julià de Ramis,2011,3348,1686,1662,652,2300,396
699,082205,Sant Julià de Vilatorta,2011,2984,1466,1518,551,2010,423
700,179032,Sant Julià del Llor i Bonmatí,2011,1271,646,625,220,872,179
701,082212,Sant Just Desvern,2011,16253,7738,8515,2734,10831,2688
702,082227,Sant Llorenç d'Hortons,2011,2492,1257,1235,469,1694,329
703,171714,Sant Llorenç de la Muga,2011,227,117,110,29,147,51
704,251930,Sant Llorenç de Morunys,2011,1032,526,506,132,646,254
705,082233,Sant Llorenç Savall,2011,2412,1216,1196,360,1558,494
706,082251,Sant Martí d'Albars,2011,109,56,53,13,68,28
707,082248,Sant Martí de Centelles,2011,1080,550,530,178,746,156
708,171729,Sant Martí de Llémena,2011,591,306,285,100,411,80
709,259025,Sant Martí de Riucorb,2011,683,357,326,72,392,219
710,082264,Sant Martí de Tous,2011,1167,590,577,238,707,222
711,082270,Sant Martí Sarroca,2011,3197,1596,1601,533,2076,588
712,082286,Sant Martí Sesgueioles,2011,376,188,188,58,242,76
713,171735,Sant Martí Vell,2011,258,137,121,55,159,44
714,082299,Sant Mateu de Bages,2011,642,332,310,60,379,203
715,171740,Sant Miquel de Campmajor,2011,234,121,113,30,155,49
716,171753,Sant Miquel de Fluvià,2011,764,390,374,103,520,141
717,171766,Sant Mori,2011,193,100,93,23,144,26
718,171772,Sant Pau de Segúries,2011,694,347,347,79,442,173
719,082310,Sant Pere de Ribes,2011,28783,14551,14232,5089,20223,3471
720,082325,Sant Pere de Riudebitlles,2011,2382,1195,1187,412,1526,444
721,082331,Sant Pere de Torelló,2011,2423,1237,1186,335,1628,460
722,082346,Sant Pere de Vilamajor,2011,4256,2142,2114,861,2849,546
723,171788,Sant Pere Pescador,2011,2108,1133,975,327,1465,316
724,081897,Sant Pere Sallavinera,2011,164,89,75,20,99,45
725,082359,Sant Pol de Mar,2011,5070,2558,2512,832,3397,841
726,082362,Sant Quintí de Mediona,2011,2147,1104,1043,393,1355,399
727,082378,Sant Quirze de Besora,2011,2201,1079,1122,300,1352,549
728,082384,Sant Quirze del Vallès,2011,19051,9368,9683,3854,13370,1827
729,082397,Sant Quirze Safaja,2011,661,341,320,134,454,73
730,251945,Sant Ramon,2011,552,293,259,56,338,158
731,082401,Sant Sadurní d'Anoia,2011,12345,6074,6271,2192,8279,1874
732,082418,Sant Sadurní d'Osormort,2011,95,52,43,10,65,20
733,080983,Sant Salvador de Guardiola,2011,3146,1608,1538,622,2073,451
734,082628,Sant Vicenç de Castellet,2011,9126,4547,4579,1400,6072,1654
735,082649,Sant Vicenç de Montalt,2011,5854,2962,2892,1298,3820,736
736,082652,Sant Vicenç de Torelló,2011,2049,1004,1045,341,1303,405
737,082634,Sant Vicenç dels Horts,2011,28137,14135,14002,4903,19304,3930
738,431384,Santa Bàrbara,2011,3989,2042,1947,596,2572,821
739,082439,Santa Cecília de Voltregà,2011,182,97,85,16,128,38
740,082444,Santa Coloma de Cervelló,2011,7931,3901,4030,1750,5321,860
741,171805,Santa Coloma de Farners,2011,12305,6293,6012,2146,8340,1819
742,082457,Santa Coloma de Gramenet,2011,120824,61082,59742,18063,82163,20598
743,431397,Santa Coloma de Queralt,2011,3092,1558,1534,551,1911,630
744,171812,Santa Cristina d'Aro,2011,5066,2582,2484,887,3449,730
745,082460,Santa Eugènia de Berga,2011,2294,1188,1106,327,1638,329
746,082476,Santa Eulàlia de Riuprimer,2011,1123,576,547,193,756,174
747,082482,Santa Eulàlia de Ronçana,2011,6921,3447,3474,1275,4590,1056
748,082495,Santa Fe del Penedès,2011,408,208,200,83,274,51
749,171827,Santa Llogaia d'Àlguema,2011,342,177,165,59,239,44
750,082508,Santa Margarida de Montbui,2011,9812,4923,4889,1744,6639,1429
751,082515,Santa Margarida i els Monjos,2011,7030,3588,3442,1411,4821,798
752,082589,Santa Maria d'Oló,2011,1066,541,525,157,674,235
753,082536,Santa Maria de Besora,2011,160,80,80,18,89,53
754,082567,Santa Maria de Martorelles,2011,841,430,411,147,590,104
755,082554,Santa Maria de Merlès,2011,171,82,89,34,108,29
756,082573,Santa Maria de Miralles,2011,140,69,71,15,94,31
757,082592,Santa Maria de Palautordera,2011,9097,4677,4420,1628,6249,1220
758,431401,Santa Oliva,2011,3343,1730,1613,596,2224,523
759,171848,Santa Pau,2011,1601,807,794,207,1089,305
760,082606,Santa Perpètua de Mogoda,2011,25331,13047,12284,4818,17603,2910
761,082613,Santa Susanna,2011,3317,1693,1624,602,2269,446
762,081923,Santpedor,2011,7185,3608,3577,1249,4886,1050
763,431423,Sarral,2011,1703,874,829,278,1099,326
764,171864,Sarrià de Ter,2011,4714,2343,2371,745,3167,802
765,252017,Sarroca de Bellera,2011,127,74,53,2,86,39
766,252000,Sarroca de Lleida,2011,433,236,197,40,274,119
767,171870,"Saus, Camallera i Llampaies",2011,780,372,408,110,515,155
768,431439,Savallà del Comtat,2011,69,34,35,3,48,18
769,431444,"Secuita, la",2011,1582,810,772,261,1099,222
770,171886,"Selva de Mar, la",2011,209,111,98,17,142,50
771,431457,"Selva del Camp, la",2011,5576,2822,2754,1030,3739,807
772,431460,Senan,2011,55,34,21,6,38,11
773,430445,"Sénia, la",2011,6045,3084,2961,944,4042,1059
774,252022,Senterada,2011,135,73,62,11,102,22
775,250352,"Sentiu de Sió, la",2011,488,248,240,44,320,124
776,082671,Sentmenat,2011,8407,4266,4141,1527,5896,984
777,171903,Serinyà,2011,1117,569,548,181,751,185
778,252043,Seròs,2011,1910,1052,858,232,1250,428
779,171910,Serra de Daró,2011,209,113,96,32,125,52
780,171925,Setcases,2011,176,95,81,10,119,47
781,252038,"Seu d'Urgell, la",2011,13009,6379,6630,1979,8882,2148
782,082690,Seva,2011,3412,1754,1658,596,2252,564
783,252056,Sidamon,2011,739,372,367,121,500,118
784,171931,Sils,2011,5492,2799,2693,997,3761,734
785,082704,Sitges,2011,28617,14270,14347,4476,19844,4297
786,170524,Siurana,2011,181,95,86,27,107,47
787,082711,Sobremunt,2011,88,42,46,14,54,20
788,252069,"Soleràs, el",2011,369,197,172,48,200,121
789,431476,Solivella,2011,687,349,338,105,398,184
790,252075,Solsona,2011,9304,4665,4639,1586,6104,1614
791,082726,Sora,2011,179,102,77,23,123,33
792,252081,Soriguera,2011,368,200,168,45,250,73
793,252094,Sort,2011,2360,1204,1156,381,1584,395
794,252108,Soses,2011,1764,910,854,272,1175,317
795,082732,Subirats,2011,3075,1540,1535,527,1971,577
796,252115,Sudanell,2011,885,489,396,97,606,182
797,252120,Sunyer,2011,305,161,144,32,194,79
798,082747,Súria,2011,6255,3052,3203,798,4020,1437
799,171946,Susqueda,2011,115,68,47,13,76,26
800,082763,Tagamanent,2011,314,170,144,56,203,55
801,082779,Talamanca,2011,155,89,66,17,114,24
802,252154,Talarn,2011,523,277,246,64,369,90
803,252167,Talavera,2011,290,162,128,31,180,79
804,171959,"Tallada d'Empordà, la",2011,449,224,225,66,286,97
805,082785,Taradell,2011,6181,3111,3070,1030,4103,1048
806,431482,Tarragona,2011,134085,65961,68124,21818,91536,20731
807,252173,Tàrrega,2011,17129,8617,8512,3075,11616,2438
808,252189,Tarrés,2011,108,57,51,9,70,29
809,252192,Tarroja de Segarra,2011,175,91,84,18,106,51
810,082750,Tavèrnoles,2011,307,155,152,46,213,48
811,082802,Tavertet,2011,142,79,63,12,101,29
812,082819,Teià,2011,6162,3060,3102,963,4243,956
813,252206,Térmens,2011,1521,784,737,187,1001,333
814,171962,Terrades,2011,311,157,154,48,205,58
815,082798,Terrassa,2011,213697,105920,107777,36912,144806,31979
816,082824,Tiana,2011,7973,3871,4102,1448,5512,1013
817,252213,Tírvia,2011,160,81,79,18,111,31
818,252228,Tiurana,2011,83,40,43,11,47,25
819,431495,Tivenys,2011,910,464,446,93,547,270
820,431508,Tivissa,2011,1824,927,897,209,1150,465
821,082830,Tona,2011,8119,4051,4068,1458,5401,1260
822,252234,Torà,2011,1343,683,660,177,897,269
823,082845,Tordera,2011,15974,8167,7807,2691,10853,2430
824,082858,Torelló,2011,13931,6887,7044,2179,9396,2356
825,252249,"Torms, els",2011,171,94,77,19,94,58
826,252252,Tornabous,2011,871,469,402,108,530,233
827,252271,"Torre de Cabdella, la",2011,769,384,385,46,499,224
828,082861,"Torre de Claramunt, la",2011,3796,1973,1823,715,2631,450
829,431515,"Torre de Fontaubella, la",2011,140,73,67,16,81,43
830,431520,"Torre de l'Espanyol, la",2011,698,354,344,98,422,178
831,252265,Torrebesses,2011,300,157,143,27,181,92
832,431536,Torredembarra,2011,15461,7692,7769,2443,10580,2438
833,252287,Torrefarrera,2011,4309,2182,2127,893,3006,410
834,259078,Torrefeta i Florejacs,2011,634,329,305,77,378,179
835,252304,Torregrossa,2011,2241,1133,1108,280,1415,546
836,252311,Torrelameu,2011,714,409,305,76,486,152
837,082877,Torrelavit,2011,1398,755,643,191,945,262
838,082883,Torrelles de Foix,2011,2454,1292,1162,395,1623,436
839,082896,Torrelles de Llobregat,2011,5661,2810,2851,1160,3937,564
840,171978,Torrent,2011,189,100,89,20,125,44
841,252326,Torres de Segre,2011,2146,1115,1031,270,1444,432
842,252332,Torre-serona,2011,348,182,166,39,219,90
843,171984,Torroella de Fluvià,2011,699,354,345,106,496,97
844,171997,Torroella de Montgrí,2011,11385,5770,5615,1896,7726,1763
845,431541,Torroja del Priorat,2011,171,93,78,14,102,55
846,172001,Tortellà,2011,760,380,380,96,458,206
847,431554,Tortosa,2011,34432,17305,17127,5263,22807,6362
848,172018,Toses,2011,161,99,62,17,107,37
849,172023,Tossa de Mar,2011,5917,3023,2894,822,4090,1005
850,252347,Tremp,2011,6711,3462,3249,932,4366,1413
851,172044,Ullà,2011,1075,590,485,194,745,136
852,082900,Ullastrell,2011,1904,960,944,419,1253,232
853,172057,Ullastret,2011,268,138,130,51,166,51
854,431567,Ulldecona,2011,7404,3823,3581,1113,4961,1330
855,431573,Ulldemolins,2011,449,258,191,33,260,156
856,172039,Ultramort,2011,211,113,98,25,130,56
857,172060,Urús,2011,204,99,105,24,141,39
858,082917,Vacarisses,2011,6175,3215,2960,1382,4134,659
859,170144,"Vajol, la",2011,101,59,42,8,76,17
860,172076,"Vall d'en Bas, la",2011,2888,1443,1445,439,1857,592
861,172082,"Vall de Bianya, la",2011,1315,667,648,216,878,221
862,250432,"Vall de Boí, la",2011,1076,587,489,107,800,169
863,259010,Vall de Cardós,2011,404,215,189,47,262,95
864,082922,Vallbona d'Anoia,2011,1433,737,696,223,985,225
865,252385,Vallbona de les Monges,2011,264,142,122,20,159,85
866,082938,Vallcebre,2011,269,161,108,21,176,72
867,431589,Vallclara,2011,125,70,55,17,75,33
868,252402,Vallfogona de Balaguer,2011,1847,917,930,272,1282,293
869,171707,Vallfogona de Ripollès,2011,223,121,102,20,147,56
870,431592,Vallfogona de Riucorb,2011,115,67,48,3,70,42
871,082943,Vallgorguina,2011,2617,1347,1270,527,1811,279
872,082956,Vallirana,2011,14409,7209,7200,2747,9762,1900
873,172095,Vall-llobrega,2011,877,439,438,190,605,82
874,431606,Vallmoll,2011,1651,862,789,253,1154,244
875,082969,Vallromanes,2011,2396,1223,1173,556,1602,238
876,431613,Valls,2011,25016,12618,12398,4048,16902,4066
877,259062,"Valls d'Aguilar, les",2011,305,169,136,25,199,81
878,252398,"Valls de Valira, les",2011,953,502,451,82,711,160
879,431628,Vandellòs i l'Hospitalet de l'Infant,2011,5941,2956,2985,938,4080,923
880,259097,"Vansa i Fórnols, la",2011,214,115,99,17,137,60
881,082975,Veciana,2011,173,97,76,25,97,51
882,431634,"Vendrell, el",2011,36453,18296,18157,6378,24888,5187
883,172109,Ventalló,2011,800,406,394,116,522,162
884,252424,Verdú,2011,1006,485,521,119,584,303
885,172116,Verges,2011,1207,600,607,172,765,270
886,431649,Vespella de Gaià,2011,415,235,180,62,287,66
887,082981,Vic,2011,40900,20298,20602,7239,27288,6373
888,172121,Vidrà,2011,167,88,79,23,114,30
889,172137,Vidreres,2011,7661,3967,3694,1356,5167,1138
890,252430,Vielha e Mijaran,2011,5601,2908,2693,835,4227,539
891,431652,Vilabella,2011,826,426,400,105,527,194
892,172142,Vilabertran,2011,902,463,439,143,572,187
893,172155,Vilablareix,2011,2401,1186,1215,391,1736,274
894,082994,Vilada,2011,509,257,252,34,330,145
895,172174,Viladamat,2011,458,242,216,50,315,93
896,172168,Viladasens,2011,210,110,100,22,143,45
897,083015,Viladecans,2011,64737,32286,32451,11465,44756,8516
898,083008,Viladecavalls,2011,7376,3692,3684,1406,5242,728
899,172180,Vilademuls,2011,780,397,383,124,483,173
900,172207,Viladrau,2011,1102,558,544,175,746,181
901,172214,Vilafant,2011,5465,2726,2739,938,3821,706
902,083054,Vilafranca del Penedès,2011,38785,19296,19489,6491,26366,5928
903,252445,Vilagrassa,2011,471,242,229,70,301,100
904,172235,Vilajuïga,2011,1166,575,591,204,756,206
905,431750,Vilalba dels Arcs,2011,711,371,340,70,419,222
906,083067,Vilalba Sasserra,2011,670,339,331,123,453,94
907,252458,Vilaller,2011,691,400,291,70,505,116
908,172240,Vilallonga de Ter,2011,476,258,218,64,298,114
909,431665,Vilallonga del Camp,2011,2181,1115,1066,414,1502,265
910,172253,Vilamacolum,2011,299,159,140,41,194,64
911,172266,Vilamalla,2011,1115,593,522,200,762,153
912,172272,Vilamaniscle,2011,171,100,71,30,109,32
913,252477,Vilamòs,2011,189,103,86,26,145,18
914,172288,Vilanant,2011,373,181,192,60,248,65
915,431671,Vilanova d'Escornalbou,2011,568,318,250,87,383,98
916,252483,Vilanova de Bellpuig,2011,1206,626,580,145,734,327
917,252496,Vilanova de l'Aguda,2011,236,120,116,26,132,78
918,252542,Vilanova de la Barca,2011,1185,606,579,163,765,257
919,252509,Vilanova de Meià,2011,422,223,199,39,255,128
920,431687,Vilanova de Prades,2011,133,69,64,15,82,36
921,083036,Vilanova de Sau,2011,335,166,169,38,234,63
922,252516,Vilanova de Segrià,2011,870,457,413,112,598,160
923,083020,Vilanova del Camí,2011,12632,6381,6251,2298,8685,1649
924,089024,Vilanova del Vallès,2011,4975,2534,2441,1124,3343,508
925,083073,Vilanova i la Geltrú,2011,66905,32887,34018,10542,45600,10763
926,431690,Vilaplana,2011,639,323,316,68,432,139
927,431704,Vila-rodona,2011,1279,662,617,202,837,240
928,172305,Vila-sacra,2011,656,321,335,100,446,110
929,252521,Vila-sana,2011,698,351,347,98,463,137
930,431711,Vila-seca,2011,21839,11178,10661,3770,15816,2253
931,082140,Vilassar de Dalt,2011,8794,4330,4464,1417,5956,1421
932,082191,Vilassar de Mar,2011,19840,9583,10257,3390,13298,3152
933,172229,Vilaür,2011,149,72,77,27,79,43
934,431726,Vilaverd,2011,504,249,255,81,318,105
935,431732,"Vilella Alta, la",2011,140,76,64,24,78,38
936,431747,"Vilella Baixa, la",2011,210,116,94,34,124,52
937,172333,Vilobí d'Onyar,2011,3031,1578,1453,542,2016,473
938,083041,Vilobí del Penedès,2011,1103,569,534,190,714,199
939,172327,Vilopriu,2011,212,117,95,30,134,48
940,252537,"Vilosell, el",2011,203,104,99,8,127,68
941,431763,Vimbodí i Poblet,2011,1010,571,439,122,619,269
942,252555,Vinaixa,2011,574,297,277,45,378,151
943,431779,Vinebre,2011,460,227,233,61,290,109
944,431785,Vinyols i els Arcs,2011,1911,984,927,301,1329,281
945,083089,Viver i Serrateix,2011,178,92,86,24,109,45
946,430521,Xerta,2011,1297,639,658,164,808,325
947,000000,Catalunya,2011,7539618,3732196,3807422,1167830,5106329,1265459
0,250019,Abella de la Conca,2012,174,98,76,17,115,42
1,080018,Abrera,2012,11870,6072,5798,2249,8176,1445
2,250024,Àger,2012,593,322,271,49,366,178
3,250030,Agramunt,2012,5633,2873,2760,901,3728,1004
4,080023,Aguilar de Segarra,2012,250,132,118,33,159,58
5,170010,Agullana,2012,858,439,419,131,543,184
6,080142,Aiguafreda,2012,2478,1198,1280,372,1605,501
7,430017,Aiguamúrcia,2012,906,473,433,115,616,175
8,170025,Aiguaviva,2012,774,383,391,165,497,112
9,250387,Aitona,2012,2419,1246,1173,335,1511,573
10,250045,"Alamús, els",2012,751,408,343,84,495,172
11,250058,Alàs i Cerc,2012,376,200,176,47,227,102
12,250061,"Albagés, l'",2012,425,224,201,43,262,120
13,170031,Albanyà,2012,153,85,68,27,108,18
14,250077,Albatàrrec,2012,2113,1101,1012,346,1530,237
15,250083,Albesa,2012,1652,889,763,240,1071,341
16,250096,"Albi, l'",2012,860,448,412,129,513,218
17,430022,Albinyana,2012,2367,1186,1181,380,1536,451
18,430038,"Albiol, l'",2012,459,232,227,91,316,52
19,170046,Albons,2012,714,370,344,117,482,115
20,430043,Alcanar,2012,10658,5520,5138,1442,7200,2016
21,250100,Alcanó,2012,237,115,122,20,143,74
22,250117,Alcarràs,2012,8755,4520,4235,1445,6208,1102
23,250122,Alcoletge,2012,3191,1677,1514,497,2320,374
24,430056,Alcover,2012,5143,2593,2550,894,3430,819
25,439044,"Aldea, l'",2012,4530,2421,2109,649,3025,856
26,430069,Aldover,2012,968,486,482,120,589,259
27,430075,"Aleixar, l'",2012,926,465,461,172,595,159
28,080039,Alella,2012,9610,4716,4894,1593,6538,1479
29,430081,Alfara de Carles,2012,399,213,186,43,244,112
30,250138,Alfarràs,2012,3077,1578,1499,451,1972,654
31,250143,Alfés,2012,342,179,163,38,216,88
32,430094,Alforja,2012,1865,964,901,259,1242,364
33,250156,Algerri,2012,438,229,209,28,250,160
34,250169,Alguaire,2012,3105,1635,1470,456,2071,578
35,250175,Alins,2012,306,159,147,39,184,83
36,430108,Alió,2012,394,196,198,49,261,84
37,250194,Almacelles,2012,6728,3534,3194,967,4503,1258
38,250208,Almatret,2012,354,187,167,15,206,133
39,250215,Almenar,2012,3653,1941,1712,482,2406,765
40,430115,Almoster,2012,1381,689,692,256,964,161
41,250220,Alòs de Balaguer,2012,134,78,56,9,73,52
42,170062,Alp,2012,1745,927,818,250,1295,200
43,080044,Alpens,2012,304,164,140,44,203,57
44,250236,Alpicat,2012,6203,3107,3096,1197,4269,737
45,250241,Alt Àneu,2012,439,246,193,41,316,82
46,430120,Altafulla,2012,4835,2382,2453,859,3325,651
47,170078,Amer,2012,2277,1105,1172,289,1451,537
48,430136,"Ametlla de Mar, l'",2012,7688,3914,3774,1145,4937,1606
49,080057,"Ametlla del Vallès, l'",2012,8190,4119,4071,1620,5641,929
50,439060,"Ampolla, l'",2012,3606,1844,1762,439,2379,788
51,430141,Amposta,2012,21434,10867,10567,3463,14491,3480
52,170084,Anglès,2012,5719,2850,2869,978,3712,1029
53,250273,Anglesola,2012,1385,692,693,204,850,331
54,250292,Arbeca,2012,2493,1287,1206,295,1577,621
55,430167,"Arboç, l'",2012,5486,2845,2641,1024,3660,802
56,430154,Arbolí,2012,113,61,52,6,80,27
57,170097,Arbúcies,2012,6741,3538,3203,1184,4508,1049
58,080060,Arenys de Mar,2012,15030,7400,7630,2201,9959,2870
59,080076,Arenys de Munt,2012,8530,4305,4225,1515,5749,1266
60,170101,Argelaguer,2012,425,223,202,61,281,83
61,080082,Argençola,2012,245,141,104,24,184,37
62,430173,"Argentera, l'",2012,153,88,65,10,109,34
63,080095,Argentona,2012,11914,5888,6026,2167,7939,1808
64,170118,"Armentera, l'",2012,860,426,434,125,546,189
65,430189,Arnes,2012,492,254,238,44,267,181
66,250313,Arres,2012,65,42,23,5,50,10
67,250328,Arsèguel,2012,91,51,40,14,62,15
68,080109,Artés,2012,5566,2802,2764,896,3729,941
69,250334,Artesa de Lleida,2012,1507,796,711,244,949,314
70,250349,Artesa de Segre,2012,3759,1908,1851,571,2438,750
71,430192,Ascó,2012,1680,875,805,160,1151,369
72,250365,Aspa,2012,216,110,106,20,123,73
73,250371,"Avellanes i Santa Linya, les",2012,458,262,196,42,269,147
74,080116,Avià,2012,2259,1120,1139,373,1450,436
75,080121,Avinyó,2012,2328,1162,1166,361,1474,493
76,170123,Avinyonet de Puigventós,2012,1523,764,759,317,1065,141
77,080137,Avinyonet del Penedès,2012,1716,923,793,294,1114,308
78,080155,Badalona,2012,220977,110309,110668,34934,150940,35103
79,089045,Badia del Vallès,2012,13563,6648,6915,2178,9035,2350
80,080168,Bagà,2012,2396,1204,1192,272,1582,542
81,250390,Baix Pallars,2012,362,187,175,46,228,88
82,250404,Balaguer,2012,16952,8659,8293,2842,11286,2824
83,080174,Balenyà,2012,3714,1865,1849,636,2534,544
84,080180,Balsareny,2012,3492,1760,1732,445,2355,692
85,430206,Banyeres del Penedès,2012,3019,1558,1461,591,2015,413
86,170157,Banyoles,2012,19341,9697,9644,3526,12702,3113
87,250411,Barbens,2012,928,492,436,126,566,236
88,430213,Barberà de la Conca,2012,526,288,238,77,336,113
89,082520,Barberà del Vallès,2012,32436,16117,16319,5589,22781,4066
90,080193,Barcelona,2012,1620943,769819,851124,199402,1082771,338770
91,250426,"Baronia de Rialb, la",2012,255,136,119,28,153,74
92,170160,Bàscara,2012,968,498,470,153,591,224
93,250447,Bassella,2012,246,129,117,31,154,61
94,430228,Batea,2012,2136,1097,1039,261,1322,553
95,250450,Bausen,2012,61,36,25,3,29,29
96,080207,Begues,2012,6520,3241,3279,1348,4533,639
97,170139,Begur,2012,4221,2156,2065,594,2851,776
98,250463,Belianes,2012,564,291,273,68,318,178
99,251706,Bellaguarda,2012,335,180,155,32,193,110
100,170182,Bellcaire d'Empordà,2012,661,328,333,105,414,142
101,250479,Bellcaire d'Urgell,2012,1350,684,666,168,826,356
102,250485,Bell-lloc d'Urgell,2012,2420,1194,1226,369,1576,475
103,250498,Bellmunt d'Urgell,2012,196,93,103,22,126,48
104,430234,Bellmunt del Priorat,2012,336,173,163,42,209,85
105,080214,Bellprat,2012,91,53,38,9,57,25
106,250501,Bellpuig,2012,4975,2582,2393,788,3324,863
107,430249,Bellvei,2012,2110,1087,1023,406,1375,329
108,250518,Bellver de Cerdanya,2012,2300,1207,1093,296,1579,425
109,250523,Bellvís,2012,2391,1213,1178,311,1516,564
110,250539,Benavent de Segrià,2012,1540,798,742,305,1040,195
111,430252,Benifallet,2012,771,390,381,58,461,252
112,430265,Benissanet,2012,1280,700,580,151,839,290
113,080229,Berga,2012,16845,8313,8532,2454,10922,3469
114,170195,Besalú,2012,2427,1163,1264,367,1540,520
115,170209,Bescanó,2012,4705,2335,2370,918,3081,706
116,170216,Beuda,2012,170,92,78,24,113,33
117,080235,Bigues i Riells del Fai,2012,8781,4489,4292,1736,5987,1058
118,250557,Biosca,2012,213,115,98,16,134,63
119,170221,"Bisbal d'Empordà, la",2012,10679,5419,5260,1913,7105,1661
120,430271,"Bisbal de Falset, la",2012,227,127,100,24,133,70
121,430287,"Bisbal del Penedès, la",2012,3428,1782,1646,546,2250,632
122,172348,Biure,2012,249,128,121,30,166,53
123,430290,Blancafort,2012,418,214,204,45,266,107
124,170237,Blanes,2012,39785,20036,19749,6228,27178,6379
125,170293,Boadella i les Escaules,2012,256,123,133,33,179,44
126,170242,Bolvir,2012,400,214,186,51,283,66
127,430304,Bonastre,2012,651,346,305,104,455,92
128,250576,"Bòrdes, Es",2012,238,130,108,24,174,40
129,170255,Bordils,2012,1737,877,860,309,1167,261
130,250582,"Borges Blanques, les",2012,6060,3095,2965,886,3951,1223
131,430311,"Borges del Camp, les",2012,2127,1065,1062,400,1360,367
132,170268,Borrassà,2012,714,364,350,128,452,134
133,080240,Borredà,2012,594,321,273,78,366,150
134,250595,Bossòst,2012,1179,591,588,165,841,173
135,430326,Bot,2012,678,353,325,58,385,235
136,430332,Botarell,2012,1126,595,531,212,780,134
137,250560,Bovera,2012,315,166,149,18,169,128
138,430347,Bràfim,2012,670,342,328,92,433,145
139,170274,Breda,2012,3767,1900,1867,551,2471,745
140,080253,"Bruc, el",2012,2029,1090,939,395,1389,245
141,080266,"Brull, el",2012,261,143,118,57,162,42
142,170280,Brunyola i Sant Martí Sapresa,2012,397,195,202,54,248,95
143,430350,Cabacés,2012,342,177,165,39,212,91
144,250609,Cabanabona,2012,100,42,58,9,49,42
145,170314,Cabanelles,2012,244,137,107,30,162,52
146,170307,Cabanes,2012,931,496,435,151,597,183
147,080272,"Cabanyes, les",2012,947,483,464,201,631,115
148,250616,Cabó,2012,94,47,47,4,60,30
149,430363,Cabra del Camp,2012,1165,607,558,215,748,202
150,080288,Cabrera d'Anoia,2012,1376,730,646,231,968,177
151,080291,Cabrera de Mar,2012,4532,2287,2245,785,3126,621
152,080305,Cabrils,2012,7140,3496,3644,1491,4874,775
153,170329,Cadaqués,2012,2935,1440,1495,462,2009,464
154,080312,Calaf,2012,3538,1848,1690,567,2323,648
155,430379,Calafell,2012,24672,12471,12201,3957,16879,3836
156,080348,Calders,2012,955,488,467,161,626,168
157,080327,Caldes d'Estrac,2012,2773,1318,1455,404,1849,520
158,170335,Caldes de Malavella,2012,7071,3515,3556,1247,4748,1076
159,080333,Caldes de Montbui,2012,17271,8635,8636,2930,11674,2667
160,080351,Calella,2012,18529,9153,9376,2852,12359,3318
161,080370,Calldetenes,2012,2441,1250,1191,393,1722,326
162,080386,Callús,2012,1909,942,967,360,1194,355
163,080364,Calonge de Segarra,2012,201,101,100,24,119,58
164,170340,Calonge i Sant Antoni,2012,10851,5431,5420,1652,7317,1882
165,250621,Camarasa,2012,945,483,462,83,599,263
166,439039,Camarles,2012,3609,1844,1765,555,2312,742
167,430385,Cambrils,2012,33535,16680,16855,5875,23235,4425
168,170353,Camós,2012,677,343,334,94,422,161
169,170366,Campdevànol,2012,3469,1710,1759,462,2150,857
170,170372,Campelles,2012,136,66,70,19,91,26
171,080399,Campins,2012,496,251,245,95,347,54
172,170388,Campllong,2012,525,266,259,131,336,58
173,170391,Camprodon,2012,2466,1207,1259,316,1582,568
174,250637,Canejan,2012,109,57,52,8,68,33
175,170405,Canet d'Adri,2012,624,317,307,88,415,121
176,080403,Canet de Mar,2012,14183,6967,7216,2261,9273,2649
177,439076,"Canonja, la",2012,5723,2871,2852,1013,3945,765
178,080410,Canovelles,2012,16090,8381,7709,2980,11070,2040
179,080425,Cànoves i Samalús,2012,2865,1471,1394,489,1930,446
180,170412,Cantallops,2012,333,171,162,43,212,78
181,080431,Canyelles,2012,4275,2175,2100,853,2965,457
182,430398,Capafonts,2012,121,64,57,7,73,41
183,430402,Capçanes,2012,421,210,211,41,270,110
184,080446,Capellades,2012,5439,2701,2738,833,3570,1036
185,170427,Capmany,2012,633,341,292,79,402,152
186,080459,Capolat,2012,90,38,52,18,53,19
187,080462,Cardedeu,2012,17427,8567,8860,3257,11826,2344
188,080478,Cardona,2012,5064,2492,2572,619,3182,1263
189,080484,Carme,2012,866,457,409,124,576,166
190,430419,Caseres,2012,284,139,145,28,172,84
191,170448,Cassà de la Selva,2012,9925,5112,4813,1691,6639,1595
192,080497,Casserres,2012,1578,796,782,157,1011,410
193,080575,Castell de l'Areny,2012,73,43,30,10,52,11
194,259046,Castell de Mur,2012,173,93,80,19,104,50
195,250642,Castellar de la Ribera,2012,159,83,76,25,95,39
196,080522,Castellar de n'Hug,2012,175,96,79,19,120,36
197,080500,Castellar del Riu,2012,174,95,79,30,113,31
198,080517,Castellar del Vallès,2012,23363,11539,11824,4376,15972,3015
199,080538,Castellbell i el Vilar,2012,3641,1870,1771,598,2408,635
200,080543,Castellbisbal,2012,12407,6338,6069,2543,8496,1368
201,080556,Castellcir,2012,668,342,326,128,425,115
202,250674,Castelldans,2012,1028,549,479,114,667,247
203,080569,Castelldefels,2012,62989,31213,31776,11000,44286,7703
204,080581,Castellet i la Gornal,2012,2252,1132,1120,371,1481,400
205,170464,Castellfollit de la Roca,2012,999,509,490,141,620,238
206,080608,Castellfollit de Riubregós,2012,184,100,84,11,123,50
207,080594,Castellfollit del Boix,2012,416,212,204,65,268,83
208,080615,Castellgalí,2012,2001,1044,957,370,1340,291
209,080620,Castellnou de Bages,2012,1184,602,582,250,810,124
210,250680,Castellnou de Seana,2012,766,394,372,105,472,189
211,170470,Castelló d'Empúries,2012,11794,6037,5757,1816,7926,2052
212,250693,Castelló de Farfanya,2012,549,297,252,49,337,163
213,080636,Castellolí,2012,563,271,292,104,372,87
214,170486,Castell-Platja d'Aro,2012,10527,5236,5291,1520,7382,1625
215,250707,Castellserà,2012,1089,561,528,112,656,321
216,080641,Castellterçol,2012,2407,1185,1222,366,1511,530
217,430424,Castellvell del Camp,2012,2845,1419,1426,604,1946,295
218,080654,Castellví de la Marca,2012,1650,831,819,282,1047,321
219,080667,Castellví de Rosanes,2012,1757,868,889,318,1185,254
220,430430,"Catllar, el",2012,4164,2141,2023,726,2969,469
221,250714,Cava,2012,60,33,27,2,39,19
222,171899,"Cellera de Ter, la",2012,2066,1029,1037,324,1316,426
223,170499,Celrà,2012,4914,2443,2471,1050,3400,464
224,080673,Centelles,2012,7282,3553,3729,1194,4776,1312
225,082687,Cercs,2012,1306,660,646,130,809,367
226,082665,Cerdanyola del Vallès,2012,57892,28512,29380,9073,40376,8443
227,080689,Cervelló,2012,8660,4346,4314,1453,6052,1155
228,250729,Cervera,2012,9440,4786,4654,1731,6252,1457
229,250735,Cervià de les Garrigues,2012,746,391,355,82,445,219
230,170502,Cervià de Ter,2012,906,459,447,166,572,168
231,170519,Cistella,2012,281,143,138,36,183,62
232,250740,Ciutadilla,2012,207,115,92,17,130,60
233,250753,Clariana de Cardener,2012,142,74,68,21,98,23
234,250766,"Cogul, el",2012,197,108,89,18,118,61
235,170545,Colera,2012,574,298,276,52,362,160
236,250772,Coll de Nargó,2012,595,303,292,62,391,142
237,080692,Collbató,2012,4287,2216,2071,994,2866,427
238,430458,Colldejou,2012,177,96,81,17,127,33
239,080706,Collsuspina,2012,347,184,163,60,227,60
240,170558,Colomers,2012,205,99,106,25,123,57
241,251636,"Coma i la Pedra, la",2012,274,166,108,28,203,43
242,251615,Conca de Dalt,2012,433,225,208,42,272,119
243,430461,Conesa,2012,130,65,65,9,91,30
244,430477,Constantí,2012,6774,3575,3199,1294,4629,851
245,080713,Copons,2012,324,158,166,61,198,65
246,430483,Corbera d'Ebre,2012,1204,649,555,159,788,257
247,080728,Corbera de Llobregat,2012,14231,7106,7125,2748,9822,1661
248,250788,Corbins,2012,1403,746,657,223,923,257
249,170577,Corçà,2012,1279,623,656,180,839,260
250,080734,Cornellà de Llobregat,2012,87458,43108,44350,13491,57883,16084
251,170561,Cornellà del Terri,2012,2257,1147,1110,360,1463,434
252,430496,Cornudella de Montsant,2012,1025,541,484,121,664,240
253,430509,Creixell,2012,3431,1758,1673,533,2213,685
254,170583,Crespià,2012,266,134,132,41,167,58
255,179011,"Cruïlles, Monells i Sant Sadurní de l'Heura",2012,1253,637,616,179,857,217
256,080749,Cubelles,2012,14375,7294,7081,2528,9861,1986
257,250791,Cubells,2012,409,216,193,44,248,117
258,430516,Cunit,2012,12626,6349,6277,2133,8182,2311
259,170600,Darnius,2012,532,267,265,48,351,133
260,170617,Das,2012,222,126,96,34,146,42
261,439018,Deltebre,2012,12316,6247,6069,1835,8061,2420
262,080752,Dosrius,2012,5176,2637,2539,1020,3599,557
263,430537,Duesaigües,2012,241,138,103,22,161,58
264,170622,"Escala, l'",2012,10508,5370,5138,1413,7045,2050
265,080765,Esparreguera,2012,21856,11160,10696,3864,15000,2992
266,170638,Espinelves,2012,201,98,103,28,123,50
267,250812,"Espluga Calba, l'",2012,399,210,189,44,227,128
268,430542,"Espluga de Francolí, l'",2012,3913,1911,2002,554,2533,826
269,080771,Esplugues de Llobregat,2012,46726,22645,24081,6371,31379,8976
270,170643,Espolla,2012,421,210,211,46,266,109
271,170656,Esponellà,2012,446,222,224,89,262,95
272,250827,Espot,2012,355,192,163,52,244,59
273,080787,"Espunyola, l'",2012,255,131,124,29,154,72
274,082541,"Esquirol, l'",2012,2193,1107,1086,317,1407,469
275,250886,Estamariu,2012,122,71,51,10,68,44
276,080790,"Estany, l'",2012,398,198,200,46,246,106
277,250851,Estaràs,2012,168,91,77,13,108,47
278,250864,Esterri d'Àneu,2012,900,471,429,114,640,146
279,250870,Esterri de Cardós,2012,75,36,39,8,54,13
280,430555,Falset,2012,2894,1461,1433,460,1882,552
281,170059,"Far d'Empordà, el",2012,555,280,275,108,348,99
282,250899,Farrera,2012,140,81,59,23,95,22
283,430568,"Fatarella, la",2012,1089,548,541,111,632,346
284,430574,"Febró, la",2012,49,33,16,1,38,10
285,081347,Figaró-Montmany,2012,1103,558,545,193,705,205
286,080804,Fígols,2012,46,25,21,6,24,16
287,259084,Fígols i Alinyà,2012,278,156,122,26,161,91
288,430580,"Figuera, la",2012,128,71,57,4,87,37
289,170669,Figueres,2012,45262,22529,22733,7778,30906,6578
290,430593,Figuerola del Camp,2012,348,170,178,63,216,69
291,170675,Flaçà,2012,1065,514,551,160,688,217
292,430607,Flix,2012,3961,1983,1978,390,2605,966
293,250925,"Floresta, la",2012,164,92,72,21,96,47
294,080826,Fogars de la Selva,2012,1529,806,723,259,1053,217
295,080811,Fogars de Montclús,2012,442,237,205,83,278,81
296,170681,Foixà,2012,311,162,149,37,184,90
297,080832,Folgueroles,2012,2230,1122,1108,512,1404,314
298,250931,Fondarella,2012,825,418,407,115,581,129
299,080847,Fonollosa,2012,1438,739,699,225,1007,206
300,170694,Fontanals de Cerdanya,2012,472,236,236,40,346,86
301,170708,Fontanilles,2012,156,89,67,23,92,41
302,170715,Fontcoberta,2012,1375,660,715,220,972,183
303,080850,Font-rubí,2012,1437,741,696,233,889,315
304,250946,Foradada,2012,184,103,81,15,115,54
305,179026,Forallac,2012,1721,834,887,246,1164,311
306,430614,Forès,2012,50,28,22,0,32,18
307,170736,Fornells de la Selva,2012,2449,1197,1252,537,1643,269
308,170741,Fortià,2012,679,337,342,111,417,151
309,080863,"Franqueses del Vallès, les",2012,19023,9773,9250,3525,13336,2162
310,430629,Freginals,2012,482,256,226,37,321,124
311,250962,"Fuliola, la",2012,1320,673,647,192,813,315
312,250978,Fulleda,2012,103,51,52,2,65,36
313,080902,Gaià,2012,167,90,77,27,118,22
314,430635,"Galera, la",2012,843,434,409,106,549,188
315,080879,Gallifa,2012,200,104,96,28,143,29
316,430640,Gandesa,2012,3162,1636,1526,421,2087,654
317,430653,Garcia,2012,592,300,292,73,363,156
318,430666,"Garidells, els",2012,193,102,91,19,140,34
319,080885,"Garriga, la",2012,15472,7482,7990,2765,10426,2281
320,170754,Garrigàs,2012,382,202,180,47,251,84
321,170767,Garrigoles,2012,167,93,74,20,104,43
322,170773,Garriguella,2012,874,432,442,144,560,170
323,080898,Gavà,2012,46488,23022,23466,7818,31774,6896
324,250984,Gavet de la Conca,2012,306,153,153,24,167,115
325,080919,Gelida,2012,7102,3553,3549,1347,4760,995
326,170789,Ger,2012,481,258,223,67,326,88
327,259123,Gimenells i el Pla de la Font,2012,1170,596,574,168,720,282
328,430672,Ginestar,2012,937,486,451,110,578,249
329,170792,Girona,2012,97198,46865,50333,16524,67239,13435
330,080924,Gironella,2012,5063,2500,2563,642,3216,1205
331,080930,Gisclareny,2012,31,16,15,0,26,5
332,430688,Godall,2012,812,418,394,86,499,227
333,250997,Golmés,2012,1741,863,878,299,1144,298
334,170806,Gombrèn,2012,209,101,108,34,134,41
335,251001,Gósol,2012,221,126,95,9,156,56
336,080945,"Granada, la",2012,2047,1027,1020,365,1388,294
337,251018,"Granadella, la",2012,750,401,349,78,450,222
338,080958,Granera,2012,83,53,30,6,61,16
339,251023,"Granja d'Escarp, la",2012,986,534,452,100,648,238
340,080961,Granollers,2012,59954,29804,30150,9440,41275,9239
341,251039,Granyanella,2012,143,76,67,11,92,40
342,251057,Granyena de les Garrigues,2012,175,102,73,13,113,49
343,251044,Granyena de Segarra,2012,136,67,69,8,74,54
344,430691,Gratallops,2012,259,136,123,28,169,62
345,080977,Gualba,2012,1359,689,670,276,905,178
346,170813,Gualta,2012,362,195,167,57,234,71
347,080996,Guardiola de Berguedà,2012,998,524,474,115,652,231
348,430705,"Guiamets, els",2012,311,145,166,25,199,87
349,170828,Guils de Cerdanya,2012,558,295,263,71,415,72
350,251095,Guimerà,2012,305,168,137,14,161,130
351,259031,"Guingueta d'Àneu, la",2012,341,176,165,41,228,72
352,251109,Guissona,2012,6763,3602,3161,1337,4825,601
353,251116,Guixers,2012,132,80,52,8,91,33
354,081000,Gurb,2012,2580,1334,1246,490,1739,351
355,430712,Horta de Sant Joan,2012,1280,690,590,151,779,350
356,081017,"Hospitalet de Llobregat, l'",2012,257057,125365,131692,35298,171840,49919
357,081629,"Hostalets de Pierola, els",2012,2897,1498,1399,602,1967,328
358,170834,Hostalric,2012,4018,2042,1976,694,2689,635
359,081022,Igualada,2012,39198,19266,19932,6696,25682,6820
360,251155,Isona i Conca Dellà,2012,1083,576,507,112,641,330
361,170849,Isòvol,2012,327,185,142,25,240,62
362,251137,Ivars d'Urgell,2012,1647,873,774,205,1020,422
363,251121,Ivars de Noguera,2012,361,192,169,34,236,91
364,251142,Ivorra,2012,118,61,57,9,68,41
365,170852,Jafre,2012,425,227,198,55,276,94
366,170865,"Jonquera, la",2012,3203,1637,1566,542,2230,431
367,081038,Jorba,2012,826,414,412,163,531,132
368,259101,Josa i Tuixén,2012,140,79,61,8,99,33
369,170871,Juià,2012,347,194,153,67,221,59
370,251180,Juncosa,2012,458,243,215,43,279,136
371,251193,Juneda,2012,3490,1834,1656,500,2263,727
372,251214,Les,2012,1012,514,498,157,725,130
373,251229,Linyola,2012,2661,1372,1289,409,1710,542
374,081043,"Llacuna, la",2012,928,506,422,112,604,212
375,170887,Lladó,2012,736,366,370,135,478,123
376,251235,Lladorre,2012,239,118,121,28,162,49
377,251240,Lladurs,2012,180,98,82,17,108,55
378,081056,"Llagosta, la",2012,13612,6765,6847,2333,9131,2148
379,170890,Llagostera,2012,8157,4212,3945,1392,5403,1362
380,170904,Llambilles,2012,713,369,344,140,456,117
381,170911,Llanars,2012,534,272,262,59,358,117
382,170926,Llançà,2012,5105,2545,2560,717,3326,1062
383,251253,Llardecans,2012,505,261,244,36,291,178
384,251266,Llavorsí,2012,366,192,174,42,243,81
385,251207,Lleida,2012,139834,69302,70532,22014,95917,21903
386,170932,Llers,2012,1194,606,588,181,776,237
387,251272,Lles de Cerdanya,2012,269,165,104,26,177,66
388,081075,Lliçà d'Amunt,2012,14584,7418,7166,2757,9847,1980
389,081081,Lliçà de Vall,2012,6394,3257,3137,1109,4387,898
390,251288,Llimiana,2012,183,105,78,15,116,52
391,081069,Llinars del Vallès,2012,9477,4688,4789,1607,6429,1441
392,170947,Llívia,2012,1689,923,766,216,1252,221
393,430727,"Lloar, el",2012,116,64,52,14,68,34
394,251291,Llobera,2012,206,109,97,26,129,51
395,430733,Llorac,2012,118,63,55,13,75,30
396,430748,Llorenç del Penedès,2012,2280,1124,1156,415,1458,407
397,170950,Lloret de Mar,2012,40837,21355,19482,6289,30136,4412
398,170963,"Llosses, les",2012,224,131,93,23,161,40
399,081094,Lluçà,2012,259,133,126,44,174,41
400,171024,Maçanet de Cabrenys,2012,739,378,361,83,432,224
401,171030,Maçanet de la Selva,2012,7175,3693,3482,1251,4868,1056
402,170979,Madremanya,2012,266,130,136,45,168,53
403,170985,Maià de Montcal,2012,443,226,217,80,274,89
404,251333,Maials,2012,980,520,460,122,579,279
405,251305,Maldà,2012,239,123,116,21,148,70
406,081108,Malgrat de Mar,2012,18504,9257,9247,2833,12377,3294
407,081115,Malla,2012,269,135,134,35,182,52
408,081120,Manlleu,2012,20416,10180,10236,3822,13280,3314
409,081136,Manresa,2012,76570,37560,39010,12075,49981,14514
410,430764,Marçà,2012,638,333,305,97,392,149
411,430751,Margalef,2012,110,62,48,5,69,36
412,082423,Marganell,2012,308,145,163,41,203,64
413,081141,Martorell,2012,28070,14543,13527,5205,18881,3984
414,081154,Martorelles,2012,4927,2466,2461,710,3350,867
415,430770,Mas de Barberans,2012,636,313,323,65,398,173
416,171002,Masarac,2012,293,160,133,36,196,61
417,430786,Masdenverge,2012,1122,578,544,135,749,238
418,081167,"Masies de Roda, les",2012,760,369,391,110,515,135
419,081173,"Masies de Voltregà, les",2012,3144,1558,1586,554,2093,497
420,430799,Masllorenç,2012,528,287,241,71,337,120
421,081189,"Masnou, el",2012,22550,10836,11714,3395,15373,3782
422,430803,"Masó, la",2012,296,157,139,38,179,79
423,430810,Maspujols,2012,750,394,356,128,495,127
424,081192,Masquefa,2012,8373,4238,4135,1716,5645,1012
425,430825,"Masroig, el",2012,565,296,269,74,337,154
426,251312,Massalcoreig,2012,575,305,270,46,387,142
427,171019,Massanes,2012,711,374,337,111,490,110
428,251327,Massoteres,2012,207,111,96,42,129,36
429,081206,Matadepera,2012,8669,4342,4327,1721,5745,1203
430,081213,Mataró,2012,124084,61859,62225,20416,84483,19185
431,081228,Mediona,2012,2348,1180,1168,405,1463,480
432,251348,Menàrguens,2012,882,482,400,93,573,216
433,170998,Meranges,2012,91,51,40,11,56,24
434,171058,Mieres,2012,333,174,159,44,224,65
435,430831,"Milà, el",2012,174,87,87,26,103,45
436,251351,Miralcamp,2012,1432,735,697,215,941,276
437,430846,Miravet,2012,789,418,371,98,491,200
438,081385,Moià,2012,5793,2931,2862,1050,3817,926
439,430859,"Molar, el",2012,296,163,133,30,177,89
440,081234,Molins de Rei,2012,24805,12067,12738,4393,16694,3718
441,251370,Mollerussa,2012,14729,7533,7196,2720,10168,1841
442,171061,Mollet de Peralada,2012,180,91,89,20,103,57
443,081249,Mollet del Vallès,2012,52242,26069,26173,9151,36021,7070
444,171077,Molló,2012,350,171,179,41,219,90
445,251364,"Molsosa, la",2012,115,56,59,6,76,33
446,081287,Monistrol de Calders,2012,700,357,343,101,463,136
447,081271,Monistrol de Montserrat,2012,2993,1533,1460,427,2016,550
448,171096,Montagut i Oix,2012,978,516,462,141,640,197
449,430862,Montblanc,2012,7356,3712,3644,1093,5011,1252
450,430884,Montbrió del Camp,2012,2515,1276,1239,417,1719,379
451,081252,Montcada i Reixac,2012,34689,17270,17419,6014,23772,4903
452,081304,Montclar,2012,115,55,60,17,69,29
453,251399,Montellà i Martinet,2012,683,364,319,67,472,144
454,081311,Montesquiu,2012,921,463,458,136,593,192
455,251403,Montferrer i Castellbò,2012,1036,566,470,147,750,139
456,430897,Montferri,2012,396,206,190,85,252,59
457,251386,Montgai,2012,701,364,337,68,413,220
458,081265,Montgat,2012,10859,5354,5505,1797,7615,1447
459,081326,Montmajor,2012,473,243,230,53,307,113
460,081332,Montmaneu,2012,187,103,84,19,114,54
461,430901,"Montmell, el",2012,1511,829,682,254,1010,247
462,081350,Montmeló,2012,8830,4364,4466,1477,6027,1326
463,251425,Montoliu de Lleida,2012,511,258,253,61,333,117
464,251410,Montoliu de Segarra,2012,197,116,81,18,121,58
465,251431,Montornès de Segarra,2012,92,45,47,4,54,34
466,081363,Montornès del Vallès,2012,16192,8259,7933,2999,11145,2048
467,430918,Mont-ral,2012,167,97,70,17,123,27
468,171100,Mont-ras,2012,1818,911,907,284,1242,292
469,430923,Mont-roig del Camp,2012,12702,6614,6088,1915,8770,2017
470,081379,Montseny,2012,303,153,150,31,200,72
471,430939,Móra d'Ebre,2012,5704,2816,2888,924,3769,1011
472,430944,Móra la Nova,2012,3285,1682,1603,483,2203,599
473,430957,"Morell, el",2012,3514,1811,1703,621,2462,431
474,430960,"Morera de Montsant, la",2012,167,100,67,20,117,30
475,081290,Muntanyola,2012,600,307,293,122,413,65
476,081398,Mura,2012,227,120,107,36,156,35
477,251459,Nalec,2012,97,50,47,4,59,34
478,250254,Naut Aran,2012,1758,899,859,265,1291,202
479,081402,Navarcles,2012,5973,2926,3047,890,4008,1075
480,081419,Navàs,2012,6145,3050,3095,937,3979,1229
481,171117,Navata,2012,1254,625,629,238,807,209
482,251462,Navès,2012,274,134,140,43,172,59
483,081424,"Nou de Berguedà, la",2012,153,79,74,18,94,41
484,430976,"Nou de Gaià, la",2012,555,272,283,122,323,110
485,430982,Nulles,2012,446,229,217,55,295,96
486,251484,Odèn,2012,268,162,106,16,178,74
487,081430,Òdena,2012,3580,1844,1736,657,2390,533
488,171122,Ogassa,2012,247,147,100,30,169,48
489,081458,Olèrdola,2012,3621,1877,1744,737,2411,473
490,081461,Olesa de Bonesvalls,2012,1755,911,844,311,1194,250
491,081477,Olesa de Montserrat,2012,23980,12069,11911,4488,16149,3343
492,251497,Oliana,2012,1920,947,973,213,1240,467
493,251500,Oliola,2012,219,124,95,17,142,60
494,251517,Olius,2012,881,450,431,189,572,120
495,081483,Olivella,2012,3678,1941,1737,758,2588,332
496,081496,Olost,2012,1188,588,600,140,768,280
497,171143,Olot,2012,33813,16868,16945,5090,22287,6436
498,251522,"Oluges, les",2012,167,92,75,7,99,61
499,081445,Olvan,2012,892,449,443,101,570,221
500,251538,"Omellons, els",2012,243,130,113,19,145,79
501,251543,"Omells de na Gaia, els",2012,151,82,69,13,94,44
502,171156,Ordis,2012,391,209,182,60,260,71
503,251556,Organyà,2012,895,443,452,91,555,249
504,081509,Orís,2012,294,147,147,41,207,46
505,081516,Oristà,2012,566,279,287,51,380,135
506,081521,Orpí,2012,160,88,72,15,116,29
507,081537,Òrrius,2012,651,330,321,112,446,93
508,251569,Os de Balaguer,2012,991,514,477,166,615,210
509,171169,Osor,2012,451,224,227,50,292,109
510,251575,Ossó de Sió,2012,218,109,109,27,135,56
511,081542,Pacs del Penedès,2012,879,444,435,149,603,127
512,081555,Palafolls,2012,9027,4516,4511,1789,6189,1049
513,171175,Palafrugell,2012,22880,11476,11404,3887,15294,3699
514,171181,Palamós,2012,17813,8755,9058,2689,11946,3178
515,251581,"Palau d'Anglesola, el",2012,2185,1084,1101,346,1418,421
516,171194,Palau de Santa Eulàlia,2012,100,60,40,10,73,17
517,171215,Palau-sator,2012,294,158,136,35,189,70
518,171208,Palau-saverdera,2012,1481,738,743,267,911,303
519,081568,Palau-solità i Plegamans,2012,14484,7208,7276,2664,10001,1819
520,431009,"Pallaresos, els",2012,4387,2231,2156,1066,2999,322
521,081574,Pallejà,2012,11255,5683,5572,2185,7612,1458
522,430995,"Palma d'Ebre, la",2012,396,189,207,34,222,140
523,089058,"Palma de Cervelló, la",2012,3023,1525,1498,501,2151,371
524,171236,Palol de Revardit,2012,478,246,232,85,306,87
525,171241,Pals,2012,2793,1414,1379,397,1777,619
526,081580,"Papiol, el",2012,4014,1979,2035,683,2751,580
527,171254,Pardines,2012,154,89,65,20,89,45
528,081593,Parets del Vallès,2012,18492,9348,9144,3268,12935,2289
529,171267,Parlavà,2012,386,203,183,52,254,80
530,431016,Passanant i Belltall,2012,161,86,75,7,106,48
531,171289,Pau,2012,597,299,298,101,373,123
532,431021,Paüls,2012,602,299,303,59,359,184
533,171292,Pedret i Marzà,2012,184,97,87,31,115,38
534,251641,Penelles,2012,524,309,215,50,330,144
535,171306,"Pera, la",2012,428,208,220,58,262,108
536,081607,Perafita,2012,407,207,200,52,255,100
537,431037,Perafort,2012,1264,665,599,260,864,140
538,171328,Peralada,2012,1888,949,939,298,1245,345
539,251654,Peramola,2012,369,187,182,38,226,105
540,431042,"Perelló, el",2012,3378,1794,1584,422,2169,787
541,081614,Piera,2012,15009,7652,7357,2782,9956,2271
542,431055,"Piles, les",2012,214,114,100,29,146,39
543,081635,Pineda de Mar,2012,26066,13087,12979,4037,17478,4551
544,431068,"Pinell de Brai, el",2012,1124,568,556,128,677,319
545,251667,Pinell de Solsonès,2012,210,115,95,20,128,62
546,251673,Pinós,2012,302,165,137,42,190,70
547,431074,Pira,2012,501,259,242,93,317,91
548,431080,"Pla de Santa Maria, el",2012,2375,1251,1124,369,1581,425
549,081640,"Pla del Penedès, el",2012,1198,608,590,204,780,214
550,171334,"Planes d'Hostoles, les",2012,1701,861,840,212,1014,475
551,171349,Planoles,2012,308,167,141,37,206,65
552,259118,"Plans de Sió, els",2012,569,305,264,58,335,176
553,251689,"Poal, el",2012,649,338,311,76,403,170
554,251692,"Pobla de Cérvoles, la",2012,245,135,110,30,145,70
555,081653,"Pobla de Claramunt, la",2012,2258,1137,1121,426,1449,383
556,081666,"Pobla de Lillet, la",2012,1249,619,630,87,806,356
557,431093,"Pobla de Mafumet, la",2012,2948,1526,1422,541,2181,226
558,431107,"Pobla de Massaluca, la",2012,364,192,172,29,208,127
559,431114,"Pobla de Montornès, la",2012,2897,1523,1374,489,1927,481
560,251713,"Pobla de Segur, la",2012,3156,1572,1584,424,1951,781
561,431129,Poboleda,2012,370,202,168,38,237,95
562,081672,Polinyà,2012,8106,4128,3978,1728,5737,641
563,431135,"Pont d'Armentera, el",2012,605,316,289,72,378,155
564,250306,"Pont de Bar, el",2012,184,106,78,24,112,48
565,171352,Pont de Molins,2012,538,274,264,78,365,95
566,251734,"Pont de Suert, el",2012,2516,1289,1227,370,1662,484
567,081825,"Pont de Vilomara i Rocafort, el",2012,3775,1961,1814,666,2511,598
568,431418,Pontils,2012,134,72,62,6,96,32
569,081688,Pontons,2012,531,289,242,82,361,88
570,171365,Pontós,2012,232,128,104,35,141,56
571,251728,Ponts,2012,2698,1361,1337,414,1710,574
572,171371,Porqueres,2012,4491,2230,2261,825,2992,674
573,431140,Porrera,2012,465,256,209,47,301,117
574,171404,"Port de la Selva, el",2012,1011,542,469,122,654,235
575,171387,Portbou,2012,1296,650,646,97,823,376
576,251749,"Portella, la",2012,772,416,356,90,557,125
577,431153,Pradell de la Teixeta,2012,199,87,112,19,132,48
578,431166,Prades,2012,651,333,318,87,411,153
579,431172,Prat de Comte,2012,183,101,82,21,104,58
580,081691,"Prat de Llobregat, el",2012,63162,31233,31929,9818,43122,10222
581,431188,Pratdip,2012,848,450,398,95,487,266
582,081712,Prats de Lluçanès,2012,2659,1319,1340,336,1759,564
583,081705,"Prats de Rei, els",2012,534,286,248,59,355,120
584,251752,Prats i Sansor,2012,296,156,140,36,209,51
585,251765,Preixana,2012,410,211,199,49,224,137
586,251771,Preixens,2012,471,232,239,61,249,161
587,082303,Premià de Dalt,2012,10289,5151,5138,1718,7079,1492
588,081727,Premià de Mar,2012,28145,13819,14326,4485,19189,4471
589,171390,"Preses, les",2012,1752,859,893,315,1134,303
590,251790,Prullans,2012,240,113,127,20,156,64
591,171411,Puigcerdà,2012,8957,4505,4452,1522,6153,1282
592,081748,Puigdàlber,2012,535,266,269,88,364,83
593,251804,Puiggròs,2012,313,166,147,46,197,70
594,431191,Puigpelat,2012,1024,529,495,200,709,115
595,081751,Puig-reig,2012,4301,2107,2194,493,2715,1093
596,251811,Puigverd d'Agramunt,2012,273,158,115,28,177,68
597,251826,Puigverd de Lleida,2012,1442,742,700,246,923,273
598,081764,Pujalt,2012,205,110,95,26,129,50
599,081770,"Quar, la",2012,62,39,23,7,42,13
600,171426,Quart,2012,3255,1660,1595,603,2286,366
601,170433,Queralbs,2012,178,99,79,13,112,53
602,431205,Querol,2012,559,310,249,73,383,103
603,171432,Rabós,2012,206,106,100,24,132,50
604,081786,Rajadell,2012,543,281,262,70,367,106
605,431212,Rasquera,2012,933,474,459,112,561,260
606,171447,Regencós,2012,295,162,133,41,183,71
607,081799,Rellinars,2012,735,383,352,122,512,101
608,431227,Renau,2012,137,71,66,29,96,12
609,431233,Reus,2012,107211,52593,54618,18813,72436,15962
610,251832,Rialp,2012,680,354,326,100,486,94
611,431248,"Riba, la",2012,659,346,313,79,423,157
612,431251,Riba-roja d'Ebre,2012,1316,698,618,102,855,359
613,259059,Ribera d'Ondara,2012,447,229,218,49,280,118
614,251850,Ribera d'Urgellet,2012,997,514,483,147,662,188
615,171450,Ribes de Freser,2012,1914,937,977,196,1174,544
616,171463,Riells i Viabrea,2012,3980,2056,1924,770,2792,418
617,431264,"Riera de Gaià, la",2012,1691,860,831,357,1099,235
618,251863,Riner,2012,294,144,150,38,187,69
619,171479,Ripoll,2012,10904,5379,5525,1420,7109,2375
620,081803,Ripollet,2012,37422,18671,18751,6894,25648,4880
621,259139,Riu de Cerdanya,2012,116,62,54,10,90,16
622,171485,Riudarenes,2012,2180,1115,1065,371,1447,362
623,171498,Riudaura,2012,438,213,225,64,281,93
624,431270,Riudecanyes,2012,1183,606,577,217,751,215
625,431286,Riudecols,2012,1289,662,627,184,876,229
626,171501,Riudellots de la Selva,2012,2037,1040,997,346,1384,307
627,431299,Riudoms,2012,6530,3354,3176,1135,4271,1124
628,171518,Riumors,2012,252,130,122,34,164,54
629,081810,"Roca del Vallès, la",2012,10393,5229,5164,1997,7078,1318
630,431303,Rocafort de Queralt,2012,268,140,128,36,161,71
631,431310,Roda de Berà,2012,6299,3286,3013,1019,4227,1053
632,081831,Roda de Ter,2012,6172,3038,3134,1051,4034,1087
633,431325,Rodonyà,2012,508,269,239,80,320,108
634,431331,Roquetes,2012,8333,4347,3986,1376,5623,1334
635,171523,Roses,2012,19896,9976,9920,3467,13438,2991
636,251898,Rosselló,2012,3103,1590,1513,549,2133,421
637,431346,"Rourell, el",2012,401,204,197,67,267,67
638,081846,Rubí,2012,74484,37120,37364,13026,51727,9731
639,081859,Rubió,2012,227,120,107,29,149,49
640,171539,Rupià,2012,248,124,124,32,166,50
641,089019,Rupit i Pruit,2012,307,159,148,24,211,72
642,081878,Sabadell,2012,207938,101530,106408,33491,138539,35908
643,081884,Sagàs,2012,144,77,67,30,85,29
644,251902,Salàs de Pallars,2012,368,191,177,27,239,102
645,081901,Saldes,2012,313,180,133,22,219,72
646,171544,Sales de Llierca,2012,144,76,68,22,107,15
647,081918,Sallent,2012,6875,3298,3577,934,4298,1643
648,431359,Salomó,2012,540,292,248,91,329,120
649,439057,Salou,2012,26601,14142,12459,4147,19883,2571
650,171557,Salt,2012,30146,16030,14116,6079,20667,3400
651,251919,Sanaüja,2012,458,236,222,65,265,128
652,081944,Sant Adrià de Besòs,2012,34482,16956,17526,5889,22624,5969
653,081957,Sant Agustí de Lluçanès,2012,97,49,48,6,68,23
654,081960,Sant Andreu de la Barca,2012,27306,13779,13527,5416,18688,3202
655,081976,Sant Andreu de Llavaneres,2012,10541,5225,5316,1902,7119,1520
656,171576,Sant Andreu Salou,2012,159,81,78,20,101,38
657,171833,Sant Aniol de Finestres,2012,351,186,165,52,229,70
658,081982,Sant Antoni de Vilamajor,2012,5699,2849,2850,1047,3910,742
659,081995,Sant Bartomeu del Grau,2012,908,471,437,124,649,135
660,082009,Sant Boi de Llobregat,2012,83070,41092,41978,12998,56549,13523
661,082016,Sant Boi de Lluçanès,2012,545,274,271,59,344,142
662,431362,Sant Carles de la Ràpita,2012,15232,7548,7684,2281,9959,2992
663,082037,Sant Cebrià de Vallalta,2012,3337,1741,1596,647,2310,380
664,082021,Sant Celoni,2012,17076,8497,8579,2947,11426,2703
665,082042,Sant Climent de Llobregat,2012,3900,1965,1935,776,2661,463
666,171582,Sant Climent Sescebes,2012,568,322,246,70,365,133
667,082055,Sant Cugat del Vallès,2012,84946,41476,43470,17813,57638,9495
668,082068,Sant Cugat Sesgarrigues,2012,986,499,487,182,618,186
669,251961,Sant Esteve de la Sarga,2012,141,83,58,8,93,40
670,082074,Sant Esteve de Palautordera,2012,2555,1247,1308,548,1700,307
671,082080,Sant Esteve Sesrovires,2012,7510,3765,3745,1400,5087,1023
672,171595,Sant Feliu de Buixalleu,2012,788,413,375,109,543,136
673,082107,Sant Feliu de Codines,2012,6105,3094,3011,1098,4078,929
674,171609,Sant Feliu de Guíxols,2012,21961,10892,11069,3437,14724,3800
675,082114,Sant Feliu de Llobregat,2012,43671,21329,22342,7337,29524,6810
676,171616,Sant Feliu de Pallerols,2012,1360,660,700,230,845,285
677,082129,Sant Feliu Sasserra,2012,660,340,320,93,430,137
678,171621,Sant Ferriol,2012,222,133,89,37,151,34
679,082093,Sant Fost de Campsentelles,2012,8441,4221,4220,1347,5689,1405
680,082135,Sant Fruitós de Bages,2012,8227,4129,4098,1524,5624,1079
681,171637,Sant Gregori,2012,3343,1692,1651,644,2237,462
682,251924,Sant Guim de Freixenet,2012,1104,565,539,156,704,244
683,251977,Sant Guim de la Plana,2012,191,103,88,22,114,55
684,171642,Sant Hilari Sacalm,2012,5753,2945,2808,819,3865,1069
685,082153,Sant Hipòlit de Voltregà,2012,3585,1799,1786,591,2340,654
686,081939,Sant Iscle de Vallalta,2012,1322,686,636,250,880,192
687,439023,Sant Jaume d'Enveja,2012,3549,1812,1737,497,2235,817
688,082166,Sant Jaume de Frontanyà,2012,28,17,11,3,21,4
689,171655,Sant Jaume de Llierca,2012,757,374,383,80,466,211
690,431378,Sant Jaume dels Domenys,2012,2491,1275,1216,446,1649,396
691,171674,Sant Joan de les Abadesses,2012,3469,1723,1746,416,2151,902
692,171680,Sant Joan de Mollet,2012,522,262,260,87,335,100
693,082188,Sant Joan de Vilatorrada,2012,10780,5430,5350,1824,7183,1773
694,082172,Sant Joan Despí,2012,32792,16062,16730,5865,22182,4745
695,171851,Sant Joan les Fonts,2012,2879,1445,1434,362,1879,638
696,171668,Sant Jordi Desvalls,2012,703,343,360,106,455,142
697,089030,Sant Julià de Cerdanyola,2012,257,142,115,34,162,61
698,171693,Sant Julià de Ramis,2012,3467,1734,1733,702,2357,408
699,082205,Sant Julià de Vilatorta,2012,3024,1486,1538,558,2035,431
700,179032,Sant Julià del Llor i Bonmatí,2012,1244,637,607,223,848,173
701,082212,Sant Just Desvern,2012,15874,7547,8327,2561,10579,2734
702,082227,Sant Llorenç d'Hortons,2012,2528,1276,1252,482,1704,342
703,171714,Sant Llorenç de la Muga,2012,248,126,122,37,161,50
704,251930,Sant Llorenç de Morunys,2012,1038,525,513,134,647,257
705,082233,Sant Llorenç Savall,2012,2417,1229,1188,366,1570,481
706,082251,Sant Martí d'Albars,2012,106,54,52,11,65,30
707,082248,Sant Martí de Centelles,2012,1098,562,536,181,767,150
708,171729,Sant Martí de Llémena,2012,596,309,287,102,412,82
709,259025,Sant Martí de Riucorb,2012,695,362,333,76,390,229
710,082264,Sant Martí de Tous,2012,1173,595,578,249,705,219
711,082270,Sant Martí Sarroca,2012,3200,1590,1610,533,2090,577
712,082286,Sant Martí Sesgueioles,2012,373,188,185,56,244,73
713,171735,Sant Martí Vell,2012,266,137,129,55,167,44
714,082299,Sant Mateu de Bages,2012,643,332,311,62,382,199
715,171740,Sant Miquel de Campmajor,2012,230,121,109,29,152,49
716,171753,Sant Miquel de Fluvià,2012,780,396,384,99,541,140
717,171766,Sant Mori,2012,196,101,95,25,140,31
718,171772,Sant Pau de Segúries,2012,675,333,342,77,425,173
719,082310,Sant Pere de Ribes,2012,29149,14690,14459,5213,20334,3602
720,082325,Sant Pere de Riudebitlles,2012,2372,1191,1181,422,1500,450
721,082331,Sant Pere de Torelló,2012,2469,1261,1208,364,1634,471
722,082346,Sant Pere de Vilamajor,2012,4276,2156,2120,882,2842,552
723,171788,Sant Pere Pescador,2012,2161,1166,995,338,1508,315
724,081897,Sant Pere Sallavinera,2012,163,91,72,20,100,43
725,082359,Sant Pol de Mar,2012,5073,2551,2522,822,3389,862
726,082362,Sant Quintí de Mediona,2012,2146,1098,1048,405,1335,406
727,082378,Sant Quirze de Besora,2012,2187,1074,1113,300,1333,554
728,082384,Sant Quirze del Vallès,2012,18994,9322,9672,3783,13261,1950
729,082397,Sant Quirze Safaja,2012,648,338,310,130,456,62
730,251945,Sant Ramon,2012,541,293,248,56,334,151
731,082401,Sant Sadurní d'Anoia,2012,12482,6126,6356,2244,8367,1871
732,082418,Sant Sadurní d'Osormort,2012,93,51,42,8,64,21
733,080983,Sant Salvador de Guardiola,2012,3139,1610,1529,598,2057,484
734,082628,Sant Vicenç de Castellet,2012,9314,4622,4692,1446,6207,1661
735,082649,Sant Vicenç de Montalt,2012,5878,2974,2904,1284,3831,763
736,082652,Sant Vicenç de Torelló,2012,2029,995,1034,336,1308,385
737,082634,Sant Vicenç dels Horts,2012,28084,14043,14041,4887,19224,3973
738,431384,Santa Bàrbara,2012,3898,1985,1913,583,2498,817
739,082439,Santa Cecília de Voltregà,2012,178,95,83,16,124,38
740,082444,Santa Coloma de Cervelló,2012,7964,3917,4047,1783,5289,892
741,171805,Santa Coloma de Farners,2012,12448,6346,6102,2191,8395,1862
742,082457,Santa Coloma de Gramenet,2012,120593,60734,59859,18230,81238,21125
743,431397,Santa Coloma de Queralt,2012,3040,1523,1517,530,1882,628
744,171812,Santa Cristina d'Aro,2012,5106,2598,2508,897,3446,763
745,082460,Santa Eugènia de Berga,2012,2269,1163,1106,327,1606,336
746,082476,Santa Eulàlia de Riuprimer,2012,1199,610,589,211,808,180
747,082482,Santa Eulàlia de Ronçana,2012,7009,3501,3508,1321,4627,1061
748,082495,Santa Fe del Penedès,2012,384,197,187,77,258,49
749,171827,Santa Llogaia d'Àlguema,2012,348,183,165,65,237,46
750,082508,Santa Margarida de Montbui,2012,9689,4849,4840,1707,6509,1473
751,082515,Santa Margarida i els Monjos,2012,7121,3613,3508,1436,4842,843
752,082589,Santa Maria d'Oló,2012,1048,532,516,147,670,231
753,082536,Santa Maria de Besora,2012,157,78,79,17,88,52
754,082567,Santa Maria de Martorelles,2012,865,434,431,144,601,120
755,082554,Santa Maria de Merlès,2012,173,84,89,35,109,29
756,082573,Santa Maria de Miralles,2012,132,66,66,14,88,30
757,082592,Santa Maria de Palautordera,2012,9196,4714,4482,1660,6296,1240
758,431401,Santa Oliva,2012,3322,1710,1612,615,2189,518
759,171848,Santa Pau,2012,1604,803,801,214,1090,300
760,082606,Santa Perpètua de Mogoda,2012,25606,13127,12479,4883,17707,3016
761,082613,Santa Susanna,2012,3338,1700,1638,600,2262,476
762,081923,Santpedor,2012,7187,3592,3595,1278,4848,1061
763,431423,Sarral,2012,1662,854,808,269,1064,329
764,171864,Sarrià de Ter,2012,4790,2380,2410,757,3220,813
765,252017,Sarroca de Bellera,2012,129,77,52,3,86,40
766,252000,Sarroca de Lleida,2012,408,219,189,37,249,122
767,171870,"Saus, Camallera i Llampaies",2012,807,383,424,118,531,158
768,431439,Savallà del Comtat,2012,68,34,34,3,46,19
769,431444,"Secuita, la",2012,1607,823,784,265,1119,223
770,171886,"Selva de Mar, la",2012,203,106,97,17,135,51
771,431457,"Selva del Camp, la",2012,5619,2831,2788,1050,3756,813
772,431460,Senan,2012,61,39,22,9,40,12
773,430445,"Sénia, la",2012,6083,3103,2980,948,4063,1072
774,252022,Senterada,2012,133,77,56,11,102,20
775,250352,"Sentiu de Sió, la",2012,471,236,235,41,306,124
776,082671,Sentmenat,2012,8521,4316,4205,1562,5940,1019
777,171903,Serinyà,2012,1122,576,546,186,747,189
778,252043,Seròs,2012,1907,1041,866,245,1232,430
779,171910,Serra de Daró,2012,208,115,93,32,123,53
780,171925,Setcases,2012,187,103,84,15,124,48
781,252038,"Seu d'Urgell, la",2012,12529,6109,6420,1918,8484,2127
782,082690,Seva,2012,3436,1760,1676,607,2260,569
783,252056,Sidamon,2012,736,371,365,118,494,124
784,171931,Sils,2012,5702,2898,2804,1045,3848,809
785,082704,Sitges,2012,29039,14479,14560,4470,20123,4446
786,170524,Siurana,2012,170,88,82,19,105,46
787,082711,Sobremunt,2012,92,45,47,14,58,20
788,252069,"Soleràs, el",2012,368,195,173,45,199,124
789,431476,Solivella,2012,660,335,325,94,390,176
790,252075,Solsona,2012,9201,4595,4606,1579,6013,1609
791,082726,Sora,2012,180,99,81,21,131,28
792,252081,Soriguera,2012,370,203,167,44,254,72
793,252094,Sort,2012,2322,1174,1148,369,1562,391
794,252108,Soses,2012,1774,917,857,269,1184,321
795,082732,Subirats,2012,3076,1553,1523,521,1981,574
796,252115,Sudanell,2012,887,490,397,99,601,187
797,252120,Sunyer,2012,297,157,140,32,187,78
798,082747,Súria,2012,6218,3009,3209,805,3970,1443
799,171946,Susqueda,2012,105,61,44,10,68,27
800,082763,Tagamanent,2012,322,172,150,58,211,53
801,082779,Talamanca,2012,157,89,68,21,108,28
802,252154,Talarn,2012,564,330,234,54,420,90
803,252167,Talavera,2012,288,161,127,30,172,86
804,171959,"Tallada d'Empordà, la",2012,459,238,221,72,293,94
805,082785,Taradell,2012,6212,3119,3093,1048,4106,1058
806,431482,Tarragona,2012,133954,65700,68254,21896,90916,21142
807,252173,Tàrrega,2012,16731,8380,8351,3051,11236,2444
808,252189,Tarrés,2012,107,61,46,9,73,25
809,252192,Tarroja de Segarra,2012,173,90,83,19,108,46
810,082750,Tavèrnoles,2012,312,156,156,43,217,52
811,082802,Tavertet,2012,137,75,62,12,98,27
812,082819,Teià,2012,6154,3055,3099,973,4180,1001
813,252206,Térmens,2012,1587,800,787,181,1066,340
814,171962,Terrades,2012,311,157,154,51,201,59
815,082798,Terrassa,2012,215678,106776,108902,37674,145462,32542
816,082824,Tiana,2012,8151,3915,4236,1470,5612,1069
817,252213,Tírvia,2012,156,81,75,15,107,34
818,252228,Tiurana,2012,80,37,43,10,44,26
819,431495,Tivenys,2012,914,466,448,97,547,270
820,431508,Tivissa,2012,1818,918,900,214,1138,466
821,082830,Tona,2012,8108,4047,4061,1489,5347,1272
822,252234,Torà,2012,1333,673,660,170,894,269
823,082845,Tordera,2012,16318,8344,7974,2775,11053,2490
824,082858,Torelló,2012,13883,6854,7029,2195,9301,2387
825,252249,"Torms, els",2012,169,92,77,19,90,60
826,252252,Tornabous,2012,925,504,421,116,577,232
827,252271,"Torre de Cabdella, la",2012,755,373,382,49,486,220
828,082861,"Torre de Claramunt, la",2012,3863,2003,1860,752,2641,470
829,431515,"Torre de Fontaubella, la",2012,131,74,57,12,80,39
830,431520,"Torre de l'Espanyol, la",2012,681,351,330,95,416,170
831,252265,Torrebesses,2012,302,159,143,28,180,94
832,431536,Torredembarra,2012,15310,7572,7738,2415,10433,2462
833,252287,Torrefarrera,2012,4341,2185,2156,913,2992,436
834,259078,Torrefeta i Florejacs,2012,617,323,294,66,367,184
835,252304,Torregrossa,2012,2234,1128,1106,287,1408,539
836,252311,Torrelameu,2012,723,410,313,80,489,154
837,082877,Torrelavit,2012,1392,750,642,196,934,262
838,082883,Torrelles de Foix,2012,2406,1252,1154,397,1577,432
839,082896,Torrelles de Llobregat,2012,5740,2854,2886,1195,3959,586
840,171978,Torrent,2012,193,101,92,22,128,43
841,252326,Torres de Segre,2012,2165,1112,1053,263,1451,451
842,252332,Torre-serona,2012,356,183,173,45,220,91
843,171984,Torroella de Fluvià,2012,704,355,349,107,493,104
844,171997,Torroella de Montgrí,2012,11494,5821,5673,1950,7726,1818
845,431541,Torroja del Priorat,2012,172,95,77,15,103,54
846,172001,Tortellà,2012,793,389,404,107,492,194
847,431554,Tortosa,2012,34734,17466,17268,5343,22937,6454
848,172018,Toses,2012,155,90,65,19,102,34
849,172023,Tossa de Mar,2012,5952,3049,2903,815,4115,1022
850,252347,Tremp,2012,6515,3317,3198,902,4225,1388
851,172044,Ullà,2012,1037,572,465,184,713,140
852,082900,Ullastrell,2012,1981,1004,977,442,1297,242
853,172057,Ullastret,2012,287,144,143,57,178,52
854,431567,Ulldecona,2012,7372,3830,3542,1140,4905,1327
855,431573,Ulldemolins,2012,434,250,184,30,254,150
856,172039,Ultramort,2012,208,113,95,28,126,54
857,172060,Urús,2012,201,97,104,22,141,38
858,082917,Vacarisses,2012,6231,3239,2992,1433,4114,684
859,170144,"Vajol, la",2012,93,53,40,8,70,15
860,172076,"Vall d'en Bas, la",2012,2931,1466,1465,466,1887,578
861,172082,"Vall de Bianya, la",2012,1335,680,655,215,889,231
862,250432,"Vall de Boí, la",2012,1052,561,491,107,773,172
863,259010,Vall de Cardós,2012,406,215,191,45,267,94
864,082922,Vallbona d'Anoia,2012,1432,742,690,225,969,238
865,252385,Vallbona de les Monges,2012,253,135,118,17,150,86
866,082938,Vallcebre,2012,274,159,115,24,178,72
867,431589,Vallclara,2012,125,70,55,16,76,33
868,252402,Vallfogona de Balaguer,2012,1853,916,937,280,1280,293
869,171707,Vallfogona de Ripollès,2012,223,121,102,22,145,56
870,431592,Vallfogona de Riucorb,2012,119,66,53,4,72,43
871,082943,Vallgorguina,2012,2640,1363,1277,532,1836,272
872,082956,Vallirana,2012,14549,7257,7292,2790,9764,1995
873,172095,Vall-llobrega,2012,904,459,445,189,626,89
874,431606,Vallmoll,2012,1677,874,803,269,1164,244
875,082969,Vallromanes,2012,2480,1264,1216,568,1651,261
876,431613,Valls,2012,25084,12616,12468,4133,16851,4100
877,259062,"Valls d'Aguilar, les",2012,300,162,138,26,195,79
878,252398,"Valls de Valira, les",2012,948,493,455,90,700,158
879,431628,Vandellòs i l'Hospitalet de l'Infant,2012,5985,2995,2990,968,4064,953
880,259097,"Vansa i Fórnols, la",2012,206,112,94,11,136,59
881,082975,Veciana,2012,169,96,73,24,95,50
882,431634,"Vendrell, el",2012,36647,18368,18279,6379,24853,5415
883,172109,Ventalló,2012,816,422,394,118,539,159
884,252424,Verdú,2012,1008,482,526,118,590,300
885,172116,Verges,2012,1193,585,608,174,752,267
886,431649,Vespella de Gaià,2012,395,215,180,55,274,66
887,082981,Vic,2012,41191,20412,20779,7388,27368,6435
888,172121,Vidrà,2012,163,88,75,23,111,29
889,172137,Vidreres,2012,7732,4017,3715,1380,5215,1137
890,252430,Vielha e Mijaran,2012,5454,2796,2658,794,4095,565
891,431652,Vilabella,2012,829,428,401,106,528,195
892,172142,Vilabertran,2012,911,468,443,138,585,188
893,172155,Vilablareix,2012,2427,1203,1224,401,1741,285
894,082994,Vilada,2012,486,253,233,32,317,137
895,172174,Viladamat,2012,451,237,214,51,295,105
896,172168,Viladasens,2012,208,108,100,26,140,42
897,083015,Viladecans,2012,65188,32420,32768,11713,44697,8778
898,083008,Viladecavalls,2012,7411,3713,3698,1399,5271,741
899,172180,Vilademuls,2012,780,396,384,116,486,178
900,172207,Viladrau,2012,1087,553,534,171,728,188
901,172214,Vilafant,2012,5523,2733,2790,966,3820,737
902,083054,Vilafranca del Penedès,2012,39035,19399,19636,6679,26333,6023
903,252445,Vilagrassa,2012,497,256,241,79,318,100
904,172235,Vilajuïga,2012,1177,577,600,213,752,212
905,431750,Vilalba dels Arcs,2012,717,372,345,73,425,219
906,083067,Vilalba Sasserra,2012,703,350,353,137,462,104
907,252458,Vilaller,2012,667,382,285,76,472,119
908,172240,Vilallonga de Ter,2012,466,253,213,57,291,118
909,431665,Vilallonga del Camp,2012,2204,1123,1081,429,1504,271
910,172253,Vilamacolum,2012,289,153,136,35,187,67
911,172266,Vilamalla,2012,1101,586,515,189,751,161
912,172272,Vilamaniscle,2012,176,102,74,30,114,32
913,252477,Vilamòs,2012,180,104,76,27,137,16
914,172288,Vilanant,2012,376,183,193,66,245,65
915,431671,Vilanova d'Escornalbou,2012,570,311,259,88,379,103
916,252483,Vilanova de Bellpuig,2012,1213,630,583,160,728,325
917,252496,Vilanova de l'Aguda,2012,242,120,122,28,136,78
918,252542,Vilanova de la Barca,2012,1160,583,577,156,751,253
919,252509,Vilanova de Meià,2012,423,223,200,42,252,129
920,431687,Vilanova de Prades,2012,129,67,62,14,79,36
921,083036,Vilanova de Sau,2012,328,163,165,34,228,66
922,252516,Vilanova de Segrià,2012,896,465,431,118,614,164
923,083020,Vilanova del Camí,2012,12585,6367,6218,2326,8576,1683
924,089024,Vilanova del Vallès,2012,5062,2566,2496,1187,3367,508
925,083073,Vilanova i la Geltrú,2012,66591,32522,34069,10591,45003,10997
926,431690,Vilaplana,2012,628,321,307,64,429,135
927,431704,Vila-rodona,2012,1280,662,618,213,831,236
928,172305,Vila-sacra,2012,671,323,348,103,457,111
929,252521,Vila-sana,2012,710,360,350,104,463,143
930,431711,Vila-seca,2012,22052,11269,10783,3887,15814,2351
931,082140,Vilassar de Dalt,2012,8865,4377,4488,1421,5962,1482
932,082191,Vilassar de Mar,2012,19918,9611,10307,3409,13268,3241
933,172229,Vilaür,2012,142,68,74,29,77,36
934,431726,Vilaverd,2012,488,247,241,75,304,109
935,431732,"Vilella Alta, la",2012,143,79,64,24,80,39
936,431747,"Vilella Baixa, la",2012,222,120,102,37,129,56
937,172333,Vilobí d'Onyar,2012,3053,1603,1450,553,2012,488
938,083041,Vilobí del Penedès,2012,1106,563,543,192,712,202
939,172327,Vilopriu,2012,217,118,99,32,138,47
940,252537,"Vilosell, el",2012,197,101,96,8,121,68
941,431763,Vimbodí i Poblet,2012,1007,568,439,124,604,279
942,252555,Vinaixa,2012,572,292,280,51,368,153
943,431779,Vinebre,2012,495,250,245,73,319,103
944,431785,Vinyols i els Arcs,2012,1936,1005,931,317,1333,286
945,083089,Viver i Serrateix,2012,178,93,85,26,109,43
946,430521,Xerta,2012,1277,627,650,155,795,327
947,000000,Catalunya,2012,7570908,3741628,3829280,1183272,5100115,1287521
0,250019,Abella de la Conca,2013,165,90,75,17,106,42
1,080018,Abrera,2013,12055,6152,5903,2308,8220,1527
2,250024,Àger,2013,604,327,277,58,375,171
3,250030,Agramunt,2013,5599,2852,2747,904,3692,1003
4,080023,Aguilar de Segarra,2013,242,128,114,34,153,55
5,170010,Agullana,2013,853,434,419,123,540,190
6,080142,Aiguafreda,2013,2502,1209,1293,368,1623,511
7,430017,Aiguamúrcia,2013,918,486,432,122,606,190
8,170025,Aiguaviva,2013,792,393,399,172,503,117
9,250387,Aitona,2013,2402,1234,1168,352,1475,575
10,250045,"Alamús, els",2013,752,395,357,86,494,172
11,250058,Alàs i Cerc,2013,359,183,176,45,219,95
12,250061,"Albagés, l'",2013,427,224,203,44,260,123
13,170031,Albanyà,2013,164,90,74,35,114,15
14,250077,Albatàrrec,2013,2090,1096,994,324,1523,243
15,250083,Albesa,2013,1636,885,751,229,1067,340
16,250096,"Albi, l'",2013,863,448,415,133,498,232
17,430022,Albinyana,2013,2354,1178,1176,369,1514,471
18,430038,"Albiol, l'",2013,469,238,231,94,322,53
19,170046,Albons,2013,739,387,352,131,485,123
20,430043,Alcanar,2013,10389,5364,5025,1406,6961,2022
21,250100,Alcanó,2013,244,119,125,27,139,78
22,250117,Alcarràs,2013,9026,4691,4335,1530,6376,1120
23,250122,Alcoletge,2013,3224,1697,1527,515,2328,381
24,430056,Alcover,2013,5142,2585,2557,906,3409,827
25,439044,"Aldea, l'",2013,4414,2339,2075,626,2922,866
26,430069,Aldover,2013,973,494,479,120,575,278
27,430075,"Aleixar, l'",2013,884,443,441,155,568,161
28,080039,Alella,2013,9690,4736,4954,1605,6513,1572
29,430081,Alfara de Carles,2013,394,215,179,43,242,109
30,250138,Alfarràs,2013,3001,1541,1460,453,1901,647
31,250143,Alfés,2013,319,164,155,34,197,88
32,430094,Alforja,2013,1857,949,908,247,1243,367
33,250156,Algerri,2013,431,228,203,27,244,160
34,250169,Alguaire,2013,3113,1636,1477,459,2056,598
35,250175,Alins,2013,301,157,144,40,175,86
36,430108,Alió,2013,421,212,209,59,275,87
37,250194,Almacelles,2013,6724,3497,3227,994,4476,1254
38,250208,Almatret,2013,348,183,165,17,205,126
39,250215,Almenar,2013,3612,1925,1687,479,2371,762
40,430115,Almoster,2013,1396,691,705,241,980,175
41,250220,Alòs de Balaguer,2013,133,75,58,12,73,48
42,170062,Alp,2013,1712,908,804,252,1256,204
43,080044,Alpens,2013,304,167,137,46,198,60
44,250236,Alpicat,2013,6267,3120,3147,1211,4289,767
45,250241,Alt Àneu,2013,416,233,183,33,300,83
46,430120,Altafulla,2013,4928,2422,2506,879,3365,684
47,170078,Amer,2013,2283,1099,1184,294,1462,527
48,430136,"Ametlla de Mar, l'",2013,7704,3924,3780,1121,4916,1667
49,080057,"Ametlla del Vallès, l'",2013,8227,4129,4098,1600,5645,982
50,439060,"Ampolla, l'",2013,3636,1854,1782,434,2409,793
51,430141,Amposta,2013,21511,10921,10590,3500,14465,3546
52,170084,Anglès,2013,5662,2818,2844,968,3673,1021
53,250273,Anglesola,2013,1384,683,701,207,845,332
54,250292,Arbeca,2013,2470,1270,1200,294,1547,629
55,430167,"Arboç, l'",2013,5517,2872,2645,1056,3652,809
56,430154,Arbolí,2013,110,62,48,6,79,25
57,170097,Arbúcies,2013,6527,3402,3125,1117,4354,1056
58,080060,Arenys de Mar,2013,15224,7457,7767,2224,10013,2987
59,080076,Arenys de Munt,2013,8588,4357,4231,1543,5725,1320
60,170101,Argelaguer,2013,425,223,202,57,277,91
61,080082,Argençola,2013,215,117,98,25,157,33
62,430173,"Argentera, l'",2013,152,88,64,8,108,36
63,080095,Argentona,2013,11920,5860,6060,2109,7951,1860
64,170118,"Armentera, l'",2013,871,436,435,127,556,188
65,430189,Arnes,2013,479,247,232,44,260,175
66,250313,Arres,2013,61,40,21,5,47,9
67,250328,Arsèguel,2013,84,45,39,15,57,12
68,080109,Artés,2013,5607,2813,2794,895,3780,932
69,250334,Artesa de Lleida,2013,1519,797,722,245,958,316
70,250349,Artesa de Segre,2013,3708,1887,1821,573,2382,753
71,430192,Ascó,2013,1650,859,791,169,1113,368
72,250365,Aspa,2013,212,107,105,18,125,69
73,250371,"Avellanes i Santa Linya, les",2013,474,270,204,50,275,149
74,080116,Avià,2013,2289,1140,1149,377,1469,443
75,080121,Avinyó,2013,2316,1161,1155,368,1449,499
76,170123,Avinyonet de Puigventós,2013,1566,800,766,325,1095,146
77,080137,Avinyonet del Penedès,2013,1705,903,802,307,1083,315
78,080155,Badalona,2013,219708,109305,110403,34970,148752,35986
79,089045,Badia del Vallès,2013,13531,6586,6945,2185,8941,2405
80,080168,Bagà,2013,2299,1146,1153,264,1488,547
81,250390,Baix Pallars,2013,376,195,181,52,236,88
82,250404,Balaguer,2013,16665,8494,8171,2801,11042,2822
83,080174,Balenyà,2013,3728,1874,1854,647,2526,555
84,080180,Balsareny,2013,3474,1747,1727,439,2346,689
85,430206,Banyeres del Penedès,2013,3044,1552,1492,594,2017,433
86,170157,Banyoles,2013,19119,9582,9537,3463,12523,3133
87,250411,Barbens,2013,870,455,415,135,505,230
88,430213,Barberà de la Conca,2013,523,282,241,72,337,114
89,082520,Barberà del Vallès,2013,32580,16153,16427,5676,22660,4244
90,080193,Barcelona,2013,1611822,763701,848121,199278,1071825,340719
91,250426,"Baronia de Rialb, la",2013,257,137,120,25,158,74
92,170160,Bàscara,2013,974,499,475,152,595,227
93,250447,Bassella,2013,249,127,122,32,156,61
94,430228,Batea,2013,1967,985,982,243,1180,544
95,250450,Bausen,2013,52,31,21,2,26,24
96,080207,Begues,2013,6590,3274,3316,1334,4552,704
97,170139,Begur,2013,4148,2093,2055,567,2794,787
98,250463,Belianes,2013,556,286,270,64,321,171
99,251706,Bellaguarda,2013,317,166,151,27,185,105
100,170182,Bellcaire d'Empordà,2013,664,322,342,101,421,142
101,250479,Bellcaire d'Urgell,2013,1315,673,642,176,801,338
102,250485,Bell-lloc d'Urgell,2013,2337,1148,1189,360,1503,474
103,250498,Bellmunt d'Urgell,2013,198,97,101,25,119,54
104,430234,Bellmunt del Priorat,2013,313,163,150,33,196,84
105,080214,Bellprat,2013,89,52,37,7,55,27
106,250501,Bellpuig,2013,5001,2589,2412,797,3341,863
107,430249,Bellvei,2013,2129,1091,1038,415,1376,338
108,250518,Bellver de Cerdanya,2013,2185,1150,1035,307,1458,420
109,250523,Bellvís,2013,2371,1188,1183,316,1479,576
110,250539,Benavent de Segrià,2013,1527,795,732,295,1032,200
111,430252,Benifallet,2013,725,365,360,53,423,249
112,430265,Benissanet,2013,1280,693,587,154,836,290
113,080229,Berga,2013,16609,8174,8435,2429,10735,3445
114,170195,Besalú,2013,2406,1153,1253,368,1511,527
115,170209,Bescanó,2013,4839,2401,2438,973,3147,719
116,170216,Beuda,2013,188,100,88,30,123,35
117,080235,Bigues i Riells del Fai,2013,8747,4472,4275,1699,5945,1103
118,250557,Biosca,2013,202,110,92,13,128,61
119,170221,"Bisbal d'Empordà, la",2013,10793,5452,5341,1944,7181,1668
120,430271,"Bisbal de Falset, la",2013,219,121,98,23,124,72
121,430287,"Bisbal del Penedès, la",2013,3497,1830,1667,553,2295,649
122,172348,Biure,2013,244,130,114,30,159,55
123,430290,Blancafort,2013,414,212,202,46,261,107
124,170237,Blanes,2013,39660,19927,19733,6190,26949,6521
125,170293,Boadella i les Escaules,2013,248,123,125,35,165,48
126,170242,Bolvir,2013,373,200,173,48,252,73
127,430304,Bonastre,2013,654,340,314,111,445,98
128,250576,"Bòrdes, Es",2013,236,133,103,25,169,42
129,170255,Bordils,2013,1742,886,856,306,1170,266
130,250582,"Borges Blanques, les",2013,6103,3122,2981,921,3953,1229
131,430311,"Borges del Camp, les",2013,2114,1056,1058,394,1353,367
132,170268,Borrassà,2013,701,357,344,124,443,134
133,080240,Borredà,2013,580,315,265,67,368,145
134,250595,Bossòst,2013,1187,596,591,179,832,176
135,430326,Bot,2013,668,348,320,63,378,227
136,430332,Botarell,2013,1113,595,518,203,769,141
137,250560,Bovera,2013,291,157,134,14,159,118
138,430347,Bràfim,2013,669,342,327,96,426,147
139,170274,Breda,2013,3755,1883,1872,558,2445,752
140,080253,"Bruc, el",2013,2027,1083,944,399,1376,252
141,080266,"Brull, el",2013,266,142,124,54,172,40
142,170280,Brunyola i Sant Martí Sapresa,2013,393,199,194,55,245,93
143,430350,Cabacés,2013,333,170,163,40,204,89
144,250609,Cabanabona,2013,97,44,53,11,51,35
145,170314,Cabanelles,2013,248,137,111,30,164,54
146,170307,Cabanes,2013,930,494,436,161,581,188
147,080272,"Cabanyes, les",2013,969,497,472,214,636,119
148,250616,Cabó,2013,94,47,47,5,60,29
149,430363,Cabra del Camp,2013,1170,615,555,213,749,208
150,080288,Cabrera d'Anoia,2013,1338,706,632,239,920,179
151,080291,Cabrera de Mar,2013,4529,2272,2257,768,3129,632
152,080305,Cabrils,2013,7181,3529,3652,1483,4874,824
153,170329,Cadaqués,2013,2938,1448,1490,458,2002,478
154,080312,Calaf,2013,3504,1821,1683,578,2279,647
155,430379,Calafell,2013,24563,12321,12242,3969,16589,4005
156,080348,Calders,2013,953,487,466,155,632,166
157,080327,Caldes d'Estrac,2013,2760,1313,1447,393,1824,543
158,170335,Caldes de Malavella,2013,7032,3521,3511,1236,4711,1085
159,080333,Caldes de Montbui,2013,17156,8562,8594,2893,11519,2744
160,080351,Calella,2013,18469,9092,9377,2843,12218,3408
161,080370,Calldetenes,2013,2479,1266,1213,405,1733,341
162,080386,Callús,2013,1896,934,962,347,1185,364
163,080364,Calonge de Segarra,2013,203,102,101,27,114,62
164,170340,Calonge i Sant Antoni,2013,10596,5320,5276,1620,7113,1863
165,250621,Camarasa,2013,941,479,462,89,593,259
166,439039,Camarles,2013,3628,1855,1773,545,2327,756
167,430385,Cambrils,2013,33775,16758,17017,5909,23270,4596
168,170353,Camós,2013,692,354,338,99,434,159
169,170366,Campdevànol,2013,3422,1682,1740,463,2090,869
170,170372,Campelles,2013,137,66,71,17,91,29
171,080399,Campins,2013,544,276,268,107,378,59
172,170388,Campllong,2013,515,255,260,122,332,61
173,170391,Camprodon,2013,2466,1219,1247,334,1568,564
174,250637,Canejan,2013,102,54,48,6,66,30
175,170405,Canet d'Adri,2013,627,321,306,88,418,121
176,080403,Canet de Mar,2013,14124,6893,7231,2280,9164,2680
177,439076,"Canonja, la",2013,5741,2879,2862,1021,3935,785
178,080410,Canovelles,2013,16009,8300,7709,3006,10902,2101
179,080425,Cànoves i Samalús,2013,2877,1473,1404,494,1934,449
180,170412,Cantallops,2013,335,169,166,45,212,78
181,080431,Canyelles,2013,4319,2200,2119,836,2991,492
182,430398,Capafonts,2013,113,58,55,4,71,38
183,430402,Capçanes,2013,415,207,208,41,265,109
184,080446,Capellades,2013,5374,2682,2692,836,3484,1054
185,170427,Capmany,2013,608,316,292,79,375,154
186,080459,Capolat,2013,87,36,51,16,56,15
187,080462,Cardedeu,2013,17533,8645,8888,3299,11779,2455
188,080478,Cardona,2013,5006,2458,2548,618,3116,1272
189,080484,Carme,2013,831,437,394,127,539,165
190,430419,Caseres,2013,273,137,136,23,166,84
191,170448,Cassà de la Selva,2013,9899,5100,4799,1682,6619,1598
192,080497,Casserres,2013,1594,792,802,174,1010,410
193,080575,Castell de l'Areny,2013,72,42,30,8,52,12
194,259046,Castell de Mur,2013,168,89,79,17,99,52
195,250642,Castellar de la Ribera,2013,157,84,73,28,90,39
196,080522,Castellar de n'Hug,2013,166,92,74,18,110,38
197,080500,Castellar del Riu,2013,170,95,75,30,109,31
198,080517,Castellar del Vallès,2013,23455,11556,11899,4404,15885,3166
199,080538,Castellbell i el Vilar,2013,3643,1862,1781,595,2420,628
200,080543,Castellbisbal,2013,12369,6324,6045,2532,8425,1412
201,080556,Castellcir,2013,704,358,346,139,454,111
202,250674,Castelldans,2013,1000,530,470,108,651,241
203,080569,Castelldefels,2013,63077,31251,31826,11045,44049,7983
204,080581,Castellet i la Gornal,2013,2261,1133,1128,358,1479,424
205,170464,Castellfollit de la Roca,2013,1025,525,500,156,625,244
206,080608,Castellfollit de Riubregós,2013,183,100,83,13,122,48
207,080594,Castellfollit del Boix,2013,424,214,210,69,273,82
208,080615,Castellgalí,2013,2023,1049,974,382,1333,308
209,080620,Castellnou de Bages,2013,1216,613,603,261,816,139
210,250680,Castellnou de Seana,2013,776,407,369,106,475,195
211,170470,Castelló d'Empúries,2013,11910,6049,5861,1854,7921,2135
212,250693,Castelló de Farfanya,2013,555,298,257,53,339,163
213,080636,Castellolí,2013,556,269,287,105,361,90
214,170486,Castell-Platja d'Aro,2013,10765,5343,5422,1592,7493,1680
215,250707,Castellserà,2013,1078,544,534,119,655,304
216,080641,Castellterçol,2013,2402,1186,1216,357,1514,531
217,430424,Castellvell del Camp,2013,2840,1417,1423,572,1957,311
218,080654,Castellví de la Marca,2013,1619,817,802,269,1035,315
219,080667,Castellví de Rosanes,2013,1746,860,886,300,1189,257
220,430430,"Catllar, el",2013,4164,2145,2019,727,2954,483
221,250714,Cava,2013,60,34,26,3,38,19
222,171899,"Cellera de Ter, la",2013,2062,1033,1029,312,1321,429
223,170499,Celrà,2013,5028,2507,2521,1093,3462,473
224,080673,Centelles,2013,7346,3601,3745,1233,4768,1345
225,082687,Cercs,2013,1272,642,630,129,775,368
226,082665,Cerdanyola del Vallès,2013,57642,28331,29311,9070,39783,8789
227,080689,Cervelló,2013,8721,4367,4354,1475,6030,1216
228,250729,Cervera,2013,9212,4652,4560,1657,6089,1466
229,250735,Cervià de les Garrigues,2013,726,380,346,71,437,218
230,170502,Cervià de Ter,2013,909,459,450,173,568,168
231,170519,Cistella,2013,292,143,149,46,188,58
232,250740,Ciutadilla,2013,209,114,95,17,130,62
233,250753,Clariana de Cardener,2013,141,73,68,23,95,23
234,250766,"Cogul, el",2013,193,108,85,15,117,61
235,170545,Colera,2013,559,293,266,51,345,163
236,250772,Coll de Nargó,2013,583,292,291,55,382,146
237,080692,Collbató,2013,4367,2249,2118,1008,2917,442
238,430458,Colldejou,2013,173,92,81,16,123,34
239,080706,Collsuspina,2013,338,181,157,62,215,61
240,170558,Colomers,2013,193,94,99,29,113,51
241,251636,"Coma i la Pedra, la",2013,273,163,110,31,203,39
242,251615,Conca de Dalt,2013,446,233,213,49,280,117
243,430461,Conesa,2013,124,63,61,10,87,27
244,430477,Constantí,2013,6748,3538,3210,1296,4586,866
245,080713,Copons,2013,325,160,165,64,198,63
246,430483,Corbera d'Ebre,2013,1130,608,522,133,731,266
247,080728,Corbera de Llobregat,2013,14315,7129,7186,2783,9813,1719
248,250788,Corbins,2013,1401,743,658,224,900,277
249,170577,Corçà,2013,1273,622,651,186,827,260
250,080734,Cornellà de Llobregat,2013,86687,42472,44215,13397,56858,16432
251,170561,Cornellà del Terri,2013,2258,1153,1105,373,1447,438
252,430496,Cornudella de Montsant,2013,983,520,463,106,634,243
253,430509,Creixell,2013,3455,1767,1688,560,2210,685
254,170583,Crespià,2013,256,130,126,42,158,56
255,179011,"Cruïlles, Monells i Sant Sadurní de l'Heura",2013,1273,647,626,190,871,212
256,080749,Cubelles,2013,14528,7341,7187,2647,9811,2070
257,250791,Cubells,2013,419,223,196,40,257,122
258,430516,Cunit,2013,12416,6248,6168,2063,7984,2369
259,170600,Darnius,2013,551,275,276,56,345,150
260,170617,Das,2013,216,120,96,39,136,41
261,439018,Deltebre,2013,12158,6140,6018,1824,7868,2466
262,080752,Dosrius,2013,5185,2632,2553,1017,3575,593
263,430537,Duesaigües,2013,246,140,106,24,160,62
264,170622,"Escala, l'",2013,10513,5345,5168,1422,6946,2145
265,080765,Esparreguera,2013,21926,11136,10790,3887,14940,3099
266,170638,Espinelves,2013,193,94,99,28,116,49
267,250812,"Espluga Calba, l'",2013,401,205,196,45,226,130
268,430542,"Espluga de Francolí, l'",2013,3897,1908,1989,545,2535,817
269,080771,Esplugues de Llobregat,2013,46667,22590,24077,6426,30948,9293
270,170643,Espolla,2013,407,203,204,45,253,109
271,170656,Esponellà,2013,447,226,221,82,274,91
272,250827,Espot,2013,358,196,162,51,247,60
273,080787,"Espunyola, l'",2013,265,134,131,30,161,74
274,082541,"Esquirol, l'",2013,2202,1113,1089,312,1420,470
275,250886,Estamariu,2013,126,74,52,15,67,44
276,080790,"Estany, l'",2013,411,203,208,47,255,109
277,250851,Estaràs,2013,158,85,73,10,100,48
278,250864,Esterri d'Àneu,2013,888,457,431,112,628,148
279,250870,Esterri de Cardós,2013,70,36,34,6,52,12
280,430555,Falset,2013,2883,1460,1423,469,1857,557
281,170059,"Far d'Empordà, el",2013,568,287,281,120,351,97
282,250899,Farrera,2013,124,72,52,18,83,23
283,430568,"Fatarella, la",2013,1056,528,528,104,603,349
284,430574,"Febró, la",2013,48,35,13,1,34,13
285,081347,Figaró-Montmany,2013,1110,563,547,189,717,204
286,080804,Fígols,2013,45,24,21,6,22,17
287,259084,Fígols i Alinyà,2013,267,149,118,27,152,88
288,430580,"Figuera, la",2013,108,59,49,5,70,33
289,170669,Figueres,2013,45123,22386,22737,7837,30653,6633
290,430593,Figuerola del Camp,2013,352,175,177,65,217,70
291,170675,Flaçà,2013,1049,504,545,156,677,216
292,430607,Flix,2013,3929,1961,1968,373,2567,989
293,250925,"Floresta, la",2013,164,89,75,22,95,47
294,080826,Fogars de la Selva,2013,1484,777,707,242,1013,229
295,080811,Fogars de Montclús,2013,473,252,221,92,298,83
296,170681,Foixà,2013,317,160,157,43,188,86
297,080832,Folgueroles,2013,2249,1135,1114,516,1403,330
298,250931,Fondarella,2013,818,412,406,115,572,131
299,080847,Fonollosa,2013,1446,747,699,226,994,226
300,170694,Fontanals de Cerdanya,2013,458,231,227,43,328,87
301,170708,Fontanilles,2013,154,87,67,21,95,38
302,170715,Fontcoberta,2013,1439,699,740,253,991,195
303,080850,Font-rubí,2013,1415,729,686,229,861,325
304,250946,Foradada,2013,185,106,79,13,116,56
305,179026,Forallac,2013,1700,832,868,233,1155,312
306,430614,Forès,2013,49,27,22,0,28,21
307,170736,Fornells de la Selva,2013,2462,1206,1256,530,1645,287
308,170741,Fortià,2013,682,334,348,110,425,147
309,080863,"Franqueses del Vallès, les",2013,19074,9734,9340,3648,13226,2200
310,430629,Freginals,2013,468,253,215,37,307,124
311,250962,"Fuliola, la",2013,1300,663,637,197,791,312
312,250978,Fulleda,2013,105,53,52,3,67,35
313,080902,Gaià,2013,159,89,70,22,117,20
314,430635,"Galera, la",2013,808,414,394,98,519,191
315,080879,Gallifa,2013,200,105,95,21,150,29
316,430640,Gandesa,2013,3117,1604,1513,424,2040,653
317,430653,Garcia,2013,568,288,280,73,343,152
318,430666,"Garidells, els",2013,187,95,92,20,132,35
319,080885,"Garriga, la",2013,15586,7551,8035,2776,10451,2359
320,170754,Garrigàs,2013,409,214,195,54,273,82
321,170767,Garrigoles,2013,157,87,70,17,97,43
322,170773,Garriguella,2013,864,433,431,150,552,162
323,080898,Gavà,2013,46377,22904,23473,7868,31465,7044
324,250984,Gavet de la Conca,2013,300,150,150,24,164,112
325,080919,Gelida,2013,7123,3552,3571,1373,4731,1019
326,170789,Ger,2013,456,244,212,67,303,86
327,259123,Gimenells i el Pla de la Font,2013,1141,584,557,157,702,282
328,430672,Ginestar,2013,902,465,437,101,567,234
329,170792,Girona,2013,97292,46750,50542,16662,66885,13745
330,080924,Gironella,2013,4940,2428,2512,647,3085,1208
331,080930,Gisclareny,2013,29,17,12,0,25,4
332,430688,Godall,2013,713,368,345,64,428,221
333,250997,Golmés,2013,1752,874,878,298,1158,296
334,170806,Gombrèn,2013,199,98,101,35,124,40
335,251001,Gósol,2013,217,127,90,10,151,56
336,080945,"Granada, la",2013,2055,1041,1014,359,1399,297
337,251018,"Granadella, la",2013,750,398,352,82,444,224
338,080958,Granera,2013,76,50,26,4,56,16
339,251023,"Granja d'Escarp, la",2013,988,521,467,96,653,239
340,080961,Granollers,2013,59753,29588,30165,9405,40867,9481
341,251039,Granyanella,2013,142,76,66,11,91,40
342,251057,Granyena de les Garrigues,2013,173,103,70,14,105,54
343,251044,Granyena de Segarra,2013,127,60,67,7,64,56
344,430691,Gratallops,2013,250,134,116,23,170,57
345,080977,Gualba,2013,1394,707,687,287,918,189
346,170813,Gualta,2013,368,199,169,59,241,68
347,080996,Guardiola de Berguedà,2013,978,529,449,117,638,223
348,430705,"Guiamets, els",2013,297,140,157,23,192,82
349,170828,Guils de Cerdanya,2013,564,300,264,75,409,80
350,251095,Guimerà,2013,296,161,135,15,156,125
351,259031,"Guingueta d'Àneu, la",2013,326,168,158,40,217,69
352,251109,Guissona,2013,6796,3622,3174,1347,4834,615
353,251116,Guixers,2013,130,78,52,8,89,33
354,081000,Gurb,2013,2570,1338,1232,464,1743,363
355,430712,Horta de Sant Joan,2013,1259,667,592,150,753,356
356,081017,"Hospitalet de Llobregat, l'",2013,254056,123674,130382,35178,168564,50314
357,081629,"Hostalets de Pierola, els",2013,2935,1513,1422,609,1989,337
358,170834,Hostalric,2013,3980,2022,1958,686,2659,635
359,081022,Igualada,2013,38978,19112,19866,6641,25414,6923
360,251155,Isona i Conca Dellà,2013,1053,560,493,107,629,317
361,170849,Isòvol,2013,318,180,138,25,238,55
362,251137,Ivars d'Urgell,2013,1619,853,766,198,994,427
363,251121,Ivars de Noguera,2013,365,190,175,39,232,94
364,251142,Ivorra,2013,119,63,56,8,70,41
365,170852,Jafre,2013,407,221,186,47,266,94
366,170865,"Jonquera, la",2013,3135,1592,1543,539,2162,434
367,081038,Jorba,2013,849,424,425,162,559,128
368,259101,Josa i Tuixén,2013,141,80,61,10,97,34
369,170871,Juià,2013,353,190,163,73,222,58
370,251180,Juncosa,2013,443,239,204,35,274,134
371,251193,Juneda,2013,3481,1820,1661,513,2233,735
372,251214,Les,2013,986,493,493,154,712,120
373,251229,Linyola,2013,2654,1350,1304,405,1717,532
374,081043,"Llacuna, la",2013,934,503,431,120,598,216
375,170887,Lladó,2013,755,374,381,153,475,127
376,251235,Lladorre,2013,238,116,122,32,158,48
377,251240,Lladurs,2013,187,103,84,17,114,56
378,081056,"Llagosta, la",2013,13447,6668,6779,2329,8899,2219
379,170890,Llagostera,2013,8200,4240,3960,1432,5411,1357
380,170904,Llambilles,2013,732,375,357,154,466,112
381,170911,Llanars,2013,506,260,246,49,342,115
382,170926,Llançà,2013,5018,2480,2538,715,3235,1068
383,251253,Llardecans,2013,497,255,242,35,285,177
384,251266,Llavorsí,2013,361,186,175,41,236,84
385,251207,Lleida,2013,139809,69294,70515,22092,95448,22269
386,170932,Llers,2013,1229,621,608,199,795,235
387,251272,Lles de Cerdanya,2013,266,159,107,29,168,69
388,081075,Lliçà d'Amunt,2013,14659,7459,7200,2699,9882,2078
389,081081,Lliçà de Vall,2013,6426,3261,3165,1107,4391,928
390,251288,Llimiana,2013,162,94,68,11,100,51
391,081069,Llinars del Vallès,2013,9554,4726,4828,1623,6466,1465
392,170947,Llívia,2013,1625,888,737,213,1178,234
393,430727,"Lloar, el",2013,113,61,52,13,68,32
394,251291,Llobera,2013,210,112,98,25,135,50
395,430733,Llorac,2013,113,60,53,11,75,27
396,430748,Llorenç del Penedès,2013,2304,1126,1178,423,1471,410
397,170950,Lloret de Mar,2013,40803,21255,19548,6254,29892,4657
398,170963,"Llosses, les",2013,214,127,87,22,157,35
399,081094,Lluçà,2013,242,120,122,42,158,42
400,171024,Maçanet de Cabrenys,2013,745,383,362,89,440,216
401,171030,Maçanet de la Selva,2013,7202,3675,3527,1225,4883,1094
402,170979,Madremanya,2013,279,134,145,48,177,54
403,170985,Maià de Montcal,2013,453,230,223,81,285,87
404,251333,Maials,2013,958,498,460,108,560,290
405,251305,Maldà,2013,233,119,114,21,144,68
406,081108,Malgrat de Mar,2013,18429,9265,9164,2803,12283,3343
407,081115,Malla,2013,262,130,132,32,176,54
408,081120,Manlleu,2013,20435,10195,10240,3796,13283,3356
409,081136,Manresa,2013,76170,37289,38881,12079,49503,14588
410,430764,Marçà,2013,616,320,296,87,383,146
411,430751,Margalef,2013,110,63,47,7,68,35
412,082423,Marganell,2013,309,148,161,40,206,63
413,081141,Martorell,2013,28108,14523,13585,5274,18724,4110
414,081154,Martorelles,2013,4882,2440,2442,706,3282,894
415,430770,Mas de Barberans,2013,637,311,326,66,398,173
416,171002,Masarac,2013,296,160,136,36,197,63
417,430786,Masdenverge,2013,1140,596,544,136,766,238
418,081167,"Masies de Roda, les",2013,744,361,383,107,506,131
419,081173,"Masies de Voltregà, les",2013,3171,1559,1612,553,2113,505
420,430799,Masllorenç,2013,534,288,246,83,330,121
421,081189,"Masnou, el",2013,22595,10848,11747,3353,15364,3878
422,430803,"Masó, la",2013,291,154,137,37,171,83
423,430810,Maspujols,2013,772,404,368,139,511,122
424,081192,Masquefa,2013,8429,4275,4154,1711,5684,1034
425,430825,"Masroig, el",2013,564,300,264,74,339,151
426,251312,Massalcoreig,2013,565,299,266,45,386,134
427,171019,Massanes,2013,708,380,328,116,479,113
428,251327,Massoteres,2013,204,113,91,44,127,33
429,081206,Matadepera,2013,8784,4395,4389,1732,5806,1246
430,081213,Mataró,2013,124099,61885,62214,20619,83856,19624
431,081228,Mediona,2013,2353,1182,1171,416,1475,462
432,251348,Menàrguens,2013,885,481,404,98,574,213
433,170998,Meranges,2013,100,56,44,14,61,25
434,171058,Mieres,2013,337,173,164,46,225,66
435,430831,"Milà, el",2013,169,84,85,24,102,43
436,251351,Miralcamp,2013,1408,711,697,222,918,268
437,430846,Miravet,2013,778,416,362,101,485,192
438,081385,Moià,2013,5766,2920,2846,1046,3780,940
439,430859,"Molar, el",2013,298,161,137,29,183,86
440,081234,Molins de Rei,2013,24878,12096,12782,4459,16634,3785
441,251370,Mollerussa,2013,14959,7632,7327,2815,10242,1902
442,171061,Mollet de Peralada,2013,174,91,83,21,96,57
443,081249,Mollet del Vallès,2013,51954,25825,26129,9150,35485,7319
444,171077,Molló,2013,356,171,185,45,222,89
445,251364,"Molsosa, la",2013,104,52,52,8,64,32
446,081287,Monistrol de Calders,2013,686,352,334,98,452,136
447,081271,Monistrol de Montserrat,2013,2993,1524,1469,455,1977,561
448,171096,Montagut i Oix,2013,957,506,451,135,628,194
449,430862,Montblanc,2013,7409,3732,3677,1141,5016,1252
450,430884,Montbrió del Camp,2013,2633,1337,1296,422,1801,410
451,081252,Montcada i Reixac,2013,34863,17293,17570,6092,23770,5001
452,081304,Montclar,2013,120,60,60,21,68,31
453,251399,Montellà i Martinet,2013,647,350,297,52,456,139
454,081311,Montesquiu,2013,912,462,450,138,578,196
455,251403,Montferrer i Castellbò,2013,1022,554,468,151,725,146
456,430897,Montferri,2013,372,203,169,75,235,62
457,251386,Montgai,2013,688,354,334,64,405,219
458,081265,Montgat,2013,11055,5458,5597,1871,7682,1502
459,081326,Montmajor,2013,463,238,225,50,301,112
460,081332,Montmaneu,2013,169,91,78,18,100,51
461,430901,"Montmell, el",2013,1474,801,673,240,983,251
462,081350,Montmeló,2013,8860,4360,4500,1467,6004,1389
463,251425,Montoliu de Lleida,2013,504,256,248,61,322,121
464,251410,Montoliu de Segarra,2013,196,116,80,19,123,54
465,251431,Montornès de Segarra,2013,102,51,51,9,57,36
466,081363,Montornès del Vallès,2013,16150,8227,7923,3050,10984,2116
467,430918,Mont-ral,2013,170,96,74,21,122,27
468,171100,Mont-ras,2013,1785,892,893,270,1220,295
469,430923,Mont-roig del Camp,2013,12906,6760,6146,1975,8807,2124
470,081379,Montseny,2013,320,164,156,44,202,74
471,430939,Móra d'Ebre,2013,5608,2764,2844,905,3685,1018
472,430944,Móra la Nova,2013,3277,1672,1605,485,2189,603
473,430957,"Morell, el",2013,3485,1807,1678,627,2407,451
474,430960,"Morera de Montsant, la",2013,158,95,63,18,110,30
475,081290,Muntanyola,2013,585,301,284,120,395,70
476,081398,Mura,2013,205,112,93,28,142,35
477,251459,Nalec,2013,105,55,50,4,62,39
478,250254,Naut Aran,2013,1780,899,881,261,1316,203
479,081402,Navarcles,2013,5973,2920,3053,877,4006,1090
480,081419,Navàs,2013,6146,3058,3088,954,3978,1214
481,171117,Navata,2013,1258,624,634,226,811,221
482,251462,Navès,2013,267,133,134,42,169,56
483,081424,"Nou de Berguedà, la",2013,150,76,74,17,93,40
484,430976,"Nou de Gaià, la",2013,559,280,279,118,328,113
485,430982,Nulles,2013,457,233,224,65,292,100
486,251484,Odèn,2013,269,161,108,13,178,78
487,081430,Òdena,2013,3629,1859,1770,714,2370,545
488,171122,Ogassa,2013,248,146,102,33,162,53
489,081458,Olèrdola,2013,3626,1879,1747,733,2398,495
490,081461,Olesa de Bonesvalls,2013,1720,892,828,320,1150,250
491,081477,Olesa de Montserrat,2013,23742,11931,11811,4473,15867,3402
492,251497,Oliana,2013,1903,932,971,215,1220,468
493,251500,Oliola,2013,230,127,103,23,145,62
494,251517,Olius,2013,903,460,443,199,581,123
495,081483,Olivella,2013,3617,1902,1715,772,2496,349
496,081496,Olost,2013,1184,593,591,135,771,278
497,171143,Olot,2013,33981,16932,17049,5155,22350,6476
498,251522,"Oluges, les",2013,162,86,76,9,91,62
499,081445,Olvan,2013,889,443,446,103,565,221
500,251538,"Omellons, els",2013,234,125,109,17,140,77
501,251543,"Omells de na Gaia, els",2013,143,76,67,13,84,46
502,171156,Ordis,2013,363,194,169,54,232,77
503,251556,Organyà,2013,875,439,436,87,543,245
504,081509,Orís,2013,284,144,140,41,201,42
505,081516,Oristà,2013,555,277,278,50,375,130
506,081521,Orpí,2013,135,76,59,13,93,29
507,081537,Òrrius,2013,662,338,324,117,449,96
508,251569,Os de Balaguer,2013,1015,517,498,182,628,205
509,171169,Osor,2013,456,229,227,56,293,107
510,251575,Ossó de Sió,2013,210,104,106,27,126,57
511,081542,Pacs del Penedès,2013,892,446,446,151,608,133
512,081555,Palafolls,2013,9081,4536,4545,1784,6212,1085
513,171175,Palafrugell,2013,22942,11507,11435,3914,15288,3740
514,171181,Palamós,2013,17830,8722,9108,2681,11934,3215
515,251581,"Palau d'Anglesola, el",2013,2185,1088,1097,356,1411,418
516,171194,Palau de Santa Eulàlia,2013,101,58,43,11,72,18
517,171215,Palau-sator,2013,306,161,145,41,198,67
518,171208,Palau-saverdera,2013,1461,735,726,271,892,298
519,081568,Palau-solità i Plegamans,2013,14454,7182,7272,2630,9948,1876
520,431009,"Pallaresos, els",2013,4450,2252,2198,1085,3019,346
521,081574,Pallejà,2013,11208,5624,5584,2183,7541,1484
522,430995,"Palma d'Ebre, la",2013,379,176,203,28,216,135
523,089058,"Palma de Cervelló, la",2013,2991,1504,1487,501,2116,374
524,171236,Palol de Revardit,2013,476,242,234,82,307,87
525,171241,Pals,2013,2740,1382,1358,381,1733,626
526,081580,"Papiol, el",2013,4041,2010,2031,685,2771,585
527,171254,Pardines,2013,158,92,66,21,94,43
528,081593,Parets del Vallès,2013,18580,9331,9249,3304,12909,2367
529,171267,Parlavà,2013,404,208,196,62,261,81
530,431016,Passanant i Belltall,2013,149,80,69,3,99,47
531,171289,Pau,2013,586,291,295,97,354,135
532,431021,Paüls,2013,594,292,302,61,351,182
533,171292,Pedret i Marzà,2013,190,100,90,33,117,40
534,251641,Penelles,2013,511,302,209,50,318,143
535,171306,"Pera, la",2013,443,214,229,64,266,113
536,081607,Perafita,2013,422,215,207,53,263,106
537,431037,Perafort,2013,1278,670,608,281,859,138
538,171328,Peralada,2013,1920,964,956,303,1262,355
539,251654,Peramola,2013,361,181,180,39,226,96
540,431042,"Perelló, el",2013,2862,1484,1378,352,1781,729
541,081614,Piera,2013,15057,7674,7383,2802,9924,2331
542,431055,"Piles, les",2013,211,111,100,31,144,36
543,081635,Pineda de Mar,2013,26157,13114,13043,4065,17367,4725
544,431068,"Pinell de Brai, el",2013,1113,570,543,127,675,311
545,251667,Pinell de Solsonès,2013,211,117,94,22,128,61
546,251673,Pinós,2013,296,162,134,43,183,70
547,431074,Pira,2013,491,256,235,90,307,94
548,431080,"Pla de Santa Maria, el",2013,2341,1234,1107,356,1558,427
549,081640,"Pla del Penedès, el",2013,1195,601,594,216,776,203
550,171334,"Planes d'Hostoles, les",2013,1686,867,819,212,999,475
551,171349,Planoles,2013,302,165,137,32,202,68
552,259118,"Plans de Sió, els",2013,545,290,255,63,308,174
553,251689,"Poal, el",2013,648,339,309,74,403,171
554,251692,"Pobla de Cérvoles, la",2013,234,129,105,28,140,66
555,081653,"Pobla de Claramunt, la",2013,2219,1114,1105,417,1428,374
556,081666,"Pobla de Lillet, la",2013,1192,591,601,83,753,356
557,431093,"Pobla de Mafumet, la",2013,3210,1656,1554,639,2338,233
558,431107,"Pobla de Massaluca, la",2013,372,196,176,36,203,133
559,431114,"Pobla de Montornès, la",2013,2904,1515,1389,512,1891,501
560,251713,"Pobla de Segur, la",2013,3073,1520,1553,422,1889,762
561,431129,Poboleda,2013,362,197,165,38,228,96
562,081672,Polinyà,2013,8158,4166,3992,1768,5712,678
563,431135,"Pont d'Armentera, el",2013,588,308,280,67,370,151
564,250306,"Pont de Bar, el",2013,176,102,74,21,104,51
565,171352,Pont de Molins,2013,540,275,265,77,363,100
566,251734,"Pont de Suert, el",2013,2441,1241,1200,343,1619,479
567,081825,"Pont de Vilomara i Rocafort, el",2013,3769,1965,1804,656,2516,597
568,431418,Pontils,2013,123,67,56,6,87,30
569,081688,Pontons,2013,504,271,233,69,347,88
570,171365,Pontós,2013,222,126,96,31,137,54
571,251728,Ponts,2013,2690,1339,1351,412,1692,586
572,171371,Porqueres,2013,4509,2232,2277,818,2998,693
573,431140,Porrera,2013,469,260,209,37,317,115
574,171404,"Port de la Selva, el",2013,990,525,465,111,635,244
575,171387,Portbou,2013,1280,643,637,96,800,384
576,251749,"Portella, la",2013,767,420,347,89,545,133
577,431153,Pradell de la Teixeta,2013,191,83,108,17,128,46
578,431166,Prades,2013,660,338,322,96,409,155
579,431172,Prat de Comte,2013,170,92,78,16,99,55
580,081691,"Prat de Llobregat, el",2013,63419,31310,32109,9943,42953,10523
581,431188,Pratdip,2013,700,374,326,85,407,208
582,081712,Prats de Lluçanès,2013,2679,1335,1344,346,1759,574
583,081705,"Prats de Rei, els",2013,551,292,259,66,366,119
584,251752,Prats i Sansor,2013,281,145,136,34,194,53
585,251765,Preixana,2013,410,207,203,48,224,138
586,251771,Preixens,2013,464,232,232,53,251,160
587,082303,Premià de Dalt,2013,10319,5172,5147,1718,7069,1532
588,081727,Premià de Mar,2013,28136,13834,14302,4437,19016,4683
589,171390,"Preses, les",2013,1779,871,908,319,1155,305
590,251790,Prullans,2013,219,108,111,21,138,60
591,171411,Puigcerdà,2013,8910,4476,4434,1476,6126,1308
592,081748,Puigdàlber,2013,533,266,267,84,360,89
593,251804,Puiggròs,2013,302,163,139,47,182,73
594,431191,Puigpelat,2013,1081,559,522,229,737,115
595,081751,Puig-reig,2013,4264,2076,2188,500,2643,1121
596,251811,Puigverd d'Agramunt,2013,269,153,116,29,174,66
597,251826,Puigverd de Lleida,2013,1440,737,703,246,917,277
598,081764,Pujalt,2013,198,106,92,26,122,50
599,081770,"Quar, la",2013,61,36,25,6,41,14
600,171426,Quart,2013,3358,1695,1663,650,2322,386
601,170433,Queralbs,2013,185,105,80,10,119,56
602,431205,Querol,2013,543,301,242,69,370,104
603,171432,Rabós,2013,185,88,97,26,112,47
604,081786,Rajadell,2013,537,277,260,68,363,106
605,431212,Rasquera,2013,827,417,410,92,485,250
606,171447,Regencós,2013,289,156,133,42,177,70
607,081799,Rellinars,2013,747,386,361,128,525,94
608,431227,Renau,2013,137,69,68,31,93,13
609,431233,Reus,2013,106790,52211,54579,18839,71689,16262
610,251832,Rialp,2013,670,348,322,94,477,99
611,431248,"Riba, la",2013,621,327,294,75,391,155
612,431251,Riba-roja d'Ebre,2013,1301,696,605,108,844,349
613,259059,Ribera d'Ondara,2013,421,216,205,46,265,110
614,251850,Ribera d'Urgellet,2013,955,493,462,148,626,181
615,171450,Ribes de Freser,2013,1891,938,953,196,1152,543
616,171463,Riells i Viabrea,2013,3954,2042,1912,759,2758,437
617,431264,"Riera de Gaià, la",2013,1635,825,810,345,1045,245
618,251863,Riner,2013,285,135,150,41,176,68
619,171479,Ripoll,2013,10798,5323,5475,1435,6998,2365
620,081803,Ripollet,2013,37234,18506,18728,6899,25360,4975
621,259139,Riu de Cerdanya,2013,117,63,54,11,89,17
622,171485,Riudarenes,2013,2175,1117,1058,364,1442,369
623,171498,Riudaura,2013,452,220,232,67,296,89
624,431270,Riudecanyes,2013,1170,607,563,206,745,219
625,431286,Riudecols,2013,1293,667,626,187,870,236
626,171501,Riudellots de la Selva,2013,2051,1048,1003,350,1394,307
627,431299,Riudoms,2013,6472,3320,3152,1132,4193,1147
628,171518,Riumors,2013,243,125,118,34,156,53
629,081810,"Roca del Vallès, la",2013,10396,5220,5176,2017,7015,1364
630,431303,Rocafort de Queralt,2013,267,139,128,34,162,71
631,431310,Roda de Berà,2013,6394,3305,3089,1037,4214,1143
632,081831,Roda de Ter,2013,6133,3003,3130,1029,4004,1100
633,431325,Rodonyà,2013,488,253,235,72,313,103
634,431331,Roquetes,2013,8297,4319,3978,1357,5598,1342
635,171523,Roses,2013,19891,9961,9930,3480,13312,3099
636,251898,Rosselló,2013,3084,1578,1506,531,2135,418
637,431346,"Rourell, el",2013,400,206,194,69,265,66
638,081846,Rubí,2013,74468,37016,37452,13086,51421,9961
639,081859,Rubió,2013,212,116,96,24,140,48
640,171539,Rupià,2013,241,121,120,33,154,54
641,089019,Rupit i Pruit,2013,295,151,144,23,198,74
642,081878,Sabadell,2013,207649,101101,106548,33749,137520,36380
643,081884,Sagàs,2013,155,81,74,35,92,28
644,251902,Salàs de Pallars,2013,369,192,177,36,236,97
645,081901,Saldes,2013,298,169,129,17,211,70
646,171544,Sales de Llierca,2013,140,74,66,21,102,17
647,081918,Sallent,2013,6809,3281,3528,933,4231,1645
648,431359,Salomó,2013,515,277,238,87,307,121
649,439057,Salou,2013,26752,14150,12602,4195,19878,2679
650,171557,Salt,2013,30247,16064,14183,6161,20651,3435
651,251919,Sanaüja,2013,444,230,214,54,263,127
652,081944,Sant Adrià de Besòs,2013,34822,17115,17707,5974,22823,6025
653,081957,Sant Agustí de Lluçanès,2013,92,47,45,5,66,21
654,081960,Sant Andreu de la Barca,2013,27329,13734,13595,5448,18497,3384
655,081976,Sant Andreu de Llavaneres,2013,10558,5218,5340,1917,7090,1551
656,171576,Sant Andreu Salou,2013,154,78,76,17,101,36
657,171833,Sant Aniol de Finestres,2013,355,188,167,56,230,69
658,081982,Sant Antoni de Vilamajor,2013,5717,2865,2852,1018,3941,758
659,081995,Sant Bartomeu del Grau,2013,888,454,434,127,626,135
660,082009,Sant Boi de Llobregat,2013,83408,41257,42151,13133,56373,13902
661,082016,Sant Boi de Lluçanès,2013,552,274,278,62,347,143
662,431362,Sant Carles de la Ràpita,2013,15245,7586,7659,2288,9927,3030
663,082037,Sant Cebrià de Vallalta,2013,3368,1751,1617,663,2308,397
664,082021,Sant Celoni,2013,17286,8588,8698,3030,11487,2769
665,082042,Sant Climent de Llobregat,2013,3920,1974,1946,787,2658,475
666,171582,Sant Climent Sescebes,2013,581,325,256,70,382,129
667,082055,Sant Cugat del Vallès,2013,86108,42029,44079,17767,58390,9951
668,082068,Sant Cugat Sesgarrigues,2013,974,487,487,171,611,192
669,251961,Sant Esteve de la Sarga,2013,134,78,56,11,88,35
670,082074,Sant Esteve de Palautordera,2013,2544,1239,1305,528,1706,310
671,082080,Sant Esteve Sesrovires,2013,7546,3766,3780,1392,5089,1065
672,171595,Sant Feliu de Buixalleu,2013,782,406,376,110,534,138
673,082107,Sant Feliu de Codines,2013,6025,3030,2995,1088,3999,938
674,171609,Sant Feliu de Guíxols,2013,21945,10895,11050,3402,14649,3894
675,082114,Sant Feliu de Llobregat,2013,43769,21320,22449,7382,29298,7089
676,171616,Sant Feliu de Pallerols,2013,1346,658,688,218,846,282
677,082129,Sant Feliu Sasserra,2013,645,337,308,94,413,138
678,171621,Sant Ferriol,2013,231,134,97,35,159,37
679,082093,Sant Fost de Campsentelles,2013,8539,4263,4276,1371,5721,1447
680,082135,Sant Fruitós de Bages,2013,8283,4151,4132,1545,5624,1114
681,171637,Sant Gregori,2013,3463,1751,1712,674,2309,480
682,251924,Sant Guim de Freixenet,2013,1112,576,536,165,697,250
683,251977,Sant Guim de la Plana,2013,184,98,86,23,105,56
684,171642,Sant Hilari Sacalm,2013,5742,2941,2801,840,3821,1081
685,082153,Sant Hipòlit de Voltregà,2013,3521,1751,1770,584,2299,638
686,081939,Sant Iscle de Vallalta,2013,1323,680,643,250,878,195
687,439023,Sant Jaume d'Enveja,2013,3566,1815,1751,512,2230,824
688,082166,Sant Jaume de Frontanyà,2013,25,16,9,2,18,5
689,171655,Sant Jaume de Llierca,2013,799,395,404,90,498,211
690,431378,Sant Jaume dels Domenys,2013,2556,1307,1249,466,1691,399
691,171674,Sant Joan de les Abadesses,2013,3434,1697,1737,414,2123,897
692,171680,Sant Joan de Mollet,2013,517,257,260,82,340,95
693,082188,Sant Joan de Vilatorrada,2013,10793,5411,5382,1822,7145,1826
694,082172,Sant Joan Despí,2013,32812,16052,16760,5844,22013,4955
695,171851,Sant Joan les Fonts,2013,2893,1446,1447,375,1856,662
696,171668,Sant Jordi Desvalls,2013,702,336,366,106,452,144
697,089030,Sant Julià de Cerdanyola,2013,248,140,108,29,155,64
698,171693,Sant Julià de Ramis,2013,3469,1745,1724,717,2339,413
699,082205,Sant Julià de Vilatorta,2013,3076,1512,1564,574,2047,455
700,179032,Sant Julià del Llor i Bonmatí,2013,1264,646,618,229,857,178
701,082212,Sant Just Desvern,2013,16859,8040,8819,2777,11183,2899
702,082227,Sant Llorenç d'Hortons,2013,2535,1273,1262,483,1706,346
703,171714,Sant Llorenç de la Muga,2013,256,132,124,39,165,52
704,251930,Sant Llorenç de Morunys,2013,1000,499,501,125,608,267
705,082233,Sant Llorenç Savall,2013,2401,1225,1176,364,1535,502
706,082251,Sant Martí d'Albars,2013,105,53,52,10,63,32
707,082248,Sant Martí de Centelles,2013,1109,567,542,201,759,149
708,171729,Sant Martí de Llémena,2013,615,327,288,99,432,84
709,259025,Sant Martí de Riucorb,2013,691,362,329,79,389,223
710,082264,Sant Martí de Tous,2013,1184,601,583,254,703,227
711,082270,Sant Martí Sarroca,2013,3168,1554,1614,533,2071,564
712,082286,Sant Martí Sesgueioles,2013,382,192,190,61,249,72
713,171735,Sant Martí Vell,2013,240,129,111,43,150,47
714,082299,Sant Mateu de Bages,2013,637,329,308,65,379,193
715,171740,Sant Miquel de Campmajor,2013,219,119,100,25,143,51
716,171753,Sant Miquel de Fluvià,2013,779,399,380,99,541,139
717,171766,Sant Mori,2013,181,95,86,24,124,33
718,171772,Sant Pau de Segúries,2013,677,331,346,76,432,169
719,082310,Sant Pere de Ribes,2013,28730,14448,14282,5155,19951,3624
720,082325,Sant Pere de Riudebitlles,2013,2346,1184,1162,416,1461,469
721,082331,Sant Pere de Torelló,2013,2445,1249,1196,358,1613,474
722,082346,Sant Pere de Vilamajor,2013,4293,2157,2136,855,2870,568
723,171788,Sant Pere Pescador,2013,2175,1160,1015,351,1497,327
724,081897,Sant Pere Sallavinera,2013,171,95,76,26,98,47
725,082359,Sant Pol de Mar,2013,5066,2557,2509,806,3342,918
726,082362,Sant Quintí de Mediona,2013,2165,1101,1064,410,1343,412
727,082378,Sant Quirze de Besora,2013,2167,1070,1097,298,1305,564
728,082384,Sant Quirze del Vallès,2013,19408,9488,9920,3913,13396,2099
729,082397,Sant Quirze Safaja,2013,659,348,311,140,446,73
730,251945,Sant Ramon,2013,525,289,236,51,326,148
731,082401,Sant Sadurní d'Anoia,2013,12603,6177,6426,2284,8399,1920
732,082418,Sant Sadurní d'Osormort,2013,88,49,39,7,61,20
733,080983,Sant Salvador de Guardiola,2013,3122,1590,1532,573,2039,510
734,082628,Sant Vicenç de Castellet,2013,9385,4651,4734,1467,6239,1679
735,082649,Sant Vicenç de Montalt,2013,5951,3004,2947,1271,3891,789
736,082652,Sant Vicenç de Torelló,2013,2013,994,1019,334,1295,384
737,082634,Sant Vicenç dels Horts,2013,28181,14114,14067,4901,19257,4023
738,431384,Santa Bàrbara,2013,3873,1975,1898,580,2469,824
739,082439,Santa Cecília de Voltregà,2013,179,93,86,17,123,39
740,082444,Santa Coloma de Cervelló,2013,8060,3950,4110,1821,5310,929
741,171805,Santa Coloma de Farners,2013,12601,6403,6198,2253,8423,1925
742,082457,Santa Coloma de Gramenet,2013,120029,60280,59749,18328,80044,21657
743,431397,Santa Coloma de Queralt,2013,2966,1468,1498,515,1817,634
744,171812,Santa Cristina d'Aro,2013,5128,2612,2516,903,3431,794
745,082460,Santa Eugènia de Berga,2013,2244,1146,1098,302,1590,352
746,082476,Santa Eulàlia de Riuprimer,2013,1231,621,610,231,822,178
747,082482,Santa Eulàlia de Ronçana,2013,7042,3530,3512,1335,4609,1098
748,082495,Santa Fe del Penedès,2013,378,195,183,73,255,50
749,171827,Santa Llogaia d'Àlguema,2013,347,184,163,62,244,41
750,082508,Santa Margarida de Montbui,2013,9690,4853,4837,1729,6465,1496
751,082515,Santa Margarida i els Monjos,2013,7288,3694,3594,1492,4914,882
752,082589,Santa Maria d'Oló,2013,1060,545,515,151,677,232
753,082536,Santa Maria de Besora,2013,163,82,81,21,92,50
754,082567,Santa Maria de Martorelles,2013,847,422,425,145,586,116
755,082554,Santa Maria de Merlès,2013,175,86,89,37,109,29
756,082573,Santa Maria de Miralles,2013,133,67,66,16,87,30
757,082592,Santa Maria de Palautordera,2013,9195,4700,4495,1629,6269,1297
758,431401,Santa Oliva,2013,3311,1680,1631,607,2175,529
759,171848,Santa Pau,2013,1589,803,786,208,1080,301
760,082606,Santa Perpètua de Mogoda,2013,25473,13016,12457,4912,17427,3134
761,082613,Santa Susanna,2013,3325,1700,1625,591,2242,492
762,081923,Santpedor,2013,7346,3656,3690,1326,4930,1090
763,431423,Sarral,2013,1640,846,794,272,1034,334
764,171864,Sarrià de Ter,2013,4892,2443,2449,779,3288,825
765,252017,Sarroca de Bellera,2013,126,75,51,2,82,42
766,252000,Sarroca de Lleida,2013,401,219,182,32,241,128
767,171870,"Saus, Camallera i Llampaies",2013,781,376,405,123,500,158
768,431439,Savallà del Comtat,2013,64,32,32,3,43,18
769,431444,"Secuita, la",2013,1635,838,797,286,1119,230
770,171886,"Selva de Mar, la",2013,185,100,85,14,125,46
771,431457,"Selva del Camp, la",2013,5614,2831,2783,1011,3785,818
772,431460,Senan,2013,56,36,20,7,35,14
773,430445,"Sénia, la",2013,5987,3045,2942,930,3981,1076
774,252022,Senterada,2013,140,82,58,10,107,23
775,250352,"Sentiu de Sió, la",2013,475,239,236,45,305,125
776,082671,Sentmenat,2013,8655,4384,4271,1593,6011,1051
777,171903,Serinyà,2013,1108,569,539,192,726,190
778,252043,Seròs,2013,1911,1045,866,260,1226,425
779,171910,Serra de Daró,2013,203,111,92,30,124,49
780,171925,Setcases,2013,189,104,85,15,128,46
781,252038,"Seu d'Urgell, la",2013,12468,6062,6406,1913,8399,2156
782,082690,Seva,2013,3481,1778,1703,601,2280,600
783,252056,Sidamon,2013,735,375,360,117,492,126
784,171931,Sils,2013,5685,2886,2799,1020,3824,841
785,082704,Sitges,2013,29140,14562,14578,4457,20130,4553
786,170524,Siurana,2013,172,89,83,20,107,45
787,082711,Sobremunt,2013,90,42,48,13,57,20
788,252069,"Soleràs, el",2013,362,184,178,47,193,122
789,431476,Solivella,2013,653,331,322,93,375,185
790,252075,Solsona,2013,9188,4591,4597,1557,6006,1625
791,082726,Sora,2013,173,95,78,19,124,30
792,252081,Soriguera,2013,374,200,174,39,261,74
793,252094,Sort,2013,2274,1143,1131,371,1521,382
794,252108,Soses,2013,1753,908,845,269,1157,327
795,082732,Subirats,2013,3027,1540,1487,512,1952,563
796,252115,Sudanell,2013,888,494,394,97,597,194
797,252120,Sunyer,2013,298,157,141,29,193,76
798,082747,Súria,2013,6121,2963,3158,804,3896,1421
799,171946,Susqueda,2013,101,60,41,8,68,25
800,082763,Tagamanent,2013,318,169,149,61,212,45
801,082779,Talamanca,2013,147,79,68,19,98,30
802,252154,Talarn,2013,436,236,200,51,298,87
803,252167,Talavera,2013,279,156,123,32,164,83
804,171959,"Tallada d'Empordà, la",2013,455,235,220,67,291,97
805,082785,Taradell,2013,6231,3137,3094,1061,4105,1065
806,431482,Tarragona,2013,133545,65414,68131,21820,90007,21718
807,252173,Tàrrega,2013,16670,8347,8323,2992,11218,2460
808,252189,Tarrés,2013,107,63,44,11,70,26
809,252192,Tarroja de Segarra,2013,171,89,82,16,109,46
810,082750,Tavèrnoles,2013,315,157,158,46,219,50
811,082802,Tavertet,2013,127,70,57,15,88,24
812,082819,Teià,2013,6144,3047,3097,963,4125,1056
813,252206,Térmens,2013,1548,775,773,173,1037,338
814,171962,Terrades,2013,278,134,144,50,174,54
815,082798,Terrassa,2013,215055,106237,108818,37909,143976,33170
816,082824,Tiana,2013,8221,3939,4282,1478,5613,1130
817,252213,Tírvia,2013,160,81,79,15,107,38
818,252228,Tiurana,2013,77,35,42,6,45,26
819,431495,Tivenys,2013,877,445,432,95,514,268
820,431508,Tivissa,2013,1814,907,907,209,1123,482
821,082830,Tona,2013,8085,3998,4087,1469,5308,1308
822,252234,Torà,2013,1253,629,624,145,846,262
823,082845,Tordera,2013,16363,8336,8027,2840,10935,2588
824,082858,Torelló,2013,13908,6827,7081,2209,9292,2407
825,252249,"Torms, els",2013,153,83,70,15,81,57
826,252252,Tornabous,2013,935,505,430,122,581,232
827,252271,"Torre de Cabdella, la",2013,747,372,375,53,481,213
828,082861,"Torre de Claramunt, la",2013,3827,1977,1850,705,2641,481
829,431515,"Torre de Fontaubella, la",2013,127,68,59,12,76,39
830,431520,"Torre de l'Espanyol, la",2013,686,357,329,101,418,167
831,252265,Torrebesses,2013,300,157,143,28,176,96
832,431536,Torredembarra,2013,15354,7565,7789,2469,10335,2550
833,252287,Torrefarrera,2013,4400,2208,2192,915,3037,448
834,259078,Torrefeta i Florejacs,2013,617,324,293,65,369,183
835,252304,Torregrossa,2013,2234,1129,1105,293,1409,532
836,252311,Torrelameu,2013,735,416,319,84,495,156
837,082877,Torrelavit,2013,1400,737,663,224,926,250
838,082883,Torrelles de Foix,2013,2360,1241,1119,379,1544,437
839,082896,Torrelles de Llobregat,2013,5776,2863,2913,1200,3954,622
840,171978,Torrent,2013,185,96,89,22,119,44
841,252326,Torres de Segre,2013,2246,1159,1087,278,1531,437
842,252332,Torre-serona,2013,369,188,181,50,225,94
843,171984,Torroella de Fluvià,2013,729,366,363,111,504,114
844,171997,Torroella de Montgrí,2013,11472,5824,5648,1937,7653,1882
845,431541,Torroja del Priorat,2013,166,91,75,12,100,54
846,172001,Tortellà,2013,774,372,402,108,482,184
847,431554,Tortosa,2013,33992,17022,16970,5214,22327,6451
848,172018,Toses,2013,149,86,63,18,95,36
849,172023,Tossa de Mar,2013,5910,3013,2897,792,4066,1052
850,252347,Tremp,2013,6288,3112,3176,911,4013,1364
851,172044,Ullà,2013,1057,584,473,184,724,149
852,082900,Ullastrell,2013,2030,1021,1009,460,1324,246
853,172057,Ullastret,2013,287,142,145,57,181,49
854,431567,Ulldecona,2013,7240,3743,3497,1122,4788,1330
855,431573,Ulldemolins,2013,435,248,187,34,256,145
856,172039,Ultramort,2013,208,114,94,30,131,47
857,172060,Urús,2013,183,89,94,20,126,37
858,082917,Vacarisses,2013,6260,3227,3033,1429,4129,702
859,170144,"Vajol, la",2013,94,55,39,8,70,16
860,172076,"Vall d'en Bas, la",2013,2974,1484,1490,477,1916,581
861,172082,"Vall de Bianya, la",2013,1316,668,648,219,872,225
862,250432,"Vall de Boí, la",2013,1023,545,478,107,746,170
863,259010,Vall de Cardós,2013,394,212,182,45,263,86
864,082922,Vallbona d'Anoia,2013,1431,730,701,221,966,244
865,252385,Vallbona de les Monges,2013,259,138,121,21,158,80
866,082938,Vallcebre,2013,264,153,111,21,171,72
867,431589,Vallclara,2013,115,65,50,16,69,30
868,252402,Vallfogona de Balaguer,2013,1877,924,953,282,1300,295
869,171707,Vallfogona de Ripollès,2013,217,119,98,23,139,55
870,431592,Vallfogona de Riucorb,2013,116,64,52,4,69,43
871,082943,Vallgorguina,2013,2746,1415,1331,577,1877,292
872,082956,Vallirana,2013,14625,7299,7326,2793,9720,2112
873,172095,Vall-llobrega,2013,910,467,443,189,627,94
874,431606,Vallmoll,2013,1674,866,808,266,1147,261
875,082969,Vallromanes,2013,2542,1289,1253,586,1695,261
876,431613,Valls,2013,24649,12361,12288,4092,16471,4086
877,259062,"Valls d'Aguilar, les",2013,320,167,153,35,204,81
878,252398,"Valls de Valira, les",2013,879,449,430,86,638,155
879,431628,Vandellòs i l'Hospitalet de l'Infant,2013,5992,2972,3020,975,4059,958
880,259097,"Vansa i Fórnols, la",2013,206,109,97,12,133,61
881,082975,Veciana,2013,176,102,74,28,101,47
882,431634,"Vendrell, el",2013,36747,18389,18358,6464,24640,5643
883,172109,Ventalló,2013,815,424,391,134,523,158
884,252424,Verdú,2013,1002,478,524,119,589,294
885,172116,Verges,2013,1210,579,631,181,760,269
886,431649,Vespella de Gaià,2013,411,221,190,61,282,68
887,082981,Vic,2013,41647,20660,20987,7580,27611,6456
888,172121,Vidrà,2013,166,88,78,23,116,27
889,172137,Vidreres,2013,7748,4003,3745,1373,5208,1167
890,252430,Vielha e Mijaran,2013,5508,2823,2685,811,4119,578
891,431652,Vilabella,2013,807,415,392,100,515,192
892,172142,Vilabertran,2013,917,475,442,139,587,191
893,172155,Vilablareix,2013,2492,1225,1267,409,1777,306
894,082994,Vilada,2013,462,246,216,29,294,139
895,172174,Viladamat,2013,453,236,217,56,294,103
896,172168,Viladasens,2013,218,112,106,32,145,41
897,083015,Viladecans,2013,65444,32527,32917,11838,44553,9053
898,083008,Viladecavalls,2013,7397,3714,3683,1360,5249,788
899,172180,Vilademuls,2013,802,407,395,127,501,174
900,172207,Viladrau,2013,1065,538,527,159,713,193
901,172214,Vilafant,2013,5502,2705,2797,965,3778,759
902,083054,Vilafranca del Penedès,2013,38929,19232,19697,6764,26047,6118
903,252445,Vilagrassa,2013,513,266,247,90,328,95
904,172235,Vilajuïga,2013,1220,602,618,222,784,214
905,431750,Vilalba dels Arcs,2013,706,367,339,70,420,216
906,083067,Vilalba Sasserra,2013,689,343,346,141,442,106
907,252458,Vilaller,2013,633,348,285,75,436,122
908,172240,Vilallonga de Ter,2013,447,238,209,52,282,113
909,431665,Vilallonga del Camp,2013,2237,1147,1090,437,1529,271
910,172253,Vilamacolum,2013,298,165,133,39,193,66
911,172266,Vilamalla,2013,1097,571,526,176,750,171
912,172272,Vilamaniscle,2013,158,89,69,36,94,28
913,252477,Vilamòs,2013,178,100,78,30,131,17
914,172288,Vilanant,2013,384,187,197,70,251,63
915,431671,Vilanova d'Escornalbou,2013,563,308,255,91,370,102
916,252483,Vilanova de Bellpuig,2013,1164,595,569,152,683,329
917,252496,Vilanova de l'Aguda,2013,237,119,118,25,136,76
918,252542,Vilanova de la Barca,2013,1141,568,573,148,739,254
919,252509,Vilanova de Meià,2013,413,220,193,36,247,130
920,431687,Vilanova de Prades,2013,132,66,66,18,81,33
921,083036,Vilanova de Sau,2013,330,164,166,32,230,68
922,252516,Vilanova de Segrià,2013,900,473,427,108,618,174
923,083020,Vilanova del Camí,2013,12533,6293,6240,2342,8470,1721
924,089024,Vilanova del Vallès,2013,5152,2622,2530,1194,3428,530
925,083073,Vilanova i la Geltrú,2013,66275,32285,33990,10567,44542,11166
926,431690,Vilaplana,2013,631,319,312,68,431,132
927,431704,Vila-rodona,2013,1261,646,615,211,817,233
928,172305,Vila-sacra,2013,661,323,338,117,426,118
929,252521,Vila-sana,2013,719,362,357,113,457,149
930,431711,Vila-seca,2013,21689,11065,10624,3879,15421,2389
931,082140,Vilassar de Dalt,2013,8879,4370,4509,1436,5901,1542
932,082191,Vilassar de Mar,2013,20030,9687,10343,3405,13333,3292
933,172229,Vilaür,2013,148,72,76,32,81,35
934,431726,Vilaverd,2013,506,262,244,83,309,114
935,431732,"Vilella Alta, la",2013,131,72,59,20,74,37
936,431747,"Vilella Baixa, la",2013,215,115,100,36,124,55
937,172333,Vilobí d'Onyar,2013,3108,1612,1496,556,2051,501
938,083041,Vilobí del Penedès,2013,1099,557,542,193,705,201
939,172327,Vilopriu,2013,200,111,89,26,127,47
940,252537,"Vilosell, el",2013,192,97,95,10,116,66
941,431763,Vimbodí i Poblet,2013,974,546,428,122,573,279
942,252555,Vinaixa,2013,567,291,276,59,355,153
943,431779,Vinebre,2013,478,242,236,62,314,102
944,431785,Vinyols i els Arcs,2013,1969,1012,957,337,1343,289
945,083089,Viver i Serrateix,2013,177,90,87,29,103,45
946,430521,Xerta,2013,1260,621,639,149,780,331
947,000000,Catalunya,2013,7553650,3725318,3828332,1186867,5057760,1309023
0,250019,Abella de la Conca,2014,170,94,76,17,107,46
1,080018,Abrera,2014,12125,6167,5958,2310,8198,1617
2,250024,Àger,2014,594,314,280,58,369,167
3,250030,Agramunt,2014,5515,2777,2738,904,3615,996
4,080023,Aguilar de Segarra,2014,251,132,119,35,159,57
5,170010,Agullana,2014,826,414,412,121,521,184
6,080142,Aiguafreda,2014,2498,1194,1304,373,1603,522
7,430017,Aiguamúrcia,2014,909,487,422,124,592,193
8,170025,Aiguaviva,2014,783,392,391,167,498,118
9,250387,Aitona,2014,2415,1225,1190,372,1472,571
10,250045,"Alamús, els",2014,769,403,366,93,504,172
11,250058,Alàs i Cerc,2014,356,182,174,42,220,94
12,250061,"Albagés, l'",2014,419,220,199,38,255,126
13,170031,Albanyà,2014,155,85,70,30,108,17
14,250077,Albatàrrec,2014,2139,1112,1027,330,1560,249
15,250083,Albesa,2014,1608,856,752,225,1039,344
16,250096,"Albi, l'",2014,834,436,398,126,475,233
17,430022,Albinyana,2014,2335,1181,1154,360,1503,472
18,430038,"Albiol, l'",2014,458,234,224,93,305,60
19,170046,Albons,2014,727,375,352,130,469,128
20,430043,Alcanar,2014,9637,4922,4715,1362,6291,1984
21,250100,Alcanó,2014,242,118,124,29,134,79
22,250117,Alcarràs,2014,9252,4815,4437,1622,6500,1130
23,250122,Alcoletge,2014,3270,1716,1554,537,2343,390
24,430056,Alcover,2014,5131,2573,2558,889,3415,827
25,439044,"Aldea, l'",2014,4376,2318,2058,620,2885,871
26,430069,Aldover,2014,940,475,465,115,538,287
27,430075,"Aleixar, l'",2014,891,450,441,154,577,160
28,080039,Alella,2014,9651,4722,4929,1555,6475,1621
29,430081,Alfara de Carles,2014,395,211,184,48,232,115
30,250138,Alfarràs,2014,3003,1562,1441,449,1900,654
31,250143,Alfés,2014,315,162,153,29,195,91
32,430094,Alforja,2014,1859,946,913,235,1243,381
33,250156,Algerri,2014,423,228,195,28,230,165
34,250169,Alguaire,2014,3093,1636,1457,455,2036,602
35,250175,Alins,2014,286,150,136,31,167,88
36,430108,Alió,2014,432,210,222,59,280,93
37,250194,Almacelles,2014,6699,3484,3215,999,4432,1268
38,250208,Almatret,2014,333,176,157,15,192,126
39,250215,Almenar,2014,3547,1887,1660,449,2334,764
40,430115,Almoster,2014,1396,691,705,237,979,180
41,250220,Alòs de Balaguer,2014,126,69,57,11,69,46
42,170062,Alp,2014,1661,876,785,231,1219,211
43,080044,Alpens,2014,300,162,138,47,197,56
44,250236,Alpicat,2014,6297,3140,3157,1210,4281,806
45,250241,Alt Àneu,2014,416,235,181,32,295,89
46,430120,Altafulla,2014,4988,2451,2537,903,3366,719
47,170078,Amer,2014,2281,1095,1186,302,1453,526
48,430136,"Ametlla de Mar, l'",2014,7303,3703,3600,1079,4620,1604
49,080057,"Ametlla del Vallès, l'",2014,8283,4177,4106,1584,5682,1017
50,439060,"Ampolla, l'",2014,3479,1772,1707,424,2264,791
51,430141,Amposta,2014,21197,10713,10484,3448,14181,3568
52,170084,Anglès,2014,5606,2786,2820,949,3632,1025
53,250273,Anglesola,2014,1360,678,682,203,821,336
54,250292,Arbeca,2014,2389,1221,1168,278,1493,618
55,430167,"Arboç, l'",2014,5515,2865,2650,1030,3657,828
56,430154,Arbolí,2014,105,59,46,3,76,26
57,170097,Arbúcies,2014,6481,3377,3104,1101,4308,1072
58,080060,Arenys de Mar,2014,15307,7509,7798,2261,9961,3085
59,080076,Arenys de Munt,2014,8654,4371,4283,1572,5717,1365
60,170101,Argelaguer,2014,425,229,196,52,278,95
61,080082,Argençola,2014,212,113,99,19,155,38
62,430173,"Argentera, l'",2014,146,81,65,7,103,36
63,080095,Argentona,2014,11963,5877,6086,2087,7923,1953
64,170118,"Armentera, l'",2014,901,450,451,144,568,189
65,430189,Arnes,2014,474,242,232,47,253,174
66,250313,Arres,2014,73,45,28,8,55,10
67,250328,Arsèguel,2014,81,45,36,15,52,14
68,080109,Artés,2014,5661,2841,2820,931,3788,942
69,250334,Artesa de Lleida,2014,1508,784,724,235,971,302
70,250349,Artesa de Segre,2014,3656,1850,1806,549,2365,742
71,430192,Ascó,2014,1654,862,792,175,1102,377
72,250365,Aspa,2014,215,107,108,19,125,71
73,250371,"Avellanes i Santa Linya, les",2014,479,272,207,47,279,153
74,080116,Avià,2014,2258,1129,1129,364,1453,441
75,080121,Avinyó,2014,2275,1138,1137,368,1412,495
76,170123,Avinyonet de Puigventós,2014,1581,797,784,329,1094,158
77,080137,Avinyonet del Penedès,2014,1675,878,797,271,1085,319
78,080155,Badalona,2014,217210,107587,109623,34585,145433,37192
79,089045,Badia del Vallès,2014,13553,6603,6950,2178,8889,2486
80,080168,Bagà,2014,2225,1109,1116,251,1438,536
81,250390,Baix Pallars,2014,361,192,169,52,226,83
82,250404,Balaguer,2014,16485,8333,8152,2790,10837,2858
83,080174,Balenyà,2014,3724,1870,1854,661,2499,564
84,080180,Balsareny,2014,3343,1644,1699,431,2213,699
85,430206,Banyeres del Penedès,2014,3057,1552,1505,595,2012,450
86,170157,Banyoles,2014,19343,9709,9634,3515,12649,3179
87,250411,Barbens,2014,875,465,410,135,515,225
88,430213,Barberà de la Conca,2014,519,281,238,79,321,119
89,082520,Barberà del Vallès,2014,32550,16120,16430,5655,22420,4475
90,080193,Barcelona,2014,1602386,758316,844070,200963,1057433,343990
91,250426,"Baronia de Rialb, la",2014,235,124,111,20,139,76
92,170160,Bàscara,2014,949,482,467,149,567,233
93,250447,Bassella,2014,244,125,119,28,153,63
94,430228,Batea,2014,1975,983,992,245,1172,558
95,250450,Bausen,2014,49,29,20,2,24,23
96,080207,Begues,2014,6620,3282,3338,1316,4567,737
97,170139,Begur,2014,3994,2027,1967,534,2688,772
98,250463,Belianes,2014,555,275,280,65,312,178
99,251706,Bellaguarda,2014,307,161,146,22,177,108
100,170182,Bellcaire d'Empordà,2014,650,309,341,100,403,147
101,250479,Bellcaire d'Urgell,2014,1305,666,639,186,779,340
102,250485,Bell-lloc d'Urgell,2014,2351,1164,1187,367,1509,475
103,250498,Bellmunt d'Urgell,2014,192,95,97,22,117,53
104,430234,Bellmunt del Priorat,2014,307,156,151,31,197,79
105,080214,Bellprat,2014,78,46,32,2,50,26
106,250501,Bellpuig,2014,4956,2558,2398,776,3309,871
107,430249,Bellvei,2014,2174,1121,1053,432,1380,362
108,250518,Bellver de Cerdanya,2014,2075,1086,989,286,1371,418
109,250523,Bellvís,2014,2342,1184,1158,320,1450,572
110,250539,Benavent de Segrià,2014,1516,792,724,274,1033,209
111,430252,Benifallet,2014,703,358,345,46,414,243
112,430265,Benissanet,2014,1247,677,570,153,813,281
113,080229,Berga,2014,16456,8076,8380,2413,10553,3490
114,170195,Besalú,2014,2400,1154,1246,372,1493,535
115,170209,Bescanó,2014,4874,2427,2447,961,3189,724
116,170216,Beuda,2014,200,108,92,37,129,34
117,080235,Bigues i Riells del Fai,2014,8854,4513,4341,1699,5984,1171
118,250557,Biosca,2014,197,106,91,14,119,64
119,170221,"Bisbal d'Empordà, la",2014,10761,5419,5342,1944,7133,1684
120,430271,"Bisbal de Falset, la",2014,216,119,97,26,122,68
121,430287,"Bisbal del Penedès, la",2014,3495,1835,1660,540,2271,684
122,172348,Biure,2014,245,132,113,29,159,57
123,430290,Blancafort,2014,413,214,199,45,262,106
124,170237,Blanes,2014,39293,19703,19590,6023,26491,6779
125,170293,Boadella i les Escaules,2014,248,129,119,33,164,51
126,170242,Bolvir,2014,373,197,176,53,242,78
127,430304,Bonastre,2014,622,321,301,105,419,98
128,250576,"Bòrdes, Es",2014,234,134,100,24,169,41
129,170255,Bordils,2014,1690,852,838,300,1114,276
130,250582,"Borges Blanques, les",2014,6088,3094,2994,912,3917,1259
131,430311,"Borges del Camp, les",2014,2077,1040,1037,387,1310,380
132,170268,Borrassà,2014,728,374,354,143,449,136
133,080240,Borredà,2014,540,299,241,53,351,136
134,250595,Bossòst,2014,1140,569,571,162,796,182
135,430326,Bot,2014,630,327,303,53,348,229
136,430332,Botarell,2014,1100,576,524,207,759,134
137,250560,Bovera,2014,290,157,133,21,152,117
138,430347,Bràfim,2014,660,332,328,97,414,149
139,170274,Breda,2014,3751,1876,1875,547,2421,783
140,080253,"Bruc, el",2014,1991,1070,921,386,1338,267
141,080266,"Brull, el",2014,263,145,118,54,170,39
142,170280,Brunyola i Sant Martí Sapresa,2014,391,197,194,59,237,95
143,430350,Cabacés,2014,326,163,163,39,197,90
144,250609,Cabanabona,2014,88,41,47,5,48,35
145,170314,Cabanelles,2014,243,136,107,33,156,54
146,170307,Cabanes,2014,921,489,432,152,574,195
147,080272,"Cabanyes, les",2014,961,497,464,205,630,126
148,250616,Cabó,2014,98,50,48,8,61,29
149,430363,Cabra del Camp,2014,1115,588,527,187,718,210
150,080288,Cabrera d'Anoia,2014,1363,713,650,244,918,201
151,080291,Cabrera de Mar,2014,4525,2275,2250,741,3126,658
152,080305,Cabrils,2014,7197,3554,3643,1423,4898,876
153,170329,Cadaqués,2014,2820,1368,1452,453,1895,472
154,080312,Calaf,2014,3475,1793,1682,572,2236,667
155,430379,Calafell,2014,24333,12210,12123,3918,16236,4179
156,080348,Calders,2014,949,491,458,158,630,161
157,080327,Caldes d'Estrac,2014,2738,1314,1424,393,1800,545
158,170335,Caldes de Malavella,2014,7130,3555,3575,1248,4758,1124
159,080333,Caldes de Montbui,2014,17156,8552,8604,2902,11398,2856
160,080351,Calella,2014,18307,8996,9311,2809,11986,3512
161,080370,Calldetenes,2014,2429,1242,1187,374,1706,349
162,080386,Callús,2014,1985,962,1023,371,1253,361
163,080364,Calonge de Segarra,2014,202,99,103,24,118,60
164,170340,Calonge i Sant Antoni,2014,10541,5298,5243,1602,6968,1971
165,250621,Camarasa,2014,911,454,457,91,570,250
166,439039,Camarles,2014,3514,1804,1710,511,2235,768
167,430385,Cambrils,2014,33301,16429,16872,5899,22713,4689
168,170353,Camós,2014,686,345,341,101,421,164
169,170366,Campdevànol,2014,3395,1660,1735,459,2040,896
170,170372,Campelles,2014,132,67,65,14,86,32
171,080399,Campins,2014,521,261,260,88,368,65
172,170388,Campllong,2014,515,257,258,125,330,60
173,170391,Camprodon,2014,2359,1149,1210,309,1485,565
174,250637,Canejan,2014,102,57,45,6,67,29
175,170405,Canet d'Adri,2014,644,331,313,96,424,124
176,080403,Canet de Mar,2014,14123,6861,7262,2290,9062,2771
177,439076,"Canonja, la",2014,5807,2896,2911,1035,3966,806
178,080410,Canovelles,2014,15954,8277,7677,3013,10761,2180
179,080425,Cànoves i Samalús,2014,2863,1454,1409,477,1923,463
180,170412,Cantallops,2014,324,163,161,45,207,72
181,080431,Canyelles,2014,4345,2217,2128,826,2986,533
182,430398,Capafonts,2014,114,57,57,6,72,36
183,430402,Capçanes,2014,411,203,208,44,259,108
184,080446,Capellades,2014,5284,2626,2658,809,3414,1061
185,170427,Capmany,2014,612,323,289,91,361,160
186,080459,Capolat,2014,88,41,47,18,58,12
187,080462,Cardedeu,2014,17698,8712,8986,3393,11767,2538
188,080478,Cardona,2014,4921,2413,2508,620,3037,1264
189,080484,Carme,2014,817,424,393,127,520,170
190,430419,Caseres,2014,267,134,133,23,161,83
191,170448,Cassà de la Selva,2014,9922,5062,4860,1714,6599,1609
192,080497,Casserres,2014,1569,776,793,173,990,406
193,080575,Castell de l'Areny,2014,75,42,33,7,53,15
194,259046,Castell de Mur,2014,163,85,78,16,93,54
195,250642,Castellar de la Ribera,2014,149,77,72,28,84,37
196,080522,Castellar de n'Hug,2014,159,86,73,13,110,36
197,080500,Castellar del Riu,2014,171,96,75,29,103,39
198,080517,Castellar del Vallès,2014,23440,11538,11902,4332,15796,3312
199,080538,Castellbell i el Vilar,2014,3624,1856,1768,615,2341,668
200,080543,Castellbisbal,2014,12434,6331,6103,2540,8420,1474
201,080556,Castellcir,2014,718,367,351,133,469,116
202,250674,Castelldans,2014,976,528,448,111,629,236
203,080569,Castelldefels,2014,63255,31286,31969,11027,43838,8390
204,080581,Castellet i la Gornal,2014,2237,1127,1110,334,1472,431
205,170464,Castellfollit de la Roca,2014,1013,518,495,160,608,245
206,080608,Castellfollit de Riubregós,2014,177,97,80,13,117,47
207,080594,Castellfollit del Boix,2014,428,217,211,67,277,84
208,080615,Castellgalí,2014,2022,1051,971,379,1324,319
209,080620,Castellnou de Bages,2014,1241,629,612,265,827,149
210,250680,Castellnou de Seana,2014,740,386,354,108,440,192
211,170470,Castelló d'Empúries,2014,11473,5835,5638,1800,7570,2103
212,250693,Castelló de Farfanya,2014,565,304,261,62,340,163
213,080636,Castellolí,2014,571,275,296,108,373,90
214,170486,Castell-Platja d'Aro,2014,10721,5309,5412,1606,7350,1765
215,250707,Castellserà,2014,1083,546,537,124,655,304
216,080641,Castellterçol,2014,2400,1191,1209,364,1495,541
217,430424,Castellvell del Camp,2014,2869,1434,1435,567,1981,321
218,080654,Castellví de la Marca,2014,1589,802,787,255,1008,326
219,080667,Castellví de Rosanes,2014,1760,871,889,298,1201,261
220,430430,"Catllar, el",2014,4222,2178,2044,746,2940,536
221,250714,Cava,2014,60,34,26,3,37,20
222,171899,"Cellera de Ter, la",2014,2071,1034,1037,320,1306,445
223,170499,Celrà,2014,5053,2519,2534,1089,3491,473
224,080673,Centelles,2014,7333,3596,3737,1220,4739,1374
225,082687,Cercs,2014,1246,628,618,134,745,367
226,082665,Cerdanyola del Vallès,2014,57402,28192,29210,8906,39296,9200
227,080689,Cervelló,2014,8811,4423,4388,1504,6029,1278
228,250729,Cervera,2014,9039,4555,4484,1637,5905,1497
229,250735,Cervià de les Garrigues,2014,708,365,343,71,420,217
230,170502,Cervià de Ter,2014,934,470,464,177,586,171
231,170519,Cistella,2014,293,143,150,45,188,60
232,250740,Ciutadilla,2014,209,114,95,18,128,63
233,250753,Clariana de Cardener,2014,140,71,69,22,93,25
234,250766,"Cogul, el",2014,190,103,87,15,112,63
235,170545,Colera,2014,532,274,258,49,334,149
236,250772,Coll de Nargó,2014,587,296,291,62,381,144
237,080692,Collbató,2014,4427,2286,2141,1025,2930,472
238,430458,Colldejou,2014,172,93,79,16,118,38
239,080706,Collsuspina,2014,338,177,161,61,216,61
240,170558,Colomers,2014,195,95,100,27,119,49
241,251636,"Coma i la Pedra, la",2014,269,164,105,28,199,42
242,251615,Conca de Dalt,2014,443,231,212,50,271,122
243,430461,Conesa,2014,122,62,60,7,85,30
244,430477,Constantí,2014,6539,3396,3143,1253,4403,883
245,080713,Copons,2014,323,163,160,61,193,69
246,430483,Corbera d'Ebre,2014,1136,604,532,143,715,278
247,080728,Corbera de Llobregat,2014,14237,7134,7103,2704,9716,1817
248,250788,Corbins,2014,1400,749,651,227,897,276
249,170577,Corçà,2014,1257,624,633,185,811,261
250,080734,Cornellà de Llobregat,2014,86234,42133,44101,13248,56215,16771
251,170561,Cornellà del Terri,2014,2235,1139,1096,357,1430,448
252,430496,Cornudella de Montsant,2014,954,509,445,108,617,229
253,430509,Creixell,2014,3480,1769,1711,543,2207,730
254,170583,Crespià,2014,245,124,121,40,153,52
255,179011,"Cruïlles, Monells i Sant Sadurní de l'Heura",2014,1284,654,630,189,881,214
256,080749,Cubelles,2014,14481,7315,7166,2602,9724,2155
257,250791,Cubells,2014,395,212,183,35,245,115
258,430516,Cunit,2014,11989,5969,6020,1951,7575,2463
259,170600,Darnius,2014,534,271,263,53,332,149
260,170617,Das,2014,220,119,101,45,130,45
261,439018,Deltebre,2014,11831,5957,5874,1745,7593,2493
262,080752,Dosrius,2014,5137,2611,2526,989,3529,619
263,430537,Duesaigües,2014,239,133,106,24,156,59
264,170622,"Escala, l'",2014,10143,5149,4994,1398,6691,2054
265,080765,Esparreguera,2014,21685,11018,10667,3772,14707,3206
266,170638,Espinelves,2014,196,97,99,30,121,45
267,250812,"Espluga Calba, l'",2014,395,199,196,45,217,133
268,430542,"Espluga de Francolí, l'",2014,3836,1867,1969,526,2482,828
269,080771,Esplugues de Llobregat,2014,46133,22250,23883,6343,30189,9601
270,170643,Espolla,2014,417,210,207,51,253,113
271,170656,Esponellà,2014,458,229,229,90,268,100
272,250827,Espot,2014,357,193,164,47,251,59
273,080787,"Espunyola, l'",2014,259,129,130,27,164,68
274,082541,"Esquirol, l'",2014,2188,1101,1087,307,1408,473
275,250886,Estamariu,2014,119,71,48,15,61,43
276,080790,"Estany, l'",2014,407,206,201,44,257,106
277,250851,Estaràs,2014,176,95,81,16,110,50
278,250864,Esterri d'Àneu,2014,866,438,428,105,617,144
279,250870,Esterri de Cardós,2014,72,36,36,8,52,12
280,430555,Falset,2014,2838,1429,1409,461,1801,576
281,170059,"Far d'Empordà, el",2014,563,285,278,120,347,96
282,250899,Farrera,2014,125,72,53,18,84,23
283,430568,"Fatarella, la",2014,1051,524,527,107,598,346
284,430574,"Febró, la",2014,40,29,11,1,31,8
285,081347,Figaró-Montmany,2014,1096,550,546,173,712,211
286,080804,Fígols,2014,43,22,21,6,22,15
287,259084,Fígols i Alinyà,2014,260,147,113,25,150,85
288,430580,"Figuera, la",2014,118,66,52,4,76,38
289,170669,Figueres,2014,45444,22489,22955,8061,30651,6732
290,430593,Figuerola del Camp,2014,345,165,180,64,210,71
291,170675,Flaçà,2014,1041,505,536,155,663,223
292,430607,Flix,2014,3795,1887,1908,377,2423,995
293,250925,"Floresta, la",2014,162,89,73,21,97,44
294,080826,Fogars de la Selva,2014,1512,794,718,244,1017,251
295,080811,Fogars de Montclús,2014,482,257,225,99,305,78
296,170681,Foixà,2014,320,156,164,43,192,85
297,080832,Folgueroles,2014,2259,1138,1121,525,1399,335
298,250931,Fondarella,2014,838,424,414,129,579,130
299,080847,Fonollosa,2014,1429,739,690,224,971,234
300,170694,Fontanals de Cerdanya,2014,443,229,214,39,314,90
301,170708,Fontanilles,2014,160,92,68,25,93,42
302,170715,Fontcoberta,2014,1442,704,738,247,1000,195
303,080850,Font-rubí,2014,1353,699,654,209,826,318
304,250946,Foradada,2014,182,103,79,16,107,59
305,179026,Forallac,2014,1729,846,883,242,1165,322
306,430614,Forès,2014,46,25,21,0,26,20
307,170736,Fornells de la Selva,2014,2479,1209,1270,526,1653,300
308,170741,Fortià,2014,710,346,364,121,442,147
309,080863,"Franqueses del Vallès, les",2014,19170,9755,9415,3757,13102,2311
310,430629,Freginals,2014,405,213,192,28,253,124
311,250962,"Fuliola, la",2014,1294,653,641,212,779,303
312,250978,Fulleda,2014,98,47,51,3,63,32
313,080902,Gaià,2014,163,90,73,25,118,20
314,430635,"Galera, la",2014,800,409,391,94,507,199
315,080879,Gallifa,2014,202,103,99,21,151,30
316,430640,Gandesa,2014,3091,1590,1501,422,1995,674
317,430653,Garcia,2014,559,288,271,71,333,155
318,430666,"Garidells, els",2014,182,89,93,20,131,31
319,080885,"Garriga, la",2014,15762,7661,8101,2818,10524,2420
320,170754,Garrigàs,2014,398,211,187,46,270,82
321,170767,Garrigoles,2014,159,87,72,17,100,42
322,170773,Garriguella,2014,857,432,425,148,547,162
323,080898,Gavà,2014,46326,22809,23517,7827,31217,7282
324,250984,Gavet de la Conca,2014,303,151,152,23,168,112
325,080919,Gelida,2014,7194,3600,3594,1382,4762,1050
326,170789,Ger,2014,432,233,199,64,278,90
327,259123,Gimenells i el Pla de la Font,2014,1129,577,552,142,695,292
328,430672,Ginestar,2014,819,422,397,92,508,219
329,170792,Girona,2014,97227,46734,50493,16756,66331,14140
330,080924,Gironella,2014,4987,2457,2530,655,3123,1209
331,080930,Gisclareny,2014,25,15,10,0,21,4
332,430688,Godall,2014,673,340,333,60,391,222
333,250997,Golmés,2014,1734,869,865,302,1132,300
334,170806,Gombrèn,2014,195,95,100,33,121,41
335,251001,Gósol,2014,216,127,89,10,149,57
336,080945,"Granada, la",2014,2073,1062,1011,371,1401,301
337,251018,"Granadella, la",2014,715,374,341,73,422,220
338,080958,Granera,2014,80,52,28,5,58,17
339,251023,"Granja d'Escarp, la",2014,972,505,467,96,638,238
340,080961,Granollers,2014,59930,29638,30292,9394,40734,9802
341,251039,Granyanella,2014,147,81,66,15,90,42
342,251057,Granyena de les Garrigues,2014,162,96,66,10,95,57
343,251044,Granyena de Segarra,2014,136,67,69,11,70,55
344,430691,Gratallops,2014,243,129,114,25,156,62
345,080977,Gualba,2014,1429,729,700,300,926,203
346,170813,Gualta,2014,362,195,167,57,234,71
347,080996,Guardiola de Berguedà,2014,937,500,437,107,605,225
348,430705,"Guiamets, els",2014,292,134,158,20,187,85
349,170828,Guils de Cerdanya,2014,536,282,254,70,387,79
350,251095,Guimerà,2014,295,162,133,15,154,126
351,259031,"Guingueta d'Àneu, la",2014,317,169,148,38,209,70
352,251109,Guissona,2014,6827,3605,3222,1341,4867,619
353,251116,Guixers,2014,128,76,52,7,88,33
354,081000,Gurb,2014,2545,1324,1221,449,1735,361
355,430712,Horta de Sant Joan,2014,1219,633,586,140,734,345
356,081017,"Hospitalet de Llobregat, l'",2014,253518,123269,130249,35326,166951,51241
357,081629,"Hostalets de Pierola, els",2014,2942,1516,1426,601,1999,342
358,170834,Hostalric,2014,4010,2025,1985,684,2668,658
359,081022,Igualada,2014,38751,18973,19778,6594,25053,7104
360,251155,Isona i Conca Dellà,2014,1049,548,501,109,626,314
361,170849,Isòvol,2014,301,167,134,25,221,55
362,251137,Ivars d'Urgell,2014,1607,843,764,212,972,423
363,251121,Ivars de Noguera,2014,350,182,168,37,219,94
364,251142,Ivorra,2014,115,59,56,9,66,40
365,170852,Jafre,2014,396,218,178,51,253,92
366,170865,"Jonquera, la",2014,3115,1576,1539,552,2119,444
367,081038,Jorba,2014,838,420,418,155,562,121
368,259101,Josa i Tuixén,2014,128,74,54,9,86,33
369,170871,Juià,2014,340,177,163,67,216,57
370,251180,Juncosa,2014,438,238,200,35,270,133
371,251193,Juneda,2014,3497,1843,1654,513,2257,727
372,251214,Les,2014,968,481,487,151,694,123
373,251229,Linyola,2014,2677,1361,1316,402,1721,554
374,081043,"Llacuna, la",2014,906,494,412,113,566,227
375,170887,Lladó,2014,767,378,389,155,485,127
376,251235,Lladorre,2014,232,114,118,33,152,47
377,251240,Lladurs,2014,195,106,89,19,116,60
378,081056,"Llagosta, la",2014,13430,6620,6810,2344,8764,2322
379,170890,Llagostera,2014,8198,4217,3981,1434,5395,1369
380,170904,Llambilles,2014,738,377,361,154,467,117
381,170911,Llanars,2014,509,263,246,58,338,113
382,170926,Llançà,2014,4970,2461,2509,694,3188,1088
383,251253,Llardecans,2014,497,257,240,42,282,173
384,251266,Llavorsí,2014,367,188,179,45,241,81
385,251207,Lleida,2014,139176,68911,70265,22034,94381,22761
386,170932,Llers,2014,1242,619,623,199,793,250
387,251272,Lles de Cerdanya,2014,260,156,104,30,163,67
388,081075,Lliçà d'Amunt,2014,14696,7466,7230,2675,9850,2171
389,081081,Lliçà de Vall,2014,6354,3224,3130,1054,4303,997
390,251288,Llimiana,2014,159,95,64,7,96,56
391,081069,Llinars del Vallès,2014,9536,4732,4804,1597,6412,1527
392,170947,Llívia,2014,1536,836,700,202,1096,238
393,430727,"Lloar, el",2014,110,58,52,14,63,33
394,251291,Llobera,2014,201,104,97,27,128,46
395,430733,Llorac,2014,112,61,51,10,74,28
396,430748,Llorenç del Penedès,2014,2306,1130,1176,409,1466,431
397,170950,Lloret de Mar,2014,38624,19972,18652,5991,27995,4638
398,170963,"Llosses, les",2014,211,121,90,21,153,37
399,081094,Lluçà,2014,257,130,127,44,167,46
400,171024,Maçanet de Cabrenys,2014,781,394,387,95,472,214
401,171030,Maçanet de la Selva,2014,6963,3567,3396,1145,4667,1151
402,170979,Madremanya,2014,283,140,143,49,182,52
403,170985,Maià de Montcal,2014,443,223,220,82,269,92
404,251333,Maials,2014,959,501,458,112,565,282
405,251305,Maldà,2014,227,117,110,22,137,68
406,081108,Malgrat de Mar,2014,18417,9244,9173,2788,12201,3428
407,081115,Malla,2014,266,131,135,36,173,57
408,081120,Manlleu,2014,20279,10112,10167,3738,13147,3394
409,081136,Manresa,2014,75297,36809,38488,12009,48560,14728
410,430764,Marçà,2014,611,316,295,89,381,141
411,430751,Margalef,2014,108,65,43,5,67,36
412,082423,Marganell,2014,297,143,154,37,195,65
413,081141,Martorell,2014,27895,14313,13582,5259,18390,4246
414,081154,Martorelles,2014,4783,2382,2401,694,3175,914
415,430770,Mas de Barberans,2014,619,306,313,64,377,178
416,171002,Masarac,2014,284,153,131,34,188,62
417,430786,Masdenverge,2014,1106,571,535,132,731,243
418,081167,"Masies de Roda, les",2014,737,365,372,104,485,148
419,081173,"Masies de Voltregà, les",2014,3186,1570,1616,541,2128,517
420,430799,Masllorenç,2014,519,280,239,83,324,112
421,081189,"Masnou, el",2014,22742,10950,11792,3377,15329,4036
422,430803,"Masó, la",2014,288,153,135,38,167,83
423,430810,Maspujols,2014,782,403,379,135,531,116
424,081192,Masquefa,2014,8406,4246,4160,1701,5620,1085
425,430825,"Masroig, el",2014,534,283,251,68,315,151
426,251312,Massalcoreig,2014,560,292,268,46,379,135
427,171019,Massanes,2014,723,392,331,134,463,126
428,251327,Massoteres,2014,196,108,88,43,119,34
429,081206,Matadepera,2014,8841,4432,4409,1714,5792,1335
430,081213,Mataró,2014,124280,61860,62420,20729,83357,20194
431,081228,Mediona,2014,2311,1162,1149,418,1422,471
432,251348,Menàrguens,2014,887,489,398,96,569,222
433,170998,Meranges,2014,94,53,41,13,56,25
434,171058,Mieres,2014,326,165,161,44,212,70
435,430831,"Milà, el",2014,174,86,88,26,102,46
436,251351,Miralcamp,2014,1384,697,687,210,895,279
437,430846,Miravet,2014,774,416,358,102,472,200
438,081385,Moià,2014,5760,2894,2866,1053,3730,977
439,430859,"Molar, el",2014,293,160,133,26,178,89
440,081234,Molins de Rei,2014,25152,12278,12874,4519,16697,3936
441,251370,Mollerussa,2014,14963,7629,7334,2812,10200,1951
442,171061,Mollet de Peralada,2014,182,96,86,26,100,56
443,081249,Mollet del Vallès,2014,51719,25698,26021,9084,35011,7624
444,171077,Molló,2014,339,165,174,40,215,84
445,251364,"Molsosa, la",2014,116,58,58,9,73,34
446,081287,Monistrol de Calders,2014,695,364,331,92,468,135
447,081271,Monistrol de Montserrat,2014,2945,1495,1450,446,1935,564
448,171096,Montagut i Oix,2014,970,507,463,138,635,197
449,430862,Montblanc,2014,7359,3725,3634,1131,4949,1279
450,430884,Montbrió del Camp,2014,2650,1349,1301,446,1801,403
451,081252,Montcada i Reixac,2014,34394,17012,17382,6035,23297,5062
452,081304,Montclar,2014,117,59,58,19,69,29
453,251399,Montellà i Martinet,2014,623,335,288,53,425,145
454,081311,Montesquiu,2014,895,455,440,137,561,197
455,251403,Montferrer i Castellbò,2014,1027,549,478,149,724,154
456,430897,Montferri,2014,369,203,166,69,236,64
457,251386,Montgai,2014,671,348,323,60,396,215
458,081265,Montgat,2014,11315,5610,5705,1958,7779,1578
459,081326,Montmajor,2014,476,240,236,57,299,120
460,081332,Montmaneu,2014,164,88,76,16,93,55
461,430901,"Montmell, el",2014,1418,769,649,222,936,260
462,081350,Montmeló,2014,8863,4376,4487,1443,5950,1470
463,251425,Montoliu de Lleida,2014,515,263,252,64,329,122
464,251410,Montoliu de Segarra,2014,193,111,82,19,120,54
465,251431,Montornès de Segarra,2014,105,53,52,13,56,36
466,081363,Montornès del Vallès,2014,16217,8241,7976,3055,11004,2158
467,430918,Mont-ral,2014,165,96,69,21,112,32
468,171100,Mont-ras,2014,1739,867,872,248,1185,306
469,430923,Mont-roig del Camp,2014,12148,6361,5787,1882,8320,1946
470,081379,Montseny,2014,332,174,158,49,200,83
471,430939,Móra d'Ebre,2014,5578,2750,2828,896,3664,1018
472,430944,Móra la Nova,2014,3190,1613,1577,462,2122,606
473,430957,"Morell, el",2014,3530,1817,1713,637,2443,450
474,430960,"Morera de Montsant, la",2014,157,94,63,21,106,30
475,081290,Muntanyola,2014,595,302,293,120,403,72
476,081398,Mura,2014,211,112,99,32,142,37
477,251459,Nalec,2014,93,48,45,3,53,37
478,250254,Naut Aran,2014,1782,897,885,259,1311,212
479,081402,Navarcles,2014,6003,2925,3078,873,4002,1128
480,081419,Navàs,2014,6117,3045,3072,951,3931,1235
481,171117,Navata,2014,1262,626,636,226,815,221
482,251462,Navès,2014,280,137,143,42,180,58
483,081424,"Nou de Berguedà, la",2014,150,75,75,13,96,41
484,430976,"Nou de Gaià, la",2014,548,273,275,115,326,107
485,430982,Nulles,2014,453,232,221,68,286,99
486,251484,Odèn,2014,267,154,113,18,175,74
487,081430,Òdena,2014,3624,1856,1768,709,2361,554
488,171122,Ogassa,2014,245,147,98,36,156,53
489,081458,Olèrdola,2014,3579,1853,1726,712,2373,494
490,081461,Olesa de Bonesvalls,2014,1735,889,846,332,1138,265
491,081477,Olesa de Montserrat,2014,23543,11776,11767,4404,15668,3471
492,251497,Oliana,2014,1870,922,948,208,1192,470
493,251500,Oliola,2014,235,129,106,25,146,64
494,251517,Olius,2014,902,462,440,193,575,134
495,081483,Olivella,2014,3609,1917,1692,746,2493,370
496,081496,Olost,2014,1186,593,593,142,766,278
497,171143,Olot,2014,33913,16881,17032,5162,22203,6548
498,251522,"Oluges, les",2014,158,84,74,10,91,57
499,081445,Olvan,2014,876,432,444,101,552,223
500,251538,"Omellons, els",2014,232,123,109,19,131,82
501,251543,"Omells de na Gaia, els",2014,141,76,65,12,84,45
502,171156,Ordis,2014,380,199,181,58,247,75
503,251556,Organyà,2014,841,413,428,82,508,251
504,081509,Orís,2014,303,154,149,43,217,43
505,081516,Oristà,2014,557,272,285,57,361,139
506,081521,Orpí,2014,131,73,58,10,92,29
507,081537,Òrrius,2014,690,353,337,120,476,94
508,251569,Os de Balaguer,2014,1008,510,498,179,628,201
509,171169,Osor,2014,452,230,222,59,286,107
510,251575,Ossó de Sió,2014,211,106,105,27,126,58
511,081542,Pacs del Penedès,2014,892,440,452,152,611,129
512,081555,Palafolls,2014,9065,4504,4561,1805,6138,1122
513,171175,Palafrugell,2014,22763,11373,11390,3865,15094,3804
514,171181,Palamós,2014,17805,8681,9124,2635,11857,3313
515,251581,"Palau d'Anglesola, el",2014,2135,1061,1074,330,1397,408
516,171194,Palau de Santa Eulàlia,2014,98,57,41,11,66,21
517,171215,Palau-sator,2014,305,158,147,47,188,70
518,171208,Palau-saverdera,2014,1437,712,725,283,876,278
519,081568,Palau-solità i Plegamans,2014,14454,7125,7329,2610,9881,1963
520,431009,"Pallaresos, els",2014,4479,2283,2196,1076,3028,375
521,081574,Pallejà,2014,11253,5641,5612,2173,7515,1565
522,430995,"Palma d'Ebre, la",2014,371,173,198,27,211,133
523,089058,"Palma de Cervelló, la",2014,3002,1503,1499,488,2124,390
524,171236,Palol de Revardit,2014,474,243,231,79,308,87
525,171241,Pals,2014,2533,1282,1251,368,1641,524
526,081580,"Papiol, el",2014,4023,2000,2023,696,2720,607
527,171254,Pardines,2014,155,88,67,19,95,41
528,081593,Parets del Vallès,2014,18733,9414,9319,3293,12974,2466
529,171267,Parlavà,2014,410,213,197,62,260,88
530,431016,Passanant i Belltall,2014,154,86,68,4,105,45
531,171289,Pau,2014,569,280,289,84,348,137
532,431021,Paüls,2014,596,290,306,66,345,185
533,171292,Pedret i Marzà,2014,189,104,85,32,121,36
534,251641,Penelles,2014,504,298,206,50,314,140
535,171306,"Pera, la",2014,467,223,244,76,284,107
536,081607,Perafita,2014,407,206,201,50,254,103
537,431037,Perafort,2014,1287,686,601,291,857,139
538,171328,Peralada,2014,1859,925,934,312,1191,356
539,251654,Peramola,2014,349,177,172,33,221,95
540,431042,"Perelló, el",2014,3155,1648,1507,397,1956,802
541,081614,Piera,2014,15000,7652,7348,2741,9852,2407
542,431055,"Piles, les",2014,214,113,101,35,142,37
543,081635,Pineda de Mar,2014,25948,12980,12968,3992,17044,4912
544,431068,"Pinell de Brai, el",2014,1076,551,525,119,658,299
545,251667,Pinell de Solsonès,2014,207,116,91,23,123,61
546,251673,Pinós,2014,302,166,136,44,189,69
547,431074,Pira,2014,480,251,229,86,306,88
548,431080,"Pla de Santa Maria, el",2014,2344,1220,1124,349,1562,433
549,081640,"Pla del Penedès, el",2014,1223,615,608,222,798,203
550,171334,"Planes d'Hostoles, les",2014,1694,864,830,230,1005,459
551,171349,Planoles,2014,300,166,134,37,195,68
552,259118,"Plans de Sió, els",2014,560,294,266,68,323,169
553,251689,"Poal, el",2014,656,342,314,77,409,170
554,251692,"Pobla de Cérvoles, la",2014,220,123,97,21,131,68
555,081653,"Pobla de Claramunt, la",2014,2186,1090,1096,407,1398,381
556,081666,"Pobla de Lillet, la",2014,1155,571,584,81,716,358
557,431093,"Pobla de Mafumet, la",2014,3420,1763,1657,680,2469,271
558,431107,"Pobla de Massaluca, la",2014,354,186,168,36,189,129
559,431114,"Pobla de Montornès, la",2014,2860,1499,1361,510,1855,495
560,251713,"Pobla de Segur, la",2014,3012,1490,1522,407,1837,768
561,431129,Poboleda,2014,361,195,166,42,217,102
562,081672,Polinyà,2014,8238,4172,4066,1810,5718,710
563,431135,"Pont d'Armentera, el",2014,561,289,272,68,350,143
564,250306,"Pont de Bar, el",2014,172,100,72,20,101,51
565,171352,Pont de Molins,2014,529,264,265,77,358,94
566,251734,"Pont de Suert, el",2014,2318,1172,1146,331,1523,464
567,081825,"Pont de Vilomara i Rocafort, el",2014,3780,1949,1831,652,2505,623
568,431418,Pontils,2014,123,68,55,9,84,30
569,081688,Pontons,2014,477,258,219,60,324,93
570,171365,Pontós,2014,223,126,97,30,142,51
571,251728,Ponts,2014,2701,1340,1361,409,1703,589
572,171371,Porqueres,2014,4529,2252,2277,819,2988,722
573,431140,Porrera,2014,461,253,208,37,308,116
574,171404,"Port de la Selva, el",2014,980,523,457,104,622,254
575,171387,Portbou,2014,1214,596,618,94,725,395
576,251749,"Portella, la",2014,750,415,335,96,518,136
577,431153,Pradell de la Teixeta,2014,181,81,100,19,115,47
578,431166,Prades,2014,626,321,305,74,398,154
579,431172,Prat de Comte,2014,164,88,76,17,96,51
580,081691,"Prat de Llobregat, el",2014,62866,30916,31950,9966,42044,10856
581,431188,Pratdip,2014,685,368,317,80,394,211
582,081712,Prats de Lluçanès,2014,2624,1314,1310,325,1722,577
583,081705,"Prats de Rei, els",2014,537,281,256,60,352,125
584,251752,Prats i Sansor,2014,248,129,119,26,175,47
585,251765,Preixana,2014,405,202,203,50,221,134
586,251771,Preixens,2014,450,229,221,49,248,153
587,082303,Premià de Dalt,2014,10311,5171,5140,1735,6982,1594
588,081727,Premià de Mar,2014,28163,13820,14343,4401,18844,4918
589,171390,"Preses, les",2014,1772,884,888,319,1152,301
590,251790,Prullans,2014,209,104,105,19,130,60
591,171411,Puigcerdà,2014,8761,4379,4382,1446,5979,1336
592,081748,Puigdàlber,2014,532,262,270,92,345,95
593,251804,Puiggròs,2014,296,160,136,41,183,72
594,431191,Puigpelat,2014,1083,563,520,224,744,115
595,081751,Puig-reig,2014,4207,2040,2167,516,2600,1091
596,251811,Puigverd d'Agramunt,2014,259,150,109,32,167,60
597,251826,Puigverd de Lleida,2014,1411,727,684,228,905,278
598,081764,Pujalt,2014,198,109,89,28,121,49
599,081770,"Quar, la",2014,57,32,25,5,38,14
600,171426,Quart,2014,3441,1724,1717,698,2326,417
601,170433,Queralbs,2014,182,106,76,10,117,55
602,431205,Querol,2014,550,305,245,64,376,110
603,171432,Rabós,2014,182,89,93,23,108,51
604,081786,Rajadell,2014,528,269,259,71,348,109
605,431212,Rasquera,2014,858,430,428,88,509,261
606,171447,Regencós,2014,291,154,137,47,178,66
607,081799,Rellinars,2014,726,375,351,119,509,98
608,431227,Renau,2014,141,71,70,30,97,14
609,431233,Reus,2014,104962,51081,53881,18500,69794,16668
610,251832,Rialp,2014,667,349,318,88,478,101
611,431248,"Riba, la",2014,601,321,280,70,381,150
612,431251,Riba-roja d'Ebre,2014,1195,632,563,103,747,345
613,259059,Ribera d'Ondara,2014,420,219,201,48,259,113
614,251850,Ribera d'Urgellet,2014,963,504,459,148,634,181
615,171450,Ribes de Freser,2014,1859,916,943,197,1131,531
616,171463,Riells i Viabrea,2014,4000,2063,1937,745,2784,471
617,431264,"Riera de Gaià, la",2014,1678,845,833,352,1072,254
618,251863,Riner,2014,281,137,144,39,173,69
619,171479,Ripoll,2014,10751,5303,5448,1446,6927,2378
620,081803,Ripollet,2014,37233,18402,18831,6969,25098,5166
621,259139,Riu de Cerdanya,2014,106,60,46,6,83,17
622,171485,Riudarenes,2014,2148,1109,1039,358,1417,373
623,171498,Riudaura,2014,463,222,241,73,299,91
624,431270,Riudecanyes,2014,1142,594,548,201,722,219
625,431286,Riudecols,2014,1254,654,600,165,857,232
626,171501,Riudellots de la Selva,2014,2026,1020,1006,338,1381,307
627,431299,Riudoms,2014,6546,3360,3186,1159,4208,1179
628,171518,Riumors,2014,244,125,119,33,157,54
629,081810,"Roca del Vallès, la",2014,10518,5289,5229,2051,7025,1442
630,431303,Rocafort de Queralt,2014,256,135,121,25,152,79
631,431310,Roda de Berà,2014,6322,3272,3050,1034,4132,1156
632,081831,Roda de Ter,2014,6124,3002,3122,1019,4002,1103
633,431325,Rodonyà,2014,513,269,244,81,329,103
634,431331,Roquetes,2014,8287,4281,4006,1355,5551,1381
635,171523,Roses,2014,19600,9795,9805,3408,13025,3167
636,251898,Rosselló,2014,3021,1543,1478,503,2087,431
637,431346,"Rourell, el",2014,394,200,194,67,257,70
638,081846,Rubí,2014,74353,36911,37442,13072,50968,10313
639,081859,Rubió,2014,228,123,105,29,149,50
640,171539,Rupià,2014,246,127,119,34,159,53
641,089019,Rupit i Pruit,2014,300,155,145,26,198,76
642,081878,Sabadell,2014,207444,100979,106465,33754,136406,37284
643,081884,Sagàs,2014,149,80,69,31,89,29
644,251902,Salàs de Pallars,2014,365,192,173,34,229,102
645,081901,Saldes,2014,283,158,125,15,197,71
646,171544,Sales de Llierca,2014,133,66,67,22,94,17
647,081918,Sallent,2014,6780,3258,3522,941,4165,1674
648,431359,Salomó,2014,539,284,255,94,320,125
649,439057,Salou,2014,26558,13982,12576,4084,19665,2809
650,171557,Salt,2014,30103,15921,14182,6169,20446,3488
651,251919,Sanaüja,2014,423,219,204,51,252,120
652,081944,Sant Adrià de Besòs,2014,35386,17410,17976,6062,23167,6157
653,081957,Sant Agustí de Lluçanès,2014,91,46,45,6,64,21
654,081960,Sant Andreu de la Barca,2014,27268,13666,13602,5465,18306,3497
655,081976,Sant Andreu de Llavaneres,2014,10590,5197,5393,1929,7043,1618
656,171576,Sant Andreu Salou,2014,155,80,75,21,96,38
657,171833,Sant Aniol de Finestres,2014,351,189,162,48,234,69
658,081982,Sant Antoni de Vilamajor,2014,5708,2862,2846,988,3943,777
659,081995,Sant Bartomeu del Grau,2014,875,448,427,111,621,143
660,082009,Sant Boi de Llobregat,2014,83107,40956,42151,13213,55485,14409
661,082016,Sant Boi de Lluçanès,2014,556,271,285,60,344,152
662,431362,Sant Carles de la Ràpita,2014,15003,7392,7611,2218,9699,3086
663,082037,Sant Cebrià de Vallalta,2014,3328,1729,1599,656,2260,412
664,082021,Sant Celoni,2014,17251,8555,8696,3043,11359,2849
665,082042,Sant Climent de Llobregat,2014,3938,1973,1965,787,2660,491
666,171582,Sant Climent Sescebes,2014,590,333,257,68,391,131
667,082055,Sant Cugat del Vallès,2014,87118,42428,44690,17821,58741,10556
668,082068,Sant Cugat Sesgarrigues,2014,972,481,491,169,603,200
669,251961,Sant Esteve de la Sarga,2014,132,79,53,8,85,39
670,082074,Sant Esteve de Palautordera,2014,2532,1232,1300,538,1679,315
671,082080,Sant Esteve Sesrovires,2014,7542,3755,3787,1404,5041,1097
672,171595,Sant Feliu de Buixalleu,2014,776,402,374,105,526,145
673,082107,Sant Feliu de Codines,2014,5900,2972,2928,1055,3907,938
674,171609,Sant Feliu de Guíxols,2014,21810,10791,11019,3436,14386,3988
675,082114,Sant Feliu de Llobregat,2014,43715,21288,22427,7362,28983,7370
676,171616,Sant Feliu de Pallerols,2014,1353,660,693,220,849,284
677,082129,Sant Feliu Sasserra,2014,626,323,303,85,402,139
678,171621,Sant Ferriol,2014,240,134,106,43,159,38
679,082093,Sant Fost de Campsentelles,2014,8666,4322,4344,1399,5772,1495
680,082135,Sant Fruitós de Bages,2014,8243,4121,4122,1535,5557,1151
681,171637,Sant Gregori,2014,3464,1745,1719,664,2301,499
682,251924,Sant Guim de Freixenet,2014,1107,575,532,164,689,254
683,251977,Sant Guim de la Plana,2014,175,93,82,24,99,52
684,171642,Sant Hilari Sacalm,2014,5681,2895,2786,857,3728,1096
685,082153,Sant Hipòlit de Voltregà,2014,3446,1712,1734,557,2245,644
686,081939,Sant Iscle de Vallalta,2014,1304,677,627,250,856,198
687,439023,Sant Jaume d'Enveja,2014,3555,1806,1749,513,2199,843
688,082166,Sant Jaume de Frontanyà,2014,24,15,9,2,15,7
689,171655,Sant Jaume de Llierca,2014,812,398,414,96,506,210
690,431378,Sant Jaume dels Domenys,2014,2493,1279,1214,462,1638,393
691,171674,Sant Joan de les Abadesses,2014,3413,1693,1720,411,2096,906
692,171680,Sant Joan de Mollet,2014,509,248,261,78,336,95
693,082188,Sant Joan de Vilatorrada,2014,10733,5376,5357,1813,7036,1884
694,082172,Sant Joan Despí,2014,32981,16108,16873,5899,21921,5161
695,171851,Sant Joan les Fonts,2014,2919,1442,1477,384,1855,680
696,171668,Sant Jordi Desvalls,2014,708,342,366,104,453,151
697,089030,Sant Julià de Cerdanyola,2014,239,134,105,26,153,60
698,171693,Sant Julià de Ramis,2014,3434,1730,1704,712,2294,428
699,082205,Sant Julià de Vilatorta,2014,3123,1532,1591,574,2073,476
700,179032,Sant Julià del Llor i Bonmatí,2014,1264,650,614,234,844,186
701,082212,Sant Just Desvern,2014,16389,7800,8589,2737,10697,2955
702,082227,Sant Llorenç d'Hortons,2014,2517,1260,1257,483,1694,340
703,171714,Sant Llorenç de la Muga,2014,249,130,119,37,162,50
704,251930,Sant Llorenç de Morunys,2014,993,492,501,123,598,272
705,082233,Sant Llorenç Savall,2014,2361,1188,1173,350,1504,507
706,082251,Sant Martí d'Albars,2014,106,54,52,12,64,30
707,082248,Sant Martí de Centelles,2014,1093,558,535,171,771,151
708,171729,Sant Martí de Llémena,2014,626,335,291,107,432,87
709,259025,Sant Martí de Riucorb,2014,685,361,324,78,389,218
710,082264,Sant Martí de Tous,2014,1175,593,582,249,696,230
711,082270,Sant Martí Sarroca,2014,3130,1537,1593,526,2033,571
712,082286,Sant Martí Sesgueioles,2014,395,200,195,62,257,76
713,171735,Sant Martí Vell,2014,242,128,114,38,154,50
714,082299,Sant Mateu de Bages,2014,644,332,312,67,376,201
715,171740,Sant Miquel de Campmajor,2014,232,123,109,27,149,56
716,171753,Sant Miquel de Fluvià,2014,798,410,388,107,556,135
717,171766,Sant Mori,2014,177,97,80,25,121,31
718,171772,Sant Pau de Segúries,2014,674,333,341,81,418,175
719,082310,Sant Pere de Ribes,2014,29339,14704,14635,5343,20169,3827
720,082325,Sant Pere de Riudebitlles,2014,2364,1187,1177,442,1431,491
721,082331,Sant Pere de Torelló,2014,2436,1267,1169,353,1601,482
722,082346,Sant Pere de Vilamajor,2014,4248,2120,2128,853,2810,585
723,171788,Sant Pere Pescador,2014,2138,1142,996,343,1467,328
724,081897,Sant Pere Sallavinera,2014,162,90,72,26,94,42
725,082359,Sant Pol de Mar,2014,4997,2504,2493,791,3229,977
726,082362,Sant Quintí de Mediona,2014,2101,1065,1036,380,1292,429
727,082378,Sant Quirze de Besora,2014,2148,1054,1094,291,1288,569
728,082384,Sant Quirze del Vallès,2014,19549,9565,9984,3898,13416,2235
729,082397,Sant Quirze Safaja,2014,644,345,299,137,436,71
730,251945,Sant Ramon,2014,496,266,230,47,302,147
731,082401,Sant Sadurní d'Anoia,2014,12590,6159,6431,2250,8362,1978
732,082418,Sant Sadurní d'Osormort,2014,86,50,36,7,59,20
733,080983,Sant Salvador de Guardiola,2014,3130,1594,1536,581,2018,531
734,082628,Sant Vicenç de Castellet,2014,9326,4634,4692,1473,6157,1696
735,082649,Sant Vicenç de Montalt,2014,6007,3044,2963,1239,3945,823
736,082652,Sant Vicenç de Torelló,2014,1975,975,1000,324,1267,384
737,082634,Sant Vicenç dels Horts,2014,28103,14039,14064,4843,19091,4169
738,431384,Santa Bàrbara,2014,3821,1950,1871,577,2415,829
739,082439,Santa Cecília de Voltregà,2014,173,91,82,14,121,38
740,082444,Santa Coloma de Cervelló,2014,8038,3948,4090,1799,5300,939
741,171805,Santa Coloma de Farners,2014,12601,6393,6208,2231,8412,1958
742,082457,Santa Coloma de Gramenet,2014,118738,59520,59218,18358,78081,22299
743,431397,Santa Coloma de Queralt,2014,2931,1448,1483,493,1800,638
744,171812,Santa Cristina d'Aro,2014,5194,2630,2564,905,3471,818
745,082460,Santa Eugènia de Berga,2014,2233,1143,1090,306,1568,359
746,082476,Santa Eulàlia de Riuprimer,2014,1259,637,622,236,839,184
747,082482,Santa Eulàlia de Ronçana,2014,7114,3577,3537,1331,4639,1144
748,082495,Santa Fe del Penedès,2014,379,189,190,74,256,49
749,171827,Santa Llogaia d'Àlguema,2014,341,188,153,52,248,41
750,082508,Santa Margarida de Montbui,2014,9641,4802,4839,1739,6378,1524
751,082515,Santa Margarida i els Monjos,2014,7337,3741,3596,1491,4924,922
752,082589,Santa Maria d'Oló,2014,1065,546,519,155,669,241
753,082536,Santa Maria de Besora,2014,162,83,79,18,95,49
754,082567,Santa Maria de Martorelles,2014,851,423,428,146,580,125
755,082554,Santa Maria de Merlès,2014,177,89,88,34,114,29
756,082573,Santa Maria de Miralles,2014,140,71,69,19,89,32
757,082592,Santa Maria de Palautordera,2014,9138,4640,4498,1614,6167,1357
758,431401,Santa Oliva,2014,3287,1667,1620,592,2144,551
759,171848,Santa Pau,2014,1567,792,775,208,1047,312
760,082606,Santa Perpètua de Mogoda,2014,25409,12907,12502,4926,17186,3297
761,082613,Santa Susanna,2014,3293,1662,1631,567,2218,508
762,081923,Santpedor,2014,7384,3691,3693,1346,4905,1133
763,431423,Sarral,2014,1595,830,765,261,1008,326
764,171864,Sarrià de Ter,2014,4937,2463,2474,809,3293,835
765,252017,Sarroca de Bellera,2014,124,73,51,2,82,40
766,252000,Sarroca de Lleida,2014,403,220,183,29,242,132
767,171870,"Saus, Camallera i Llampaies",2014,815,402,413,122,524,169
768,431439,Savallà del Comtat,2014,65,30,35,3,42,20
769,431444,"Secuita, la",2014,1665,837,828,295,1127,243
770,171886,"Selva de Mar, la",2014,181,102,79,11,122,48
771,431457,"Selva del Camp, la",2014,5598,2818,2780,1003,3772,823
772,431460,Senan,2014,53,33,20,6,34,13
773,430445,"Sénia, la",2014,5893,2984,2909,914,3896,1083
774,252022,Senterada,2014,131,77,54,7,103,21
775,250352,"Sentiu de Sió, la",2014,467,235,232,48,293,126
776,082671,Sentmenat,2014,8645,4378,4267,1590,5966,1089
777,171903,Serinyà,2014,1123,572,551,202,724,197
778,252043,Seròs,2014,1887,1032,855,252,1197,438
779,171910,Serra de Daró,2014,211,115,96,34,127,50
780,171925,Setcases,2014,195,108,87,14,134,47
781,252038,"Seu d'Urgell, la",2014,12366,5968,6398,1890,8292,2184
782,082690,Seva,2014,3488,1782,1706,607,2279,602
783,252056,Sidamon,2014,706,371,335,115,476,115
784,171931,Sils,2014,5851,2968,2883,1046,3901,904
785,082704,Sitges,2014,28171,14029,14142,4296,19229,4646
786,170524,Siurana,2014,150,74,76,16,93,41
787,082711,Sobremunt,2014,83,36,47,8,54,21
788,252069,"Soleràs, el",2014,359,185,174,48,195,116
789,431476,Solivella,2014,653,330,323,96,378,179
790,252075,Solsona,2014,9067,4531,4536,1527,5896,1644
791,082726,Sora,2014,175,97,78,21,121,33
792,252081,Soriguera,2014,377,199,178,43,260,74
793,252094,Sort,2014,2237,1113,1124,363,1485,389
794,252108,Soses,2014,1754,916,838,285,1141,328
795,082732,Subirats,2014,3029,1555,1474,496,1953,580
796,252115,Sudanell,2014,872,485,387,99,574,199
797,252120,Sunyer,2014,307,163,144,27,199,81
798,082747,Súria,2014,5999,2891,3108,792,3813,1394
799,171946,Susqueda,2014,95,58,37,7,62,26
800,082763,Tagamanent,2014,322,174,148,60,215,47
801,082779,Talamanca,2014,141,80,61,19,90,32
802,252154,Talarn,2014,413,216,197,48,276,89
803,252167,Talavera,2014,267,148,119,28,154,85
804,171959,"Tallada d'Empordà, la",2014,454,236,218,67,288,99
805,082785,Taradell,2014,6219,3123,3096,1068,4065,1086
806,431482,Tarragona,2014,132199,64652,67547,21749,88330,22120
807,252173,Tàrrega,2014,16587,8256,8331,3022,11059,2506
808,252189,Tarrés,2014,105,62,43,13,64,28
809,252192,Tarroja de Segarra,2014,173,90,83,18,110,45
810,082750,Tavèrnoles,2014,317,160,157,46,217,54
811,082802,Tavertet,2014,125,70,55,14,86,25
812,082819,Teià,2014,6141,3053,3088,975,4066,1100
813,252206,Térmens,2014,1536,769,767,174,1023,339
814,171962,Terrades,2014,288,141,147,41,190,57
815,082798,Terrassa,2014,215517,106429,109088,38080,143399,34038
816,082824,Tiana,2014,8314,3980,4334,1470,5674,1170
817,252213,Tírvia,2014,156,76,80,17,101,38
818,252228,Tiurana,2014,76,36,40,7,45,24
819,431495,Tivenys,2014,876,449,427,96,502,278
820,431508,Tivissa,2014,1760,871,889,208,1073,479
821,082830,Tona,2014,8012,3927,4085,1434,5227,1351
822,252234,Torà,2014,1202,603,599,135,803,264
823,082845,Tordera,2014,16345,8267,8078,2883,10781,2681
824,082858,Torelló,2014,13949,6856,7093,2230,9252,2467
825,252249,"Torms, els",2014,148,81,67,14,76,58
826,252252,Tornabous,2014,911,487,424,126,553,232
827,252271,"Torre de Cabdella, la",2014,761,390,371,60,491,210
828,082861,"Torre de Claramunt, la",2014,3819,1968,1851,687,2620,512
829,431515,"Torre de Fontaubella, la",2014,126,67,59,14,75,37
830,431520,"Torre de l'Espanyol, la",2014,676,351,325,98,401,177
831,252265,Torrebesses,2014,291,152,139,25,173,93
832,431536,Torredembarra,2014,15475,7622,7853,2471,10354,2650
833,252287,Torrefarrera,2014,4512,2268,2244,952,3101,459
834,259078,Torrefeta i Florejacs,2014,601,315,286,65,357,179
835,252304,Torregrossa,2014,2235,1133,1102,295,1408,532
836,252311,Torrelameu,2014,709,400,309,86,470,153
837,082877,Torrelavit,2014,1393,736,657,234,914,245
838,082883,Torrelles de Foix,2014,2308,1206,1102,368,1504,436
839,082896,Torrelles de Llobregat,2014,5851,2895,2956,1201,3991,659
840,171978,Torrent,2014,170,89,81,20,108,42
841,252326,Torres de Segre,2014,2301,1184,1117,279,1578,444
842,252332,Torre-serona,2014,388,197,191,53,236,99
843,171984,Torroella de Fluvià,2014,704,362,342,101,490,113
844,171997,Torroella de Montgrí,2014,11381,5784,5597,1896,7567,1918
845,431541,Torroja del Priorat,2014,160,89,71,11,97,52
846,172001,Tortellà,2014,772,370,402,106,483,183
847,431554,Tortosa,2014,33932,16997,16935,5147,22198,6587
848,172018,Toses,2014,150,89,61,16,98,36
849,172023,Tossa de Mar,2014,5681,2897,2784,780,3878,1023
850,252347,Tremp,2014,6305,3145,3160,894,4040,1371
851,172044,Ullà,2014,1053,585,468,191,713,149
852,082900,Ullastrell,2014,2056,1027,1029,467,1322,267
853,172057,Ullastret,2014,289,143,146,58,182,49
854,431567,Ulldecona,2014,6904,3551,3353,1097,4520,1287
855,431573,Ulldemolins,2014,412,230,182,29,242,141
856,172039,Ultramort,2014,204,111,93,31,122,51
857,172060,Urús,2014,185,89,96,25,126,34
858,082917,Vacarisses,2014,6218,3215,3003,1380,4109,729
859,170144,"Vajol, la",2014,86,48,38,9,64,13
860,172076,"Vall d'en Bas, la",2014,2965,1485,1480,482,1907,576
861,172082,"Vall de Bianya, la",2014,1305,657,648,217,858,230
862,250432,"Vall de Boí, la",2014,992,528,464,110,716,166
863,259010,Vall de Cardós,2014,384,210,174,49,252,83
864,082922,Vallbona d'Anoia,2014,1424,735,689,233,936,255
865,252385,Vallbona de les Monges,2014,262,138,124,26,150,86
866,082938,Vallcebre,2014,258,146,112,24,159,75
867,431589,Vallclara,2014,116,64,52,16,71,29
868,252402,Vallfogona de Balaguer,2014,1888,930,958,300,1279,309
869,171707,Vallfogona de Ripollès,2014,215,116,99,22,133,60
870,431592,Vallfogona de Riucorb,2014,99,59,40,2,61,36
871,082943,Vallgorguina,2014,2699,1381,1318,558,1837,304
872,082956,Vallirana,2014,14612,7301,7311,2794,9598,2220
873,172095,Vall-llobrega,2014,901,457,444,190,614,97
874,431606,Vallmoll,2014,1670,854,816,268,1136,266
875,082969,Vallromanes,2014,2519,1270,1249,561,1668,290
876,431613,Valls,2014,24570,12263,12307,4114,16253,4203
877,259062,"Valls d'Aguilar, les",2014,298,156,142,29,184,85
878,252398,"Valls de Valira, les",2014,849,429,420,92,600,157
879,431628,Vandellòs i l'Hospitalet de l'Infant,2014,6047,3011,3036,999,4069,979
880,259097,"Vansa i Fórnols, la",2014,210,110,100,14,135,61
881,082975,Veciana,2014,176,102,74,30,97,49
882,431634,"Vendrell, el",2014,36719,18345,18374,6432,24389,5898
883,172109,Ventalló,2014,836,439,397,137,534,165
884,252424,Verdú,2014,964,457,507,111,559,294
885,172116,Verges,2014,1195,572,623,178,751,266
886,431649,Vespella de Gaià,2014,417,222,195,66,274,77
887,082981,Vic,2014,41956,20822,21134,7694,27744,6518
888,172121,Vidrà,2014,169,87,82,25,115,29
889,172137,Vidreres,2014,7702,3981,3721,1332,5157,1213
890,252430,Vielha e Mijaran,2014,5474,2764,2710,817,4051,606
891,431652,Vilabella,2014,805,416,389,107,508,190
892,172142,Vilabertran,2014,913,468,445,153,578,182
893,172155,Vilablareix,2014,2529,1250,1279,425,1784,320
894,082994,Vilada,2014,443,233,210,28,278,137
895,172174,Viladamat,2014,440,227,213,59,281,100
896,172168,Viladasens,2014,216,112,104,34,144,38
897,083015,Viladecans,2014,65358,32458,32900,11863,44043,9452
898,083008,Viladecavalls,2014,7395,3705,3690,1330,5211,854
899,172180,Vilademuls,2014,787,408,379,130,485,172
900,172207,Viladrau,2014,1037,527,510,154,687,196
901,172214,Vilafant,2014,5481,2694,2787,936,3732,813
902,083054,Vilafranca del Penedès,2014,39221,19306,19915,6934,25973,6314
903,252445,Vilagrassa,2014,514,267,247,88,332,94
904,172235,Vilajuïga,2014,1190,590,600,211,763,216
905,431750,Vilalba dels Arcs,2014,682,352,330,68,389,225
906,083067,Vilalba Sasserra,2014,706,347,359,144,454,108
907,252458,Vilaller,2014,563,304,259,67,381,115
908,172240,Vilallonga de Ter,2014,421,219,202,45,263,113
909,431665,Vilallonga del Camp,2014,2229,1138,1091,434,1509,286
910,172253,Vilamacolum,2014,307,163,144,41,199,67
911,172266,Vilamalla,2014,1103,573,530,170,752,181
912,172272,Vilamaniscle,2014,170,94,76,36,109,25
913,252477,Vilamòs,2014,171,95,76,24,129,18
914,172288,Vilanant,2014,399,199,200,76,258,65
915,431671,Vilanova d'Escornalbou,2014,540,292,248,83,351,106
916,252483,Vilanova de Bellpuig,2014,1179,603,576,161,683,335
917,252496,Vilanova de l'Aguda,2014,228,112,116,23,132,73
918,252542,Vilanova de la Barca,2014,1120,563,557,146,726,248
919,252509,Vilanova de Meià,2014,422,224,198,39,252,131
920,431687,Vilanova de Prades,2014,126,63,63,17,75,34
921,083036,Vilanova de Sau,2014,314,156,158,27,216,71
922,252516,Vilanova de Segrià,2014,930,487,443,116,637,177
923,083020,Vilanova del Camí,2014,12506,6284,6222,2326,8368,1812
924,089024,Vilanova del Vallès,2014,5250,2671,2579,1203,3503,544
925,083073,Vilanova i la Geltrú,2014,65941,32069,33872,10439,44093,11409
926,431690,Vilaplana,2014,630,325,305,68,436,126
927,431704,Vila-rodona,2014,1264,641,623,214,823,227
928,172305,Vila-sacra,2014,681,327,354,122,431,128
929,252521,Vila-sana,2014,706,357,349,112,453,141
930,431711,Vila-seca,2014,21923,11118,10805,4031,15419,2473
931,082140,Vilassar de Dalt,2014,8882,4375,4507,1430,5882,1570
932,082191,Vilassar de Mar,2014,20185,9736,10449,3466,13321,3398
933,172229,Vilaür,2014,153,75,78,35,84,34
934,431726,Vilaverd,2014,487,252,235,86,301,100
935,431732,"Vilella Alta, la",2014,129,70,59,18,74,37
936,431747,"Vilella Baixa, la",2014,202,107,95,32,116,54
937,172333,Vilobí d'Onyar,2014,3136,1640,1496,554,2056,526
938,083041,Vilobí del Penedès,2014,1090,553,537,186,698,206
939,172327,Vilopriu,2014,209,114,95,34,129,46
940,252537,"Vilosell, el",2014,188,92,96,10,112,66
941,431763,Vimbodí i Poblet,2014,964,539,425,116,570,278
942,252555,Vinaixa,2014,546,278,268,58,334,154
943,431779,Vinebre,2014,449,228,221,66,282,101
944,431785,Vinyols i els Arcs,2014,1872,960,912,326,1264,282
945,083089,Viver i Serrateix,2014,174,91,83,30,99,45
946,430521,Xerta,2014,1250,606,644,150,775,325
947,000000,Catalunya,2014,7518903,3701740,3817163,1185386,4996234,1337283
0,250019,Abella de la Conca,2015,170,93,77,19,106,45
1,080018,Abrera,2015,12071,6118,5953,2315,8078,1678
2,250024,Àger,2015,613,325,288,54,380,179
3,250030,Agramunt,2015,5491,2775,2716,902,3584,1005
4,080023,Aguilar de Segarra,2015,246,131,115,36,154,56
5,170010,Agullana,2015,828,418,410,120,522,186
6,080142,Aiguafreda,2015,2465,1175,1290,361,1573,531
7,430017,Aiguamúrcia,2015,912,486,426,121,591,200
8,170025,Aiguaviva,2015,775,391,384,167,488,120
9,250387,Aitona,2015,2456,1249,1207,372,1509,575
10,250045,"Alamús, els",2015,778,404,374,99,507,172
11,250058,Alàs i Cerc,2015,356,182,174,44,215,97
12,250061,"Albagés, l'",2015,419,222,197,34,257,128
13,170031,Albanyà,2015,149,85,64,29,104,16
14,250077,Albatàrrec,2015,2214,1156,1058,343,1614,257
15,250083,Albesa,2015,1624,874,750,238,1043,343
16,250096,"Albi, l'",2015,819,426,393,126,467,226
17,430022,Albinyana,2015,2320,1171,1149,343,1491,486
18,430038,"Albiol, l'",2015,448,228,220,91,293,64
19,170046,Albons,2015,745,382,363,136,475,134
20,430043,Alcanar,2015,9603,4863,4740,1355,6264,1984
21,250100,Alcanó,2015,246,123,123,28,141,77
22,250117,Alcarràs,2015,9372,4863,4509,1683,6555,1134
23,250122,Alcoletge,2015,3285,1716,1569,548,2344,393
24,430056,Alcover,2015,5073,2535,2538,880,3348,845
25,439044,"Aldea, l'",2015,4245,2239,2006,605,2766,874
26,430069,Aldover,2015,918,459,459,108,527,283
27,430075,"Aleixar, l'",2015,885,448,437,150,569,166
28,080039,Alella,2015,9660,4726,4934,1561,6368,1731
29,430081,Alfara de Carles,2015,378,202,176,41,225,112
30,250138,Alfarràs,2015,2976,1558,1418,432,1890,654
31,250143,Alfés,2015,326,164,162,38,197,91
32,430094,Alforja,2015,1883,956,927,261,1239,383
33,250156,Algerri,2015,422,229,193,34,222,166
34,250169,Alguaire,2015,3002,1571,1431,443,1955,604
35,250175,Alins,2015,288,153,135,32,169,87
36,430108,Alió,2015,419,202,217,55,273,91
37,250194,Almacelles,2015,6766,3534,3232,997,4486,1283
38,250208,Almatret,2015,326,172,154,15,192,119
39,250215,Almenar,2015,3525,1879,1646,445,2311,769
40,430115,Almoster,2015,1410,702,708,238,986,186
41,250220,Alòs de Balaguer,2015,123,69,54,9,68,46
42,170062,Alp,2015,1595,835,760,229,1150,216
43,080044,Alpens,2015,290,156,134,45,191,54
44,250236,Alpicat,2015,6275,3146,3129,1197,4258,820
45,250241,Alt Àneu,2015,407,232,175,35,281,91
46,430120,Altafulla,2015,5052,2482,2570,909,3393,750
47,170078,Amer,2015,2250,1095,1155,299,1425,526
48,430136,"Ametlla de Mar, l'",2015,7183,3617,3566,1093,4480,1610
49,080057,"Ametlla del Vallès, l'",2015,8303,4178,4125,1549,5699,1055
50,439060,"Ampolla, l'",2015,3473,1766,1707,436,2223,814
51,430141,Amposta,2015,20952,10564,10388,3417,13898,3637
52,170084,Anglès,2015,5540,2748,2792,964,3540,1036
53,250273,Anglesola,2015,1378,688,690,209,828,341
54,250292,Arbeca,2015,2278,1156,1122,259,1411,608
55,430167,"Arboç, l'",2015,5513,2853,2660,1058,3617,838
56,430154,Arbolí,2015,123,71,52,7,88,28
57,170097,Arbúcies,2015,6297,3259,3038,1080,4127,1090
58,080060,Arenys de Mar,2015,15289,7491,7798,2273,9854,3162
59,080076,Arenys de Munt,2015,8736,4408,4328,1555,5775,1406
60,170101,Argelaguer,2015,412,221,191,49,271,92
61,080082,Argençola,2015,223,118,105,22,156,45
62,430173,"Argentera, l'",2015,147,82,65,8,101,38
63,080095,Argentona,2015,11978,5899,6079,2073,7902,2003
64,170118,"Armentera, l'",2015,907,451,456,146,560,201
65,430189,Arnes,2015,474,242,232,49,252,173
66,250313,Arres,2015,67,42,25,7,52,8
67,250328,Arsèguel,2015,79,46,33,14,53,12
68,080109,Artés,2015,5665,2861,2804,918,3801,946
69,250334,Artesa de Lleida,2015,1517,793,724,226,988,303
70,250349,Artesa de Segre,2015,3614,1840,1774,546,2321,747
71,430192,Ascó,2015,1682,877,805,185,1126,371
72,250365,Aspa,2015,218,110,108,18,132,68
73,250371,"Avellanes i Santa Linya, les",2015,473,269,204,49,273,151
74,080116,Avià,2015,2225,1102,1123,364,1410,451
75,080121,Avinyó,2015,2248,1112,1136,356,1394,498
76,170123,Avinyonet de Puigventós,2015,1565,795,770,324,1093,148
77,080137,Avinyonet del Penedès,2015,1652,863,789,270,1073,309
78,080155,Badalona,2015,215654,106424,109230,34375,143083,38196
79,089045,Badia del Vallès,2015,13502,6571,6931,2121,8838,2543
80,080168,Bagà,2015,2188,1080,1108,241,1422,525
81,250390,Baix Pallars,2015,350,187,163,44,228,78
82,250404,Balaguer,2015,16479,8323,8156,2826,10826,2827
83,080174,Balenyà,2015,3711,1863,1848,647,2485,579
84,080180,Balsareny,2015,3324,1636,1688,429,2189,706
85,430206,Banyeres del Penedès,2015,3103,1561,1542,589,2040,474
86,170157,Banyoles,2015,19299,9652,9647,3523,12560,3216
87,250411,Barbens,2015,900,477,423,116,549,235
88,430213,Barberà de la Conca,2015,505,267,238,71,318,116
89,082520,Barberà del Vallès,2015,32545,16091,16454,5647,22178,4720
90,080193,Barcelona,2015,1604555,759520,845035,201896,1055681,346978
91,250426,"Baronia de Rialb, la",2015,245,128,117,19,149,77
92,170160,Bàscara,2015,943,479,464,148,566,229
93,250447,Bassella,2015,234,117,117,25,144,65
94,430228,Batea,2015,1945,966,979,248,1143,554
95,250450,Bausen,2015,58,32,26,2,31,25
96,080207,Begues,2015,6670,3317,3353,1319,4600,751
97,170139,Begur,2015,3985,2019,1966,522,2670,793
98,250463,Belianes,2015,555,274,281,66,319,170
99,251706,Bellaguarda,2015,308,161,147,26,174,108
100,170182,Bellcaire d'Empordà,2015,652,316,336,98,407,147
101,250479,Bellcaire d'Urgell,2015,1296,659,637,176,781,339
102,250485,Bell-lloc d'Urgell,2015,2329,1156,1173,357,1488,484
103,250498,Bellmunt d'Urgell,2015,188,93,95,24,114,50
104,430234,Bellmunt del Priorat,2015,303,153,150,32,187,84
105,080214,Bellprat,2015,74,46,28,3,46,25
106,250501,Bellpuig,2015,4989,2590,2399,779,3324,886
107,430249,Bellvei,2015,2185,1140,1045,436,1374,375
108,250518,Bellver de Cerdanya,2015,2028,1051,977,294,1324,410
109,250523,Bellvís,2015,2270,1141,1129,315,1390,565
110,250539,Benavent de Segrià,2015,1506,780,726,273,1026,207
111,430252,Benifallet,2015,717,356,361,53,431,233
112,430265,Benissanet,2015,1251,683,568,148,813,290
113,080229,Berga,2015,16238,7952,8286,2333,10389,3516
114,170195,Besalú,2015,2437,1154,1283,393,1500,544
115,170209,Bescanó,2015,4807,2411,2396,967,3105,735
116,170216,Beuda,2015,193,100,93,32,126,35
117,080235,Bigues i Riells del Fai,2015,8858,4524,4334,1684,5944,1230
118,250557,Biosca,2015,199,104,95,14,116,69
119,170221,"Bisbal d'Empordà, la",2015,10759,5370,5389,1964,7082,1713
120,430271,"Bisbal de Falset, la",2015,221,120,101,28,125,68
121,430287,"Bisbal del Penedès, la",2015,3474,1838,1636,526,2252,696
122,172348,Biure,2015,242,129,113,27,156,59
123,430290,Blancafort,2015,413,211,202,49,258,106
124,170237,Blanes,2015,39132,19561,19571,5925,26302,6905
125,170293,Boadella i les Escaules,2015,261,134,127,34,178,49
126,170242,Bolvir,2015,380,195,185,61,245,74
127,430304,Bonastre,2015,641,329,312,124,424,93
128,250576,"Bòrdes, Es",2015,237,136,101,28,164,45
129,170255,Bordils,2015,1710,844,866,304,1127,279
130,250582,"Borges Blanques, les",2015,6019,3051,2968,927,3839,1253
131,430311,"Borges del Camp, les",2015,2087,1043,1044,393,1302,392
132,170268,Borrassà,2015,711,368,343,141,436,134
133,080240,Borredà,2015,503,280,223,43,330,130
134,250595,Bossòst,2015,1137,555,582,166,784,187
135,430326,Bot,2015,618,320,298,50,337,231
136,430332,Botarell,2015,1101,576,525,203,757,141
137,250560,Bovera,2015,275,152,123,18,144,113
138,430347,Bràfim,2015,665,334,331,108,407,150
139,170274,Breda,2015,3728,1862,1866,530,2395,803
140,080253,"Bruc, el",2015,2032,1097,935,407,1366,259
141,080266,"Brull, el",2015,254,138,116,53,162,39
142,170280,Brunyola i Sant Martí Sapresa,2015,394,199,195,56,242,96
143,430350,Cabacés,2015,330,166,164,46,194,90
144,250609,Cabanabona,2015,82,38,44,5,45,32
145,170314,Cabanelles,2015,237,130,107,36,145,56
146,170307,Cabanes,2015,931,499,432,145,589,197
147,080272,"Cabanyes, les",2015,967,501,466,203,640,124
148,250616,Cabó,2015,94,48,46,7,61,26
149,430363,Cabra del Camp,2015,1109,578,531,173,711,225
150,080288,Cabrera d'Anoia,2015,1348,715,633,229,916,203
151,080291,Cabrera de Mar,2015,4522,2277,2245,733,3083,706
152,080305,Cabrils,2015,7250,3590,3660,1420,4922,908
153,170329,Cadaqués,2015,2840,1371,1469,439,1919,482
154,080312,Calaf,2015,3426,1749,1677,574,2168,684
155,430379,Calafell,2015,24256,12191,12065,3831,16079,4346
156,080348,Calders,2015,968,496,472,160,638,170
157,080327,Caldes d'Estrac,2015,2717,1316,1401,401,1770,546
158,170335,Caldes de Malavella,2015,7166,3559,3607,1273,4726,1167
159,080333,Caldes de Montbui,2015,17098,8521,8577,2852,11310,2936
160,080351,Calella,2015,18226,8886,9340,2766,11838,3622
161,080370,Calldetenes,2015,2427,1240,1187,379,1679,369
162,080386,Callús,2015,2024,994,1030,374,1287,363
163,080364,Calonge de Segarra,2015,197,99,98,22,116,59
164,170340,Calonge i Sant Antoni,2015,10520,5272,5248,1579,6926,2015
165,250621,Camarasa,2015,903,461,442,87,559,257
166,439039,Camarles,2015,3476,1780,1696,534,2159,783
167,430385,Cambrils,2015,32915,16170,16745,5888,22185,4842
168,170353,Camós,2015,683,346,337,100,419,164
169,170366,Campdevànol,2015,3352,1653,1699,454,2017,881
170,170372,Campelles,2015,127,64,63,12,84,31
171,080399,Campins,2015,491,249,242,73,347,71
172,170388,Campllong,2015,499,247,252,115,325,59
173,170391,Camprodon,2015,2299,1126,1173,293,1434,572
174,250637,Canejan,2015,100,56,44,5,67,28
175,170405,Canet d'Adri,2015,671,340,331,112,434,125
176,080403,Canet de Mar,2015,14177,6884,7293,2308,9024,2845
177,439076,"Canonja, la",2015,5839,2891,2948,1056,3965,818
178,080410,Canovelles,2015,15906,8205,7701,2993,10649,2264
179,080425,Cànoves i Samalús,2015,2897,1473,1424,485,1917,495
180,170412,Cantallops,2015,328,166,162,45,207,76
181,080431,Canyelles,2015,4375,2235,2140,816,2991,568
182,430398,Capafonts,2015,111,58,53,9,71,31
183,430402,Capçanes,2015,413,204,209,47,246,120
184,080446,Capellades,2015,5268,2592,2676,815,3382,1071
185,170427,Capmany,2015,590,307,283,84,349,157
186,080459,Capolat,2015,92,44,48,18,60,14
187,080462,Cardedeu,2015,17938,8799,9139,3406,11910,2622
188,080478,Cardona,2015,4898,2404,2494,620,3007,1271
189,080484,Carme,2015,792,411,381,123,502,167
190,430419,Caseres,2015,258,131,127,19,152,87
191,170448,Cassà de la Selva,2015,10030,5132,4898,1729,6682,1619
192,080497,Casserres,2015,1541,764,777,175,973,393
193,080575,Castell de l'Areny,2015,73,41,32,7,53,13
194,259046,Castell de Mur,2015,188,101,87,17,113,58
195,250642,Castellar de la Ribera,2015,150,76,74,29,83,38
196,080522,Castellar de n'Hug,2015,159,86,73,12,109,38
197,080500,Castellar del Riu,2015,175,96,79,28,106,41
198,080517,Castellar del Vallès,2015,23442,11561,11881,4275,15712,3455
199,080538,Castellbell i el Vilar,2015,3566,1820,1746,599,2282,685
200,080543,Castellbisbal,2015,12364,6272,6092,2479,8364,1521
201,080556,Castellcir,2015,694,345,349,124,458,112
202,250674,Castelldans,2015,981,534,447,114,637,230
203,080569,Castelldefels,2015,63891,31500,32391,11106,44060,8725
204,080581,Castellet i la Gornal,2015,2212,1115,1097,316,1456,440
205,170464,Castellfollit de la Roca,2015,992,498,494,153,597,242
206,080608,Castellfollit de Riubregós,2015,167,96,71,13,110,44
207,080594,Castellfollit del Boix,2015,434,220,214,67,283,84
208,080615,Castellgalí,2015,1996,1044,952,367,1301,328
209,080620,Castellnou de Bages,2015,1266,638,628,270,827,169
210,250680,Castellnou de Seana,2015,736,391,345,101,444,191
211,170470,Castelló d'Empúries,2015,10870,5502,5368,1745,7214,1911
212,250693,Castelló de Farfanya,2015,547,294,253,68,317,162
213,080636,Castellolí,2015,574,280,294,103,375,96
214,170486,Castell-Platja d'Aro,2015,10589,5251,5338,1531,7234,1824
215,250707,Castellserà,2015,1044,530,514,124,627,293
216,080641,Castellterçol,2015,2368,1192,1176,350,1488,530
217,430424,Castellvell del Camp,2015,2897,1448,1449,563,1993,341
218,080654,Castellví de la Marca,2015,1540,769,771,247,966,327
219,080667,Castellví de Rosanes,2015,1771,868,903,292,1198,281
220,430430,"Catllar, el",2015,4215,2176,2039,723,2943,549
221,250714,Cava,2015,60,35,25,5,36,19
222,171899,"Cellera de Ter, la",2015,2071,1028,1043,324,1300,447
223,170499,Celrà,2015,5155,2591,2564,1110,3556,489
224,080673,Centelles,2015,7372,3601,3771,1252,4747,1373
225,082687,Cercs,2015,1209,602,607,120,735,354
226,082665,Cerdanyola del Vallès,2015,57413,28124,29289,8802,39048,9563
227,080689,Cervelló,2015,8851,4426,4425,1538,5982,1331
228,250729,Cervera,2015,8956,4483,4473,1615,5847,1494
229,250735,Cervià de les Garrigues,2015,695,364,331,77,404,214
230,170502,Cervià de Ter,2015,926,468,458,178,569,179
231,170519,Cistella,2015,303,146,157,52,188,63
232,250740,Ciutadilla,2015,217,117,100,23,129,65
233,250753,Clariana de Cardener,2015,140,71,69,18,97,25
234,250766,"Cogul, el",2015,181,97,84,10,109,62
235,170545,Colera,2015,533,270,263,48,341,144
236,250772,Coll de Nargó,2015,575,293,282,62,374,139
237,080692,Collbató,2015,4389,2263,2126,972,2903,514
238,430458,Colldejou,2015,172,94,78,15,118,39
239,080706,Collsuspina,2015,343,181,162,64,215,64
240,170558,Colomers,2015,189,91,98,23,116,50
241,251636,"Coma i la Pedra, la",2015,270,165,105,28,197,45
242,251615,Conca de Dalt,2015,446,233,213,52,271,123
243,430461,Conesa,2015,120,58,62,7,83,30
244,430477,Constantí,2015,6416,3337,3079,1223,4300,893
245,080713,Copons,2015,307,157,150,56,183,68
246,430483,Corbera d'Ebre,2015,1095,572,523,138,674,283
247,080728,Corbera de Llobregat,2015,14240,7127,7113,2669,9681,1890
248,250788,Corbins,2015,1394,744,650,218,893,283
249,170577,Corçà,2015,1244,628,616,197,783,264
250,080734,Cornellà de Llobregat,2015,86376,42093,44283,13306,56018,17052
251,170561,Cornellà del Terri,2015,2236,1147,1089,353,1428,455
252,430496,Cornudella de Montsant,2015,981,539,442,105,648,228
253,430509,Creixell,2015,3492,1771,1721,544,2183,765
254,170583,Crespià,2015,256,133,123,48,156,52
255,179011,"Cruïlles, Monells i Sant Sadurní de l'Heura",2015,1304,664,640,199,878,227
256,080749,Cubelles,2015,14420,7325,7095,2571,9582,2267
257,250791,Cubells,2015,378,200,178,27,235,116
258,430516,Cunit,2015,11883,5889,5994,1908,7435,2540
259,170600,Darnius,2015,554,282,272,55,351,148
260,170617,Das,2015,222,122,100,45,136,41
261,439018,Deltebre,2015,11676,5901,5775,1690,7474,2512
262,080752,Dosrius,2015,5215,2644,2571,998,3561,656
263,430537,Duesaigües,2015,236,128,108,23,155,58
264,170622,"Escala, l'",2015,10276,5210,5066,1436,6728,2112
265,080765,Esparreguera,2015,21701,10975,10726,3717,14709,3275
266,170638,Espinelves,2015,196,95,101,30,121,45
267,250812,"Espluga Calba, l'",2015,387,192,195,44,213,130
268,430542,"Espluga de Francolí, l'",2015,3818,1846,1972,532,2460,826
269,080771,Esplugues de Llobregat,2015,45626,21965,23661,6279,29479,9868
270,170643,Espolla,2015,415,205,210,49,252,114
271,170656,Esponellà,2015,444,221,223,81,270,93
272,250827,Espot,2015,362,196,166,46,250,66
273,080787,"Espunyola, l'",2015,252,129,123,25,161,66
274,082541,"Esquirol, l'",2015,2150,1077,1073,297,1378,475
275,250886,Estamariu,2015,124,71,53,20,61,43
276,080790,"Estany, l'",2015,398,199,199,45,244,109
277,250851,Estaràs,2015,176,95,81,17,111,48
278,250864,Esterri d'Àneu,2015,804,386,418,106,570,128
279,250870,Esterri de Cardós,2015,73,35,38,9,53,11
280,430555,Falset,2015,2867,1435,1432,465,1804,598
281,170059,"Far d'Empordà, el",2015,552,279,273,109,349,94
282,250899,Farrera,2015,118,69,49,14,80,24
283,430568,"Fatarella, la",2015,1028,512,516,105,577,346
284,430574,"Febró, la",2015,39,28,11,1,28,10
285,081347,Figaró-Montmany,2015,1094,549,545,167,701,226
286,080804,Fígols,2015,43,23,20,5,22,16
287,259084,Fígols i Alinyà,2015,261,147,114,27,148,86
288,430580,"Figuera, la",2015,117,66,51,3,75,39
289,170669,Figueres,2015,45346,22471,22875,8049,30548,6749
290,430593,Figuerola del Camp,2015,349,167,182,70,213,66
291,170675,Flaçà,2015,1060,506,554,163,678,219
292,430607,Flix,2015,3754,1868,1886,386,2379,989
293,250925,"Floresta, la",2015,160,89,71,17,101,42
294,080826,Fogars de la Selva,2015,1470,755,715,224,993,253
295,080811,Fogars de Montclús,2015,477,248,229,100,298,79
296,170681,Foixà,2015,306,157,149,39,180,87
297,080832,Folgueroles,2015,2285,1156,1129,525,1428,332
298,250931,Fondarella,2015,831,413,418,129,566,136
299,080847,Fonollosa,2015,1393,726,667,208,950,235
300,170694,Fontanals de Cerdanya,2015,450,237,213,45,318,87
301,170708,Fontanilles,2015,144,86,58,15,86,43
302,170715,Fontcoberta,2015,1448,709,739,252,992,204
303,080850,Font-rubí,2015,1348,692,656,206,823,319
304,250946,Foradada,2015,174,99,75,16,105,53
305,179026,Forallac,2015,1705,832,873,236,1146,323
306,430614,Forès,2015,51,27,24,0,25,26
307,170736,Fornells de la Selva,2015,2528,1244,1284,530,1692,306
308,170741,Fortià,2015,723,347,376,127,452,144
309,080863,"Franqueses del Vallès, les",2015,19446,9894,9552,3830,13228,2388
310,430629,Freginals,2015,399,214,185,29,252,118
311,250962,"Fuliola, la",2015,1291,653,638,213,775,303
312,250978,Fulleda,2015,94,47,47,2,59,33
313,080902,Gaià,2015,168,91,77,27,119,22
314,430635,"Galera, la",2015,770,397,373,89,483,198
315,080879,Gallifa,2015,197,103,94,19,147,31
316,430640,Gandesa,2015,3009,1536,1473,422,1924,663
317,430653,Garcia,2015,583,299,284,78,350,155
318,430666,"Garidells, els",2015,188,92,96,19,136,33
319,080885,"Garriga, la",2015,15740,7646,8094,2795,10449,2496
320,170754,Garrigàs,2015,423,220,203,52,285,86
321,170767,Garrigoles,2015,160,88,72,16,99,45
322,170773,Garriguella,2015,842,419,423,151,523,168
323,080898,Gavà,2015,46405,22851,23554,7808,31037,7560
324,250984,Gavet de la Conca,2015,287,142,145,24,158,105
325,080919,Gelida,2015,7253,3629,3624,1397,4779,1077
326,170789,Ger,2015,430,230,200,62,283,85
327,259123,Gimenells i el Pla de la Font,2015,1151,589,562,142,719,290
328,430672,Ginestar,2015,802,418,384,90,496,216
329,170792,Girona,2015,97586,46761,50825,16899,66243,14444
330,080924,Gironella,2015,4925,2422,2503,673,3039,1213
331,080930,Gisclareny,2015,27,16,11,1,21,5
332,430688,Godall,2015,632,311,321,59,357,216
333,250997,Golmés,2015,1770,882,888,302,1161,307
334,170806,Gombrèn,2015,185,92,93,32,113,40
335,251001,Gósol,2015,226,131,95,10,157,59
336,080945,"Granada, la",2015,2085,1070,1015,368,1414,303
337,251018,"Granadella, la",2015,712,369,343,77,417,218
338,080958,Granera,2015,80,53,27,6,55,19
339,251023,"Granja d'Escarp, la",2015,1001,528,473,102,656,243
340,080961,Granollers,2015,60101,29712,30389,9315,40764,10022
341,251039,Granyanella,2015,146,81,65,15,87,44
342,251057,Granyena de les Garrigues,2015,161,96,65,12,95,54
343,251044,Granyena de Segarra,2015,139,70,69,14,73,52
344,430691,Gratallops,2015,243,131,112,25,156,62
345,080977,Gualba,2015,1414,722,692,303,900,211
346,170813,Gualta,2015,368,203,165,61,237,70
347,080996,Guardiola de Berguedà,2015,930,493,437,102,605,223
348,430705,"Guiamets, els",2015,277,129,148,19,178,80
349,170828,Guils de Cerdanya,2015,523,275,248,66,375,82
350,251095,Guimerà,2015,277,152,125,16,141,120
351,259031,"Guingueta d'Àneu, la",2015,315,169,146,38,204,73
352,251109,Guissona,2015,6862,3637,3225,1366,4872,624
353,251116,Guixers,2015,142,89,53,17,89,36
354,081000,Gurb,2015,2545,1318,1227,447,1717,381
355,430712,Horta de Sant Joan,2015,1217,632,585,141,724,352
356,081017,"Hospitalet de Llobregat, l'",2015,252171,122224,129947,35267,165095,51809
357,081629,"Hostalets de Pierola, els",2015,2887,1491,1396,582,1950,355
358,170834,Hostalric,2015,4005,2017,1988,691,2635,679
359,081022,Igualada,2015,38751,18950,19801,6630,24875,7246
360,251155,Isona i Conca Dellà,2015,1064,558,506,116,632,316
361,170849,Isòvol,2015,281,156,125,27,199,55
362,251137,Ivars d'Urgell,2015,1591,831,760,210,962,419
363,251121,Ivars de Noguera,2015,346,177,169,37,220,89
364,251142,Ivorra,2015,106,55,51,6,58,42
365,170852,Jafre,2015,387,208,179,48,242,97
366,170865,"Jonquera, la",2015,3220,1615,1605,567,2205,448
367,081038,Jorba,2015,838,422,416,153,568,117
368,259101,Josa i Tuixén,2015,129,74,55,9,85,35
369,170871,Juià,2015,338,177,161,69,208,61
370,251180,Juncosa,2015,421,230,191,30,259,132
371,251193,Juneda,2015,3384,1757,1627,496,2149,739
372,251214,Les,2015,953,476,477,148,680,125
373,251229,Linyola,2015,2652,1339,1313,394,1705,553
374,081043,"Llacuna, la",2015,883,476,407,109,550,224
375,170887,Lladó,2015,767,380,387,159,485,123
376,251235,Lladorre,2015,229,111,118,31,153,45
377,251240,Lladurs,2015,193,103,90,17,117,59
378,081056,"Llagosta, la",2015,13252,6531,6721,2283,8586,2383
379,170890,Llagostera,2015,8224,4214,4010,1438,5389,1397
380,170904,Llambilles,2015,733,374,359,150,459,124
381,170911,Llanars,2015,512,267,245,66,330,116
382,170926,Llançà,2015,4985,2466,2519,679,3194,1112
383,251253,Llardecans,2015,491,253,238,45,271,175
384,251266,Llavorsí,2015,354,179,175,40,234,80
385,251207,Lleida,2015,138542,68412,70130,21964,93505,23073
386,170932,Llers,2015,1209,605,604,175,785,249
387,251272,Lles de Cerdanya,2015,257,148,109,26,164,67
388,081075,Lliçà d'Amunt,2015,14742,7498,7244,2621,9899,2222
389,081081,Lliçà de Vall,2015,6383,3254,3129,1044,4265,1074
390,251288,Llimiana,2015,158,91,67,9,96,53
391,081069,Llinars del Vallès,2015,9570,4742,4828,1582,6402,1586
392,170947,Llívia,2015,1456,787,669,197,1016,243
393,430727,"Lloar, el",2015,121,66,55,12,75,34
394,251291,Llobera,2015,202,109,93,26,131,45
395,430733,Llorac,2015,111,61,50,11,73,27
396,430748,Llorenç del Penedès,2015,2323,1152,1171,419,1477,427
397,170950,Lloret de Mar,2015,37618,19338,18280,5873,26947,4798
398,170963,"Llosses, les",2015,226,129,97,23,164,39
399,081094,Lluçà,2015,280,139,141,50,184,46
400,171024,Maçanet de Cabrenys,2015,755,379,376,96,451,208
401,171030,Maçanet de la Selva,2015,6887,3527,3360,1105,4589,1193
402,170979,Madremanya,2015,276,138,138,49,174,53
403,170985,Maià de Montcal,2015,446,229,217,77,280,89
404,251333,Maials,2015,941,500,441,102,564,275
405,251305,Maldà,2015,228,117,111,24,131,73
406,081108,Malgrat de Mar,2015,18371,9183,9188,2817,12053,3501
407,081115,Malla,2015,262,132,130,36,168,58
408,081120,Manlleu,2015,20228,10096,10132,3683,13099,3446
409,081136,Manresa,2015,74655,36397,38258,11990,47874,14791
410,430764,Marçà,2015,596,314,282,91,365,140
411,430751,Margalef,2015,106,64,42,4,64,38
412,082423,Marganell,2015,280,132,148,32,181,67
413,081141,Martorell,2015,27694,14149,13545,5252,18088,4354
414,081154,Martorelles,2015,4756,2370,2386,687,3158,911
415,430770,Mas de Barberans,2015,604,297,307,59,360,185
416,171002,Masarac,2015,294,154,140,42,194,58
417,430786,Masdenverge,2015,1096,565,531,136,708,252
418,081167,"Masies de Roda, les",2015,715,354,361,94,464,157
419,081173,"Masies de Voltregà, les",2015,3165,1554,1611,527,2110,528
420,430799,Masllorenç,2015,501,271,230,80,313,108
421,081189,"Masnou, el",2015,22923,11062,11861,3384,15395,4144
422,430803,"Masó, la",2015,290,155,135,40,162,88
423,430810,Maspujols,2015,786,403,383,135,534,117
424,081192,Masquefa,2015,8335,4214,4121,1626,5612,1097
425,430825,"Masroig, el",2015,511,280,231,62,303,146
426,251312,Massalcoreig,2015,564,301,263,47,386,131
427,171019,Massanes,2015,722,381,341,139,455,128
428,251327,Massoteres,2015,189,105,84,41,114,34
429,081206,Matadepera,2015,8900,4461,4439,1699,5829,1372
430,081213,Mataró,2015,124867,62045,62822,20879,83315,20673
431,171045,Medinyà,2015,0,0,0,0,0,0
432,081228,Mediona,2015,2273,1147,1126,398,1372,503
433,251348,Menàrguens,2015,849,471,378,80,553,216
434,170998,Meranges,2015,100,58,42,14,62,24
435,171058,Mieres,2015,330,169,161,43,213,74
436,430831,"Milà, el",2015,178,88,90,26,105,47
437,251351,Miralcamp,2015,1390,695,695,222,889,279
438,430846,Miravet,2015,747,402,345,100,451,196
439,081385,Moià,2015,5865,2942,2923,1040,3817,1008
440,430859,"Molar, el",2015,291,156,135,25,175,91
441,081234,Molins de Rei,2015,25155,12255,12900,4501,16588,4066
442,251370,Mollerussa,2015,14900,7612,7288,2794,10122,1984
443,171061,Mollet de Peralada,2015,180,95,85,27,95,58
444,081249,Mollet del Vallès,2015,51650,25648,26002,8975,34853,7822
445,171077,Molló,2015,330,160,170,43,203,84
446,251364,"Molsosa, la",2015,113,56,57,9,71,33
447,081287,Monistrol de Calders,2015,697,361,336,84,462,151
448,081271,Monistrol de Montserrat,2015,2901,1473,1428,437,1899,565
449,171096,Montagut i Oix,2015,949,498,451,135,628,186
450,430862,Montblanc,2015,7283,3684,3599,1118,4855,1310
451,430884,Montbrió del Camp,2015,2693,1382,1311,468,1819,406
452,081252,Montcada i Reixac,2015,34377,16941,17436,6077,23117,5183
453,081304,Montclar,2015,120,60,60,23,70,27
454,251399,Montellà i Martinet,2015,586,320,266,51,391,144
455,081311,Montesquiu,2015,943,480,463,152,597,194
456,251403,Montferrer i Castellbò,2015,1010,546,464,147,698,165
457,430897,Montferri,2015,378,207,171,67,246,65
458,251386,Montgai,2015,663,347,316,56,388,219
459,081265,Montgat,2015,11501,5721,5780,1987,7884,1630
460,081326,Montmajor,2015,476,238,238,60,298,118
461,081332,Montmaneu,2015,156,83,73,15,90,51
462,430901,"Montmell, el",2015,1373,749,624,214,910,249
463,081350,Montmeló,2015,8835,4331,4504,1389,5943,1503
464,251425,Montoliu de Lleida,2015,514,260,254,67,323,124
465,251410,Montoliu de Segarra,2015,194,107,87,23,120,51
466,251431,Montornès de Segarra,2015,101,50,51,13,54,34
467,081363,Montornès del Vallès,2015,16172,8210,7962,3027,10907,2238
468,430918,Mont-ral,2015,176,98,78,25,118,33
469,171100,Mont-ras,2015,1710,859,851,235,1169,306
470,430923,Mont-roig del Camp,2015,11877,6202,5675,1834,8060,1983
471,081379,Montseny,2015,319,166,153,44,195,80
472,430939,Móra d'Ebre,2015,5477,2699,2778,857,3592,1028
473,430944,Móra la Nova,2015,3185,1600,1585,435,2121,629
474,430957,"Morell, el",2015,3524,1808,1716,652,2420,452
475,430960,"Morera de Montsant, la",2015,147,86,61,16,102,29
476,081290,Muntanyola,2015,606,313,293,121,408,77
477,081398,Mura,2015,203,109,94,30,131,42
478,251459,Nalec,2015,95,49,46,3,53,39
479,250254,Naut Aran,2015,1760,890,870,258,1282,220
480,081402,Navarcles,2015,6012,2936,3076,857,4001,1154
481,081419,Navàs,2015,6103,3049,3054,932,3922,1249
482,171117,Navata,2015,1323,652,671,241,860,222
483,251462,Navès,2015,281,136,145,41,181,59
484,081424,"Nou de Berguedà, la",2015,153,74,79,14,97,42
485,430976,"Nou de Gaià, la",2015,537,264,273,113,311,113
486,430982,Nulles,2015,448,233,215,69,281,98
487,251484,Odèn,2015,253,145,108,15,169,69
488,081430,Òdena,2015,3623,1848,1775,728,2329,566
489,171122,Ogassa,2015,232,136,96,33,145,54
490,081458,Olèrdola,2015,3518,1823,1695,658,2324,536
491,081461,Olesa de Bonesvalls,2015,1715,881,834,317,1122,276
492,081477,Olesa de Montserrat,2015,23536,11791,11745,4451,15542,3543
493,251497,Oliana,2015,1842,923,919,211,1145,486
494,251500,Oliola,2015,233,128,105,21,149,63
495,251517,Olius,2015,910,475,435,201,566,143
496,081483,Olivella,2015,3569,1895,1674,740,2448,381
497,081496,Olost,2015,1182,596,586,135,763,284
498,171143,Olot,2015,33944,16845,17099,5171,22132,6641
499,251522,"Oluges, les",2015,161,85,76,13,90,58
500,081445,Olvan,2015,856,423,433,95,537,224
501,251538,"Omellons, els",2015,226,118,108,16,126,84
502,251543,"Omells de na Gaia, els",2015,136,73,63,9,82,45
503,171156,Ordis,2015,389,208,181,57,257,75
504,251556,Organyà,2015,845,418,427,86,511,248
505,081509,Orís,2015,308,154,154,43,218,47
506,081516,Oristà,2015,559,275,284,66,344,149
507,081521,Orpí,2015,139,76,63,19,88,32
508,081537,Òrrius,2015,688,356,332,113,471,104
509,251569,Os de Balaguer,2015,995,501,494,163,624,208
510,171169,Osor,2015,421,217,204,53,266,102
511,251575,Ossó de Sió,2015,213,109,104,30,121,62
512,081542,Pacs del Penedès,2015,893,451,442,150,609,134
513,081555,Palafolls,2015,9132,4550,4582,1791,6193,1148
514,171175,Palafrugell,2015,22733,11313,11420,3896,15001,3836
515,171181,Palamós,2015,17911,8751,9160,2597,11958,3356
516,251581,"Palau d'Anglesola, el",2015,2136,1051,1085,344,1385,407
517,171194,Palau de Santa Eulàlia,2015,88,54,34,12,62,14
518,171215,Palau-sator,2015,298,157,141,46,184,68
519,171208,Palau-saverdera,2015,1485,742,743,284,896,305
520,081568,Palau-solità i Plegamans,2015,14457,7087,7370,2588,9786,2083
521,431009,"Pallaresos, els",2015,4547,2298,2249,1051,3058,438
522,081574,Pallejà,2015,11298,5634,5664,2189,7494,1615
523,430995,"Palma d'Ebre, la",2015,376,178,198,30,211,135
524,089058,"Palma de Cervelló, la",2015,2966,1492,1474,464,2103,399
525,171236,Palol de Revardit,2015,466,240,226,71,305,90
526,171241,Pals,2015,2501,1265,1236,368,1596,537
527,081580,"Papiol, el",2015,4071,2033,2038,710,2719,642
528,171254,Pardines,2015,155,87,68,18,98,39
529,081593,Parets del Vallès,2015,18901,9495,9406,3315,13017,2569
530,171267,Parlavà,2015,398,208,190,64,245,89
531,431016,Passanant i Belltall,2015,173,100,73,6,118,49
532,171289,Pau,2015,557,276,281,82,338,137
533,431021,Paüls,2015,582,285,297,62,334,186
534,171292,Pedret i Marzà,2015,193,106,87,34,125,34
535,251641,Penelles,2015,482,277,205,54,294,134
536,171306,"Pera, la",2015,441,210,231,72,263,106
537,081607,Perafita,2015,419,212,207,46,262,111
538,431037,Perafort,2015,1320,697,623,305,869,146
539,171328,Peralada,2015,1841,920,921,297,1193,351
540,251654,Peramola,2015,343,175,168,32,213,98
541,431042,"Perelló, el",2015,2925,1500,1425,372,1748,805
542,081614,Piera,2015,14991,7621,7370,2707,9834,2450
543,431055,"Piles, les",2015,209,112,97,35,137,37
544,081635,Pineda de Mar,2015,25968,12986,12982,3902,16978,5088
545,431068,"Pinell de Brai, el",2015,1053,533,520,117,635,301
546,251667,Pinell de Solsonès,2015,207,119,88,21,129,57
547,251673,Pinós,2015,305,167,138,44,188,73
548,431074,Pira,2015,494,262,232,92,319,83
549,431080,"Pla de Santa Maria, el",2015,2333,1212,1121,344,1536,453
550,081640,"Pla del Penedès, el",2015,1230,614,616,225,799,206
551,171334,"Planes d'Hostoles, les",2015,1674,848,826,230,988,456
552,171349,Planoles,2015,298,161,137,35,191,72
553,259118,"Plans de Sió, els",2015,528,281,247,57,312,159
554,251689,"Poal, el",2015,668,348,320,80,422,166
555,251692,"Pobla de Cérvoles, la",2015,222,124,98,22,134,66
556,081653,"Pobla de Claramunt, la",2015,2150,1089,1061,389,1371,390
557,081666,"Pobla de Lillet, la",2015,1139,561,578,79,694,366
558,431093,"Pobla de Mafumet, la",2015,3675,1897,1778,764,2634,277
559,431107,"Pobla de Massaluca, la",2015,341,182,159,37,179,125
560,431114,"Pobla de Montornès, la",2015,2861,1518,1343,498,1841,522
561,251713,"Pobla de Segur, la",2015,3016,1499,1517,432,1809,775
562,431129,Poboleda,2015,363,196,167,38,219,106
563,081672,Polinyà,2015,8226,4180,4046,1806,5666,754
564,431135,"Pont d'Armentera, el",2015,545,277,268,64,338,143
565,250306,"Pont de Bar, el",2015,159,88,71,20,93,46
566,171352,Pont de Molins,2015,512,251,261,76,345,91
567,251734,"Pont de Suert, el",2015,2314,1167,1147,334,1508,472
568,081825,"Pont de Vilomara i Rocafort, el",2015,3715,1901,1814,626,2449,640
569,431418,Pontils,2015,121,69,52,10,79,32
570,081688,Pontons,2015,483,273,210,50,331,102
571,171365,Pontós,2015,231,131,100,32,146,53
572,251728,Ponts,2015,2632,1305,1327,393,1643,596
573,171371,Porqueres,2015,4521,2253,2268,799,2992,730
574,431140,Porrera,2015,448,243,205,34,304,110
575,171404,"Port de la Selva, el",2015,1002,533,469,107,638,257
576,171387,Portbou,2015,1167,579,588,89,685,393
577,251749,"Portella, la",2015,731,398,333,92,508,131
578,431153,Pradell de la Teixeta,2015,183,82,101,21,115,47
579,431166,Prades,2015,623,319,304,77,391,155
580,431172,Prat de Comte,2015,165,89,76,16,97,52
581,081691,"Prat de Llobregat, el",2015,63014,30931,32083,9982,41858,11174
582,431188,Pratdip,2015,697,368,329,72,405,220
583,081712,Prats de Lluçanès,2015,2580,1294,1286,309,1683,588
584,081705,"Prats de Rei, els",2015,536,280,256,66,338,132
585,251752,Prats i Sansor,2015,251,131,120,29,173,49
586,251765,Preixana,2015,407,204,203,52,224,131
587,251771,Preixens,2015,458,234,224,51,254,153
588,082303,Premià de Dalt,2015,10392,5231,5161,1749,6983,1660
589,081727,Premià de Mar,2015,27944,13667,14277,4389,18524,5031
590,171390,"Preses, les",2015,1764,873,891,316,1143,305
591,251790,Prullans,2015,206,105,101,19,129,58
592,171411,Puigcerdà,2015,8825,4412,4413,1435,6036,1354
593,081748,Puigdàlber,2015,539,266,273,103,342,94
594,251804,Puiggròs,2015,295,153,142,40,179,76
595,431191,Puigpelat,2015,1119,577,542,232,770,117
596,081751,Puig-reig,2015,4167,2022,2145,492,2573,1102
597,251811,Puigverd d'Agramunt,2015,244,140,104,32,154,58
598,251826,Puigverd de Lleida,2015,1405,725,680,230,901,274
599,081764,Pujalt,2015,198,109,89,28,122,48
600,081770,"Quar, la",2015,52,28,24,6,32,14
601,171426,Quart,2015,3448,1734,1714,712,2307,429
602,170433,Queralbs,2015,173,100,73,10,114,49
603,431205,Querol,2015,563,312,251,70,380,113
604,171432,Rabós,2015,182,90,92,20,105,57
605,081786,Rajadell,2015,524,268,256,69,342,113
606,431212,Rasquera,2015,864,430,434,89,512,263
607,171447,Regencós,2015,285,148,137,44,175,66
608,081799,Rellinars,2015,748,388,360,126,519,103
609,431227,Renau,2015,151,79,72,34,99,18
610,431233,Reus,2015,103194,50011,53183,18129,68053,17012
611,251832,Rialp,2015,655,340,315,88,454,113
612,431248,"Riba, la",2015,605,325,280,72,373,160
613,431251,Riba-roja d'Ebre,2015,1172,618,554,103,725,344
614,259059,Ribera d'Ondara,2015,429,225,204,51,256,122
615,251850,Ribera d'Urgellet,2015,978,514,464,153,639,186
616,171450,Ribes de Freser,2015,1818,896,922,190,1108,520
617,171463,Riells i Viabrea,2015,3945,2042,1903,695,2758,492
618,431264,"Riera de Gaià, la",2015,1679,841,838,375,1058,246
619,251863,Riner,2015,267,131,136,37,160,70
620,171479,Ripoll,2015,10632,5217,5415,1451,6794,2387
621,081803,Ripollet,2015,37445,18544,18901,7024,25121,5300
622,259139,Riu de Cerdanya,2015,104,60,44,6,82,16
623,171485,Riudarenes,2015,2120,1091,1029,365,1384,371
624,171498,Riudaura,2015,461,225,236,74,299,88
625,431270,Riudecanyes,2015,1151,600,551,198,726,227
626,431286,Riudecols,2015,1216,636,580,160,823,233
627,171501,Riudellots de la Selva,2015,2022,1030,992,336,1385,301
628,431299,Riudoms,2015,6633,3409,3224,1175,4254,1204
629,171518,Riumors,2015,245,122,123,35,158,52
630,081810,"Roca del Vallès, la",2015,10504,5278,5226,1988,7029,1487
631,431303,Rocafort de Queralt,2015,251,133,118,29,141,81
632,431310,Roda de Berà,2015,6352,3288,3064,1047,4096,1209
633,081831,Roda de Ter,2015,6122,3006,3116,1039,3973,1110
634,431325,Rodonyà,2015,501,258,243,74,325,102
635,431331,Roquetes,2015,8234,4246,3988,1342,5495,1397
636,171523,Roses,2015,19575,9806,9769,3339,12905,3331
637,251898,Rosselló,2015,3043,1538,1505,510,2102,431
638,431346,"Rourell, el",2015,404,207,197,66,268,70
639,081846,Rubí,2015,74536,36985,37551,12993,50836,10707
640,081859,Rubió,2015,229,125,104,27,149,53
641,171539,Rupià,2015,248,125,123,38,154,56
642,089019,Rupit i Pruit,2015,281,145,136,26,178,77
643,081878,Sabadell,2015,207814,101118,106696,33839,135995,37980
644,081884,Sagàs,2015,157,85,72,33,94,30
645,251902,Salàs de Pallars,2015,359,193,166,40,222,97
646,081901,Saldes,2015,288,162,126,15,199,74
647,171544,Sales de Llierca,2015,139,68,71,21,102,16
648,081918,Sallent,2015,6669,3215,3454,926,4061,1682
649,431359,Salomó,2015,539,275,264,94,328,117
650,439057,Salou,2015,26459,13863,12596,4080,19454,2925
651,171557,Salt,2015,29342,15461,13881,6036,19781,3525
652,251919,Sanaüja,2015,427,219,208,52,259,116
653,081944,Sant Adrià de Besòs,2015,35814,17638,18176,6141,23415,6258
654,081957,Sant Agustí de Lluçanès,2015,90,45,45,7,62,21
655,081960,Sant Andreu de la Barca,2015,27340,13717,13623,5472,18258,3610
656,081976,Sant Andreu de Llavaneres,2015,10493,5166,5327,1853,6961,1679
657,171576,Sant Andreu Salou,2015,149,79,70,19,93,37
658,171833,Sant Aniol de Finestres,2015,373,196,177,59,247,67
659,081982,Sant Antoni de Vilamajor,2015,5789,2896,2893,1000,3966,823
660,081995,Sant Bartomeu del Grau,2015,863,447,416,110,606,147
661,082009,Sant Boi de Llobregat,2015,82195,40327,41868,13170,54314,14711
662,082016,Sant Boi de Lluçanès,2015,544,264,280,59,323,162
663,431362,Sant Carles de la Ràpita,2015,14760,7259,7501,2163,9478,3119
664,082037,Sant Cebrià de Vallalta,2015,3326,1734,1592,644,2248,434
665,082021,Sant Celoni,2015,17317,8582,8735,3053,11352,2912
666,082042,Sant Climent de Llobregat,2015,4013,2011,2002,828,2687,498
667,171582,Sant Climent Sescebes,2015,601,346,255,73,400,128
668,082055,Sant Cugat del Vallès,2015,87830,42743,45087,17844,58990,10996
669,082068,Sant Cugat Sesgarrigues,2015,978,482,496,172,605,201
670,251961,Sant Esteve de la Sarga,2015,144,89,55,10,93,41
671,082074,Sant Esteve de Palautordera,2015,2568,1272,1296,524,1706,338
672,082080,Sant Esteve Sesrovires,2015,7613,3805,3808,1387,5104,1122
673,171595,Sant Feliu de Buixalleu,2015,787,411,376,113,530,144
674,082107,Sant Feliu de Codines,2015,5908,2977,2931,1023,3939,946
675,171609,Sant Feliu de Guíxols,2015,21586,10668,10918,3350,14191,4045
676,082114,Sant Feliu de Llobregat,2015,43800,21259,22541,7412,28760,7628
677,171616,Sant Feliu de Pallerols,2015,1332,654,678,215,832,285
678,082129,Sant Feliu Sasserra,2015,628,330,298,87,402,139
679,171621,Sant Ferriol,2015,239,135,104,48,154,37
680,082093,Sant Fost de Campsentelles,2015,8603,4298,4305,1343,5691,1569
681,082135,Sant Fruitós de Bages,2015,8351,4165,4186,1550,5615,1186
682,171637,Sant Gregori,2015,3498,1762,1736,676,2307,515
683,251924,Sant Guim de Freixenet,2015,1078,557,521,157,671,250
684,251977,Sant Guim de la Plana,2015,174,94,80,24,97,53
685,171642,Sant Hilari Sacalm,2015,5608,2843,2765,845,3640,1123
686,082153,Sant Hipòlit de Voltregà,2015,3429,1697,1732,553,2219,657
687,081939,Sant Iscle de Vallalta,2015,1308,672,636,253,859,196
688,439023,Sant Jaume d'Enveja,2015,3538,1801,1737,506,2195,837
689,082166,Sant Jaume de Frontanyà,2015,26,16,10,2,14,10
690,171655,Sant Jaume de Llierca,2015,841,412,429,115,521,205
691,431378,Sant Jaume dels Domenys,2015,2521,1299,1222,484,1636,401
692,171674,Sant Joan de les Abadesses,2015,3383,1676,1707,412,2056,915
693,171680,Sant Joan de Mollet,2015,497,240,257,78,330,89
694,082188,Sant Joan de Vilatorrada,2015,10768,5383,5385,1822,7004,1942
695,082172,Sant Joan Despí,2015,33264,16264,17000,5860,22028,5376
696,171851,Sant Joan les Fonts,2015,2937,1451,1486,395,1845,697
697,171668,Sant Jordi Desvalls,2015,720,349,371,111,459,150
698,089030,Sant Julià de Cerdanyola,2015,242,134,108,26,154,62
699,171693,Sant Julià de Ramis,2015,3415,1724,1691,701,2288,426
700,082205,Sant Julià de Vilatorta,2015,3104,1518,1586,551,2063,490
701,179032,Sant Julià del Llor i Bonmatí,2015,1272,654,618,236,848,188
702,082212,Sant Just Desvern,2015,16631,7918,8713,2803,10751,3077
703,082227,Sant Llorenç d'Hortons,2015,2557,1284,1273,486,1713,358
704,171714,Sant Llorenç de la Muga,2015,255,129,126,39,162,54
705,251930,Sant Llorenç de Morunys,2015,977,478,499,123,575,279
706,082233,Sant Llorenç Savall,2015,2380,1208,1172,356,1518,506
707,082251,Sant Martí d'Albars,2015,110,54,56,14,64,32
708,082248,Sant Martí de Centelles,2015,1103,562,541,166,792,145
709,171729,Sant Martí de Llémena,2015,605,319,286,103,413,89
710,259025,Sant Martí de Riucorb,2015,689,368,321,78,388,223
711,082264,Sant Martí de Tous,2015,1186,599,587,248,713,225
712,082270,Sant Martí Sarroca,2015,3092,1509,1583,524,1998,570
713,082286,Sant Martí Sesgueioles,2015,378,189,189,60,245,73
714,171735,Sant Martí Vell,2015,248,131,117,41,159,48
715,082299,Sant Mateu de Bages,2015,620,314,306,59,363,198
716,171740,Sant Miquel de Campmajor,2015,219,115,104,25,145,49
717,171753,Sant Miquel de Fluvià,2015,756,395,361,94,526,136
718,171766,Sant Mori,2015,176,96,80,28,116,32
719,171772,Sant Pau de Segúries,2015,682,336,346,84,419,179
720,082310,Sant Pere de Ribes,2015,29666,14906,14760,5328,20319,4019
721,082325,Sant Pere de Riudebitlles,2015,2374,1191,1183,443,1433,498
722,082331,Sant Pere de Torelló,2015,2433,1255,1178,348,1596,489
723,082346,Sant Pere de Vilamajor,2015,4281,2134,2147,834,2827,620
724,171788,Sant Pere Pescador,2015,2143,1159,984,350,1462,331
725,081897,Sant Pere Sallavinera,2015,167,93,74,26,96,45
726,082359,Sant Pol de Mar,2015,5012,2486,2526,806,3179,1027
727,082362,Sant Quintí de Mediona,2015,2116,1074,1042,370,1334,412
728,082378,Sant Quirze de Besora,2015,2132,1050,1082,288,1283,561
729,082384,Sant Quirze del Vallès,2015,19602,9619,9983,3894,13387,2321
730,082397,Sant Quirze Safaja,2015,622,332,290,125,421,76
731,251945,Sant Ramon,2015,506,273,233,47,307,152
732,082401,Sant Sadurní d'Anoia,2015,12689,6234,6455,2275,8381,2033
733,082418,Sant Sadurní d'Osormort,2015,86,50,36,6,59,21
734,080983,Sant Salvador de Guardiola,2015,3126,1583,1543,586,1991,549
735,082628,Sant Vicenç de Castellet,2015,9246,4584,4662,1471,6041,1734
736,082649,Sant Vicenç de Montalt,2015,6049,3053,2996,1197,3979,873
737,082652,Sant Vicenç de Torelló,2015,2001,988,1013,338,1278,385
738,082634,Sant Vicenç dels Horts,2015,27983,13952,14031,4762,18973,4248
739,431384,Santa Bàrbara,2015,3734,1904,1830,549,2368,817
740,082439,Santa Cecília de Voltregà,2015,179,94,85,17,122,40
741,082444,Santa Coloma de Cervelló,2015,8022,3945,4077,1769,5293,960
742,171805,Santa Coloma de Farners,2015,12681,6447,6234,2262,8436,1983
743,082457,Santa Coloma de Gramenet,2015,116950,58265,58685,18118,76099,22733
744,431397,Santa Coloma de Queralt,2015,2850,1414,1436,462,1753,635
745,171812,Santa Cristina d'Aro,2015,5089,2570,2519,865,3399,825
746,082460,Santa Eugènia de Berga,2015,2204,1131,1073,300,1534,370
747,082476,Santa Eulàlia de Riuprimer,2015,1284,645,639,257,839,188
748,082482,Santa Eulàlia de Ronçana,2015,7080,3560,3520,1270,4624,1186
749,082495,Santa Fe del Penedès,2015,378,190,188,71,256,51
750,171827,Santa Llogaia d'Àlguema,2015,339,178,161,60,238,41
751,082508,Santa Margarida de Montbui,2015,9648,4822,4826,1777,6298,1573
752,082515,Santa Margarida i els Monjos,2015,7332,3732,3600,1517,4857,958
753,082589,Santa Maria d'Oló,2015,1063,548,515,148,664,251
754,082536,Santa Maria de Besora,2015,158,79,79,19,90,49
755,082567,Santa Maria de Martorelles,2015,853,425,428,151,574,128
756,082554,Santa Maria de Merlès,2015,185,91,94,35,119,31
757,082573,Santa Maria de Miralles,2015,130,68,62,15,82,33
758,082592,Santa Maria de Palautordera,2015,9103,4584,4519,1584,6131,1388
759,431401,Santa Oliva,2015,3283,1674,1609,593,2122,568
760,171848,Santa Pau,2015,1562,796,766,207,1041,314
761,082606,Santa Perpètua de Mogoda,2015,25466,12899,12567,4896,17186,3384
762,082613,Santa Susanna,2015,3275,1662,1613,580,2190,505
763,081923,Santpedor,2015,7459,3721,3738,1364,4916,1179
764,431423,Sarral,2015,1585,806,779,262,1000,323
765,171864,Sarrià de Ter,2015,4973,2474,2499,852,3270,851
766,252017,Sarroca de Bellera,2015,125,79,46,1,85,39
767,252000,Sarroca de Lleida,2015,387,213,174,28,222,137
768,171870,"Saus, Camallera i Llampaies",2015,830,413,417,127,533,170
769,431439,Savallà del Comtat,2015,62,31,31,2,42,18
770,431444,"Secuita, la",2015,1670,839,831,288,1132,250
771,171886,"Selva de Mar, la",2015,184,103,81,14,124,46
772,431457,"Selva del Camp, la",2015,5559,2797,2762,988,3729,842
773,431460,Senan,2015,47,31,16,5,34,8
774,430445,"Sénia, la",2015,5799,2912,2887,877,3816,1106
775,252022,Senterada,2015,133,80,53,10,101,22
776,250352,"Sentiu de Sió, la",2015,459,234,225,49,289,121
777,082671,Sentmenat,2015,8652,4387,4265,1594,5930,1128
778,171903,Serinyà,2015,1130,585,545,206,723,201
779,252043,Seròs,2015,1886,1025,861,248,1199,439
780,171910,Serra de Daró,2015,209,114,95,34,126,49
781,171925,Setcases,2015,180,100,80,11,123,46
782,252038,"Seu d'Urgell, la",2015,12249,5896,6353,1850,8200,2199
783,082690,Seva,2015,3434,1750,1684,577,2254,603
784,252056,Sidamon,2015,732,379,353,122,486,124
785,171931,Sils,2015,5797,2932,2865,1034,3866,897
786,082704,Sitges,2015,28269,14082,14187,4327,19172,4770
787,170524,Siurana,2015,152,73,79,17,92,43
788,082711,Sobremunt,2015,82,35,47,8,54,20
789,252069,"Soleràs, el",2015,342,176,166,41,184,117
790,431476,Solivella,2015,629,313,316,83,370,176
791,252075,Solsona,2015,9004,4505,4499,1500,5863,1641
792,082726,Sora,2015,184,104,80,25,125,34
793,252081,Soriguera,2015,385,206,179,45,272,68
794,252094,Sort,2015,2199,1089,1110,359,1459,381
795,252108,Soses,2015,1728,899,829,289,1105,334
796,082732,Subirats,2015,2988,1543,1445,482,1926,580
797,252115,Sudanell,2015,847,473,374,92,556,199
798,252120,Sunyer,2015,325,180,145,26,216,83
799,082747,Súria,2015,5927,2858,3069,788,3753,1386
800,171946,Susqueda,2015,92,55,37,6,63,23
801,082763,Tagamanent,2015,319,170,149,50,221,48
802,082779,Talamanca,2015,189,108,81,24,123,42
803,252154,Talarn,2015,582,363,219,53,442,87
804,252167,Talavera,2015,262,146,116,27,148,87
805,171959,"Tallada d'Empordà, la",2015,458,237,221,73,288,97
806,082785,Taradell,2015,6262,3126,3136,1073,4088,1101
807,431482,Tarragona,2015,131255,63920,67335,21597,87043,22615
808,252173,Tàrrega,2015,16444,8152,8292,2968,10892,2584
809,252189,Tarrés,2015,103,57,46,15,61,27
810,252192,Tarroja de Segarra,2015,178,91,87,22,113,43
811,082750,Tavèrnoles,2015,319,165,154,51,216,52
812,082802,Tavertet,2015,124,70,54,11,86,27
813,082819,Teià,2015,6238,3078,3160,979,4096,1163
814,252206,Térmens,2015,1531,767,764,172,1010,349
815,171962,Terrades,2015,294,145,149,39,191,64
816,082798,Terrassa,2015,215214,106067,109147,38045,142542,34627
817,082824,Tiana,2015,8411,4035,4376,1490,5713,1208
818,252213,Tírvia,2015,153,76,77,15,101,37
819,252228,Tiurana,2015,72,35,37,6,42,24
820,431495,Tivenys,2015,868,443,425,87,501,280
821,431508,Tivissa,2015,1751,876,875,214,1069,468
822,082830,Tona,2015,8021,3961,4060,1402,5232,1387
823,252234,Torà,2015,1232,613,619,149,812,271
824,082845,Tordera,2015,16433,8325,8108,2936,10776,2721
825,082858,Torelló,2015,13881,6816,7065,2192,9168,2521
826,252249,"Torms, els",2015,147,82,65,15,74,58
827,252252,Tornabous,2015,885,467,418,119,531,235
828,252271,"Torre de Cabdella, la",2015,762,390,372,58,494,210
829,082861,"Torre de Claramunt, la",2015,3767,1925,1842,651,2569,547
830,431515,"Torre de Fontaubella, la",2015,129,67,62,16,75,38
831,431520,"Torre de l'Espanyol, la",2015,644,338,306,77,387,180
832,252265,Torrebesses,2015,286,151,135,26,167,93
833,431536,Torredembarra,2015,15371,7528,7843,2498,10149,2724
834,252287,Torrefarrera,2015,4611,2333,2278,998,3138,475
835,259078,Torrefeta i Florejacs,2015,604,319,285,61,361,182
836,252304,Torregrossa,2015,2255,1143,1112,317,1424,514
837,252311,Torrelameu,2015,706,400,306,80,468,158
838,082877,Torrelavit,2015,1401,741,660,238,918,245
839,082883,Torrelles de Foix,2015,2246,1184,1062,360,1454,432
840,082896,Torrelles de Llobregat,2015,5883,2902,2981,1194,3994,695
841,171978,Torrent,2015,169,91,78,21,107,41
842,252326,Torres de Segre,2015,2271,1172,1099,295,1547,429
843,252332,Torre-serona,2015,379,190,189,53,231,95
844,171984,Torroella de Fluvià,2015,732,387,345,101,508,123
845,171997,Torroella de Montgrí,2015,11388,5778,5610,1887,7566,1935
846,431541,Torroja del Priorat,2015,164,92,72,12,98,54
847,172001,Tortellà,2015,775,377,398,103,491,181
848,431554,Tortosa,2015,33864,16964,16900,5205,21954,6705
849,172018,Toses,2015,155,92,63,18,104,33
850,172023,Tossa de Mar,2015,5623,2857,2766,771,3806,1046
851,252347,Tremp,2015,6175,3062,3113,879,3936,1360
852,172044,Ullà,2015,1068,593,475,193,723,152
853,082900,Ullastrell,2015,2043,1023,1020,464,1308,271
854,172057,Ullastret,2015,295,144,151,52,185,58
855,431567,Ulldecona,2015,6637,3394,3243,1068,4302,1267
856,431573,Ulldemolins,2015,404,228,176,28,238,138
857,172039,Ultramort,2015,200,111,89,33,118,49
858,172060,Urús,2015,176,83,93,23,119,34
859,082917,Vacarisses,2015,6143,3175,2968,1321,4049,773
860,170144,"Vajol, la",2015,88,50,38,7,66,15
861,172076,"Vall d'en Bas, la",2015,2966,1480,1486,482,1903,581
862,172082,"Vall de Bianya, la",2015,1297,661,636,220,844,233
863,250432,"Vall de Boí, la",2015,1004,532,472,111,720,173
864,259010,Vall de Cardós,2015,368,196,172,48,241,79
865,082922,Vallbona d'Anoia,2015,1417,732,685,229,923,265
866,252385,Vallbona de les Monges,2015,256,136,120,25,145,86
867,082938,Vallcebre,2015,255,146,109,21,158,76
868,431589,Vallclara,2015,109,62,47,15,64,30
869,252402,Vallfogona de Balaguer,2015,1880,925,955,304,1258,318
870,171707,Vallfogona de Ripollès,2015,205,111,94,22,123,60
871,431592,Vallfogona de Riucorb,2015,95,58,37,3,57,35
872,082943,Vallgorguina,2015,2749,1409,1340,577,1855,317
873,082956,Vallirana,2015,14633,7307,7326,2772,9553,2308
874,172095,Vall-llobrega,2015,915,458,457,200,619,96
875,431606,Vallmoll,2015,1651,836,815,261,1121,269
876,082969,Vallromanes,2015,2543,1295,1248,561,1687,295
877,431613,Valls,2015,24321,12127,12194,4035,16077,4209
878,259062,"Valls d'Aguilar, les",2015,302,164,138,30,188,84
879,252398,"Valls de Valira, les",2015,845,428,417,97,592,156
880,431628,Vandellòs i l'Hospitalet de l'Infant,2015,6050,3019,3031,1031,4021,998
881,259097,"Vansa i Fórnols, la",2015,210,111,99,13,137,60
882,082975,Veciana,2015,175,97,78,29,95,51
883,431634,"Vendrell, el",2015,36558,18229,18329,6421,24057,6080
884,172109,Ventalló,2015,830,429,401,134,524,172
885,252424,Verdú,2015,947,452,495,111,555,281
886,172116,Verges,2015,1197,578,619,191,729,277
887,431649,Vespella de Gaià,2015,425,232,193,72,270,83
888,082981,Vic,2015,42498,21146,21352,7719,28093,6686
889,172121,Vidrà,2015,173,89,84,25,119,29
890,172137,Vidreres,2015,7741,4006,3735,1320,5164,1257
891,252430,Vielha e Mijaran,2015,5450,2767,2683,797,4028,625
892,431652,Vilabella,2015,803,421,382,107,503,193
893,172142,Vilabertran,2015,902,460,442,149,573,180
894,172155,Vilablareix,2015,2559,1256,1303,435,1782,342
895,082994,Vilada,2015,427,227,200,26,267,134
896,172174,Viladamat,2015,441,229,212,56,284,101
897,172168,Viladasens,2015,221,114,107,35,151,35
898,083015,Viladecans,2015,65549,32541,33008,11930,43806,9813
899,083008,Viladecavalls,2015,7365,3685,3680,1295,5151,919
900,172180,Vilademuls,2015,834,436,398,148,515,171
901,172207,Viladrau,2015,1035,527,508,154,680,201
902,172214,Vilafant,2015,5543,2720,2823,935,3736,872
903,083054,Vilafranca del Penedès,2015,39224,19282,19942,6908,25826,6490
904,252445,Vilagrassa,2015,522,270,252,90,340,92
905,172235,Vilajuïga,2015,1169,577,592,202,756,211
906,431750,Vilalba dels Arcs,2015,669,341,328,64,386,219
907,083067,Vilalba Sasserra,2015,709,352,357,147,459,103
908,252458,Vilaller,2015,566,303,263,64,375,127
909,172240,Vilallonga de Ter,2015,398,205,193,43,246,109
910,431665,Vilallonga del Camp,2015,2228,1138,1090,435,1500,293
911,172253,Vilamacolum,2015,294,150,144,38,192,64
912,172266,Vilamalla,2015,1133,581,552,177,758,198
913,172272,Vilamaniscle,2015,179,97,82,36,118,25
914,252477,Vilamòs,2015,164,92,72,20,129,15
915,172288,Vilanant,2015,399,198,201,71,263,65
916,431671,Vilanova d'Escornalbou,2015,538,288,250,82,345,111
917,252483,Vilanova de Bellpuig,2015,1175,604,571,169,671,335
918,252496,Vilanova de l'Aguda,2015,218,108,110,21,129,68
919,252542,Vilanova de la Barca,2015,1099,546,553,147,706,246
920,252509,Vilanova de Meià,2015,424,233,191,42,253,129
921,431687,Vilanova de Prades,2015,121,61,60,15,74,32
922,083036,Vilanova de Sau,2015,312,157,155,27,208,77
923,252516,Vilanova de Segrià,2015,940,497,443,122,630,188
924,083020,Vilanova del Camí,2015,12452,6250,6202,2303,8293,1856
925,089024,Vilanova del Vallès,2015,5241,2661,2580,1188,3498,555
926,083073,Vilanova i la Geltrú,2015,65684,31821,33863,10301,43648,11735
927,431690,Vilaplana,2015,624,316,308,75,425,124
928,431704,Vila-rodona,2015,1276,647,629,219,822,235
929,172305,Vila-sacra,2015,670,319,351,122,418,130
930,252521,Vila-sana,2015,718,359,359,111,464,143
931,431711,Vila-seca,2015,22332,11314,11018,4200,15540,2592
932,082140,Vilassar de Dalt,2015,8964,4406,4558,1462,5906,1596
933,082191,Vilassar de Mar,2015,20447,9860,10587,3511,13405,3531
934,172229,Vilaür,2015,159,80,79,33,89,37
935,431726,Vilaverd,2015,469,246,223,80,294,95
936,431732,"Vilella Alta, la",2015,135,70,65,24,76,35
937,431747,"Vilella Baixa, la",2015,197,109,88,29,115,53
938,172333,Vilobí d'Onyar,2015,3166,1647,1519,568,2056,542
939,083041,Vilobí del Penedès,2015,1085,564,521,189,690,206
940,172327,Vilopriu,2015,199,107,92,34,120,45
941,252537,"Vilosell, el",2015,187,91,96,8,109,70
942,431763,Vimbodí i Poblet,2015,966,542,424,117,575,274
943,252555,Vinaixa,2015,526,268,258,53,323,150
944,431779,Vinebre,2015,435,219,216,72,261,102
945,431785,Vinyols i els Arcs,2015,1931,993,938,326,1304,301
946,083089,Viver i Serrateix,2015,168,90,78,28,93,47
947,430521,Xerta,2015,1209,589,620,140,749,320
948,000000,Catalunya,2015,7508106,3691745,3816361,1182716,4963773,1361617
0,250019,Abella de la Conca,2016,181,100,81,19,115,47
1,080018,Abrera,2016,12216,6215,6001,2338,8151,1727
2,250024,Àger,2016,602,322,280,51,360,191
3,250030,Agramunt,2016,5390,2714,2676,840,3534,1016
4,080023,Aguilar de Segarra,2016,253,133,120,41,154,58
5,170010,Agullana,2016,841,419,422,128,525,188
6,080142,Aiguafreda,2016,2467,1172,1295,354,1565,548
7,430017,Aiguamúrcia,2016,903,476,427,126,576,201
8,170025,Aiguaviva,2016,763,391,372,163,475,125
9,250387,Aitona,2016,2523,1300,1223,378,1563,582
10,250045,"Alamús, els",2016,799,419,380,114,512,173
11,250058,Alàs i Cerc,2016,350,176,174,44,209,97
12,250061,"Albagés, l'",2016,403,212,191,33,247,123
13,170031,Albanyà,2016,147,82,65,30,96,21
14,250077,Albatàrrec,2016,2291,1193,1098,351,1673,267
15,250083,Albesa,2016,1596,861,735,230,1010,356
16,250096,"Albi, l'",2016,803,418,385,118,455,230
17,430022,Albinyana,2016,2303,1167,1136,325,1487,491
18,430038,"Albiol, l'",2016,459,235,224,96,304,59
19,170046,Albons,2016,765,387,378,131,498,136
20,430043,Alcanar,2016,9494,4785,4709,1324,6184,1986
21,250100,Alcanó,2016,249,123,126,29,143,77
22,250117,Alcarràs,2016,9297,4814,4483,1694,6471,1132
23,250122,Alcoletge,2016,3375,1745,1630,592,2386,397
24,430056,Alcover,2016,5095,2538,2557,894,3336,865
25,439044,"Aldea, l'",2016,4250,2236,2014,633,2734,883
26,430069,Aldover,2016,863,436,427,100,495,268
27,430075,"Aleixar, l'",2016,887,456,431,143,583,161
28,080039,Alella,2016,9632,4690,4942,1532,6278,1822
29,430081,Alfara de Carles,2016,371,199,172,40,217,114
30,250138,Alfarràs,2016,2923,1544,1379,404,1875,644
31,250143,Alfés,2016,326,169,157,36,201,89
32,430094,Alforja,2016,1844,936,908,247,1230,367
33,250156,Algerri,2016,423,229,194,35,228,160
34,250169,Alguaire,2016,3006,1576,1430,449,1955,602
35,250175,Alins,2016,287,152,135,35,163,89
36,430108,Alió,2016,405,193,212,56,258,91
37,250194,Almacelles,2016,6800,3569,3231,1002,4513,1285
38,250208,Almatret,2016,327,181,146,13,197,117
39,250215,Almenar,2016,3502,1870,1632,449,2285,768
40,430115,Almoster,2016,1401,701,700,225,981,195
41,250220,Alòs de Balaguer,2016,125,69,56,10,67,48
42,170062,Alp,2016,1536,800,736,224,1098,214
43,080044,Alpens,2016,294,153,141,46,193,55
44,250236,Alpicat,2016,6233,3108,3125,1192,4232,809
45,250241,Alt Àneu,2016,402,226,176,32,281,89
46,430120,Altafulla,2016,5034,2472,2562,889,3357,788
47,170078,Amer,2016,2260,1107,1153,315,1408,537
48,430136,"Ametlla de Mar, l'",2016,7102,3593,3509,1060,4397,1645
49,080057,"Ametlla del Vallès, l'",2016,8337,4199,4138,1524,5720,1093
50,439060,"Ampolla, l'",2016,3322,1680,1642,423,2085,814
51,430141,Amposta,2016,20654,10389,10265,3358,13606,3690
52,170084,Anglès,2016,5473,2709,2764,950,3488,1035
53,250273,Anglesola,2016,1335,668,667,195,805,335
54,250292,Arbeca,2016,2240,1137,1103,248,1392,600
55,430167,"Arboç, l'",2016,5520,2842,2678,1065,3595,860
56,430154,Arbolí,2016,125,72,53,7,91,27
57,170097,Arbúcies,2016,6380,3298,3082,1105,4174,1101
58,080060,Arenys de Mar,2016,15253,7463,7790,2206,9839,3208
59,080076,Arenys de Munt,2016,8638,4353,4285,1497,5711,1430
60,170101,Argelaguer,2016,415,218,197,51,278,86
61,080082,Argençola,2016,227,120,107,26,159,42
62,430173,"Argentera, l'",2016,136,77,59,7,91,38
63,080095,Argentona,2016,12051,5916,6135,2035,7985,2031
64,170118,"Armentera, l'",2016,935,471,464,155,586,194
65,430189,Arnes,2016,472,238,234,47,252,173
66,250313,Arres,2016,64,41,23,6,49,9
67,250328,Arsèguel,2016,83,50,33,16,55,12
68,080109,Artés,2016,5596,2823,2773,916,3729,951
69,250334,Artesa de Lleida,2016,1512,786,726,225,995,292
70,250349,Artesa de Segre,2016,3556,1808,1748,537,2274,745
71,430192,Ascó,2016,1695,881,814,191,1143,361
72,250365,Aspa,2016,217,108,109,18,129,70
73,250371,"Avellanes i Santa Linya, les",2016,465,267,198,55,261,149
74,080116,Avià,2016,2257,1113,1144,371,1433,453
75,080121,Avinyó,2016,2212,1102,1110,341,1382,489
76,170123,Avinyonet de Puigventós,2016,1587,803,784,314,1117,156
77,080137,Avinyonet del Penedès,2016,1665,885,780,253,1095,317
78,080155,Badalona,2016,215634,106301,109333,34228,142616,38790
79,089045,Badia del Vallès,2016,13482,6588,6894,2092,8783,2607
80,080168,Bagà,2016,2162,1076,1086,229,1402,531
81,250390,Baix Pallars,2016,342,181,161,40,228,74
82,250404,Balaguer,2016,16530,8363,8167,2867,10802,2861
83,080174,Balenyà,2016,3705,1861,1844,636,2491,578
84,080180,Balsareny,2016,3285,1629,1656,404,2157,724
85,430206,Banyeres del Penedès,2016,3091,1563,1528,571,2029,491
86,170157,Banyoles,2016,19239,9608,9631,3528,12504,3207
87,250411,Barbens,2016,943,500,443,123,582,238
88,430213,Barberà de la Conca,2016,478,255,223,67,295,116
89,082520,Barberà del Vallès,2016,32832,16229,16603,5685,22208,4939
90,080193,Barcelona,2016,1608746,761487,847259,202711,1058000,348035
91,250426,"Baronia de Rialb, la",2016,240,129,111,18,147,75
92,170160,Bàscara,2016,980,514,466,152,598,230
93,250447,Bassella,2016,235,112,123,26,146,63
94,430228,Batea,2016,1967,982,985,265,1136,566
95,250450,Bausen,2016,64,33,31,3,34,27
96,080207,Begues,2016,6736,3324,3412,1304,4635,797
97,170139,Begur,2016,3957,2000,1957,496,2653,808
98,250463,Belianes,2016,539,269,270,62,303,174
99,251706,Bellaguarda,2016,307,159,148,24,178,105
100,170182,Bellcaire d'Empordà,2016,647,317,330,102,399,146
101,250479,Bellcaire d'Urgell,2016,1263,639,624,170,745,348
102,250485,Bell-lloc d'Urgell,2016,2349,1162,1187,362,1499,488
103,250498,Bellmunt d'Urgell,2016,188,90,98,24,113,51
104,430234,Bellmunt del Priorat,2016,296,145,151,28,186,82
105,080214,Bellprat,2016,75,46,29,4,45,26
106,250501,Bellpuig,2016,5005,2600,2405,792,3317,896
107,430249,Bellvei,2016,2190,1136,1054,440,1372,378
108,250518,Bellver de Cerdanya,2016,1995,1034,961,290,1281,424
109,250523,Bellvís,2016,2264,1150,1114,324,1391,549
110,250539,Benavent de Segrià,2016,1482,772,710,257,1014,211
111,430252,Benifallet,2016,708,348,360,57,420,231
112,430265,Benissanet,2016,1218,653,565,143,790,285
113,080229,Berga,2016,16175,7950,8225,2306,10322,3547
114,170195,Besalú,2016,2438,1146,1292,391,1480,567
115,170209,Bescanó,2016,4854,2432,2422,963,3146,745
116,170216,Beuda,2016,199,112,87,36,135,28
117,080235,Bigues i Riells del Fai,2016,8915,4546,4369,1677,5968,1270
118,250557,Biosca,2016,187,99,88,10,108,69
119,170221,"Bisbal d'Empordà, la",2016,10742,5346,5396,1962,7042,1738
120,430271,"Bisbal de Falset, la",2016,208,115,93,25,120,63
121,430287,"Bisbal del Penedès, la",2016,3466,1831,1635,535,2232,699
122,172348,Biure,2016,233,122,111,23,149,61
123,430290,Blancafort,2016,393,205,188,45,249,99
124,170237,Blanes,2016,39060,19491,19569,5911,26120,7029
125,170293,Boadella i les Escaules,2016,266,138,128,37,176,53
126,170242,Bolvir,2016,375,198,177,61,241,73
127,430304,Bonastre,2016,639,327,312,125,415,99
128,250576,"Bòrdes, Es",2016,250,138,112,33,170,47
129,170255,Bordils,2016,1680,836,844,278,1116,286
130,250582,"Borges Blanques, les",2016,6000,3062,2938,918,3827,1255
131,430311,"Borges del Camp, les",2016,2070,1042,1028,393,1279,398
132,170268,Borrassà,2016,711,369,342,134,441,136
133,080240,Borredà,2016,495,274,221,49,317,129
134,250595,Bossòst,2016,1123,555,568,167,769,187
135,430326,Bot,2016,615,312,303,50,336,229
136,430332,Botarell,2016,1120,587,533,210,768,142
137,250560,Bovera,2016,267,147,120,18,143,106
138,430347,Bràfim,2016,668,337,331,114,406,148
139,170274,Breda,2016,3722,1849,1873,526,2424,772
140,080253,"Bruc, el",2016,2014,1081,933,402,1347,265
141,080266,"Brull, el",2016,263,142,121,53,170,40
142,170280,Brunyola i Sant Martí Sapresa,2016,375,196,179,58,229,88
143,430350,Cabacés,2016,326,166,160,46,195,85
144,250609,Cabanabona,2016,77,36,41,4,46,27
145,170314,Cabanelles,2016,257,146,111,45,153,59
146,170307,Cabanes,2016,915,494,421,135,582,198
147,080272,"Cabanyes, les",2016,943,483,460,194,625,124
148,250616,Cabó,2016,92,48,44,8,56,28
149,430363,Cabra del Camp,2016,1113,581,532,168,729,216
150,080288,Cabrera d'Anoia,2016,1351,712,639,225,925,201
151,080291,Cabrera de Mar,2016,4553,2299,2254,736,3095,722
152,080305,Cabrils,2016,7287,3603,3684,1357,4984,946
153,170329,Cadaqués,2016,2837,1379,1458,439,1911,487
154,080312,Calaf,2016,3424,1752,1672,554,2168,702
155,430379,Calafell,2016,24289,12192,12097,3780,16017,4492
156,080348,Calders,2016,953,494,459,148,634,171
157,080327,Caldes d'Estrac,2016,2766,1341,1425,413,1798,555
158,170335,Caldes de Malavella,2016,7220,3611,3609,1260,4772,1188
159,080333,Caldes de Montbui,2016,17137,8523,8614,2839,11303,2995
160,080351,Calella,2016,18317,8979,9338,2674,11972,3671
161,080370,Calldetenes,2016,2418,1233,1185,384,1662,372
162,080386,Callús,2016,2057,1008,1049,379,1313,365
163,080364,Calonge de Segarra,2016,191,96,95,20,113,58
164,170340,Calonge i Sant Antoni,2016,10709,5368,5341,1605,7046,2058
165,250621,Camarasa,2016,879,448,431,88,535,256
166,439039,Camarles,2016,3349,1707,1642,504,2057,788
167,430385,Cambrils,2016,33273,16317,16956,5977,22255,5041
168,170353,Camós,2016,683,340,343,101,417,165
169,170366,Campdevànol,2016,3314,1630,1684,443,1994,877
170,170372,Campelles,2016,137,70,67,14,90,33
171,080399,Campins,2016,470,246,224,68,333,69
172,170388,Campllong,2016,516,258,258,117,341,58
173,170391,Camprodon,2016,2221,1097,1124,271,1365,585
174,250637,Canejan,2016,97,54,43,5,66,26
175,170405,Canet d'Adri,2016,702,353,349,121,450,131
176,080403,Canet de Mar,2016,14284,6936,7348,2312,9059,2913
177,439076,"Canonja, la",2016,5846,2886,2960,1041,3962,843
178,080410,Canovelles,2016,15937,8250,7687,2981,10615,2341
179,080425,Cànoves i Samalús,2016,2873,1452,1421,481,1894,498
180,170412,Cantallops,2016,317,160,157,44,196,77
181,080431,Canyelles,2016,4407,2246,2161,821,2988,598
182,430398,Capafonts,2016,112,58,54,9,71,32
183,430402,Capçanes,2016,392,192,200,40,236,116
184,080446,Capellades,2016,5227,2572,2655,810,3334,1083
185,170427,Capmany,2016,596,306,290,89,357,150
186,080459,Capolat,2016,93,45,48,20,56,17
187,080462,Cardedeu,2016,18158,8958,9200,3409,12050,2699
188,080478,Cardona,2016,4775,2351,2424,599,2939,1237
189,080484,Carme,2016,791,411,380,125,498,168
190,430419,Caseres,2016,253,127,126,19,147,87
191,170448,Cassà de la Selva,2016,10025,5101,4924,1716,6673,1636
192,080497,Casserres,2016,1528,760,768,175,954,399
193,080575,Castell de l'Areny,2016,69,40,29,6,50,13
194,259046,Castell de Mur,2016,175,94,81,14,109,52
195,250642,Castellar de la Ribera,2016,142,71,71,28,75,39
196,080522,Castellar de n'Hug,2016,157,83,74,11,109,37
197,080500,Castellar del Riu,2016,176,97,79,28,110,38
198,080517,Castellar del Vallès,2016,23633,11639,11994,4220,15845,3568
199,080538,Castellbell i el Vilar,2016,3584,1820,1764,600,2290,694
200,080543,Castellbisbal,2016,12277,6206,6071,2438,8296,1543
201,080556,Castellcir,2016,726,367,359,132,487,107
202,250674,Castelldans,2016,958,524,434,108,630,220
203,080569,Castelldefels,2016,64892,32034,32858,11175,44669,9048
204,080581,Castellet i la Gornal,2016,2193,1104,1089,322,1431,440
205,170464,Castellfollit de la Roca,2016,970,494,476,145,584,241
206,080608,Castellfollit de Riubregós,2016,165,96,69,14,108,43
207,080594,Castellfollit del Boix,2016,448,225,223,77,290,81
208,080615,Castellgalí,2016,1995,1039,956,364,1301,330
209,080620,Castellnou de Bages,2016,1287,647,640,264,846,177
210,250680,Castellnou de Seana,2016,736,393,343,95,450,191
211,170470,Castelló d'Empúries,2016,10784,5441,5343,1698,7113,1973
212,250693,Castelló de Farfanya,2016,556,300,256,66,333,157
213,080636,Castellolí,2016,573,277,296,103,373,97
214,170486,Castell-Platja d'Aro,2016,10567,5215,5352,1507,7160,1900
215,250707,Castellserà,2016,1030,519,511,123,618,289
216,080641,Castellterçol,2016,2351,1181,1170,345,1474,532
217,430424,Castellvell del Camp,2016,2851,1436,1415,536,1959,356
218,080654,Castellví de la Marca,2016,1545,772,773,241,977,327
219,080667,Castellví de Rosanes,2016,1807,882,925,309,1209,289
220,430430,"Catllar, el",2016,4211,2170,2041,723,2923,565
221,250714,Cava,2016,57,35,22,5,33,19
222,171899,"Cellera de Ter, la",2016,2054,1023,1031,310,1279,465
223,170499,Celrà,2016,5303,2665,2638,1169,3621,513
224,080673,Centelles,2016,7410,3632,3778,1260,4746,1404
225,082687,Cercs,2016,1183,591,592,120,716,347
226,082665,Cerdanyola del Vallès,2016,57543,28184,29359,8684,38937,9922
227,080689,Cervelló,2016,8861,4453,4408,1512,5981,1368
228,250729,Cervera,2016,9013,4544,4469,1601,5897,1515
229,250735,Cervià de les Garrigues,2016,686,357,329,69,404,213
230,170502,Cervià de Ter,2016,916,462,454,168,573,175
231,170519,Cistella,2016,293,140,153,46,184,63
232,250740,Ciutadilla,2016,204,110,94,17,121,66
233,250753,Clariana de Cardener,2016,141,71,70,17,97,27
234,250766,"Cogul, el",2016,174,93,81,12,100,62
235,170545,Colera,2016,522,262,260,51,331,140
236,250772,Coll de Nargó,2016,574,292,282,63,370,141
237,080692,Collbató,2016,4396,2259,2137,934,2903,559
238,430458,Colldejou,2016,171,92,79,15,116,40
239,080706,Collsuspina,2016,349,185,164,64,222,63
240,170558,Colomers,2016,188,94,94,22,118,48
241,251636,"Coma i la Pedra, la",2016,261,156,105,25,188,48
242,251615,Conca de Dalt,2016,439,228,211,51,262,126
243,430461,Conesa,2016,116,60,56,8,76,32
244,430477,Constantí,2016,6439,3340,3099,1229,4303,907
245,080713,Copons,2016,300,152,148,54,181,65
246,430483,Corbera d'Ebre,2016,1080,568,512,134,658,288
247,080728,Corbera de Llobregat,2016,14168,7089,7079,2610,9633,1925
248,250788,Corbins,2016,1401,751,650,229,895,277
249,170577,Corçà,2016,1249,631,618,195,789,265
250,080734,Cornellà de Llobregat,2016,86072,41878,44194,13167,55625,17280
251,170561,Cornellà del Terri,2016,2279,1171,1108,376,1445,458
252,430496,Cornudella de Montsant,2016,966,524,442,108,637,221
253,430509,Creixell,2016,3467,1759,1708,518,2162,787
254,170583,Crespià,2016,267,136,131,50,166,51
255,179011,"Cruïlles, Monells i Sant Sadurní de l'Heura",2016,1292,653,639,198,854,240
256,080749,Cubelles,2016,14608,7390,7218,2577,9688,2343
257,250791,Cubells,2016,373,196,177,31,231,111
258,430516,Cunit,2016,11808,5837,5971,1874,7343,2591
259,170600,Darnius,2016,550,279,271,60,341,149
260,170617,Das,2016,215,117,98,44,136,35
261,439018,Deltebre,2016,11544,5841,5703,1617,7426,2501
262,080752,Dosrius,2016,5154,2614,2540,945,3530,679
263,430537,Duesaigües,2016,242,136,106,24,164,54
264,170622,"Escala, l'",2016,10400,5291,5109,1474,6762,2164
265,080765,Esparreguera,2016,21766,11021,10745,3680,14736,3350
266,170638,Espinelves,2016,201,93,108,35,124,42
267,250812,"Espluga Calba, l'",2016,375,189,186,43,201,131
268,430542,"Espluga de Francolí, l'",2016,3791,1824,1967,544,2428,819
269,080771,Esplugues de Llobregat,2016,45733,21979,23754,6349,29332,10052
270,170643,Espolla,2016,421,209,212,54,252,115
271,170656,Esponellà,2016,456,226,230,87,274,95
272,250827,Espot,2016,361,195,166,36,256,69
273,080787,"Espunyola, l'",2016,247,126,121,23,162,62
274,082541,"Esquirol, l'",2016,2168,1097,1071,295,1399,474
275,250886,Estamariu,2016,119,67,52,18,60,41
276,080790,"Estany, l'",2016,404,200,204,51,241,112
277,250851,Estaràs,2016,163,86,77,12,105,46
278,250864,Esterri d'Àneu,2016,789,375,414,97,562,130
279,250870,Esterri de Cardós,2016,69,34,35,9,49,11
280,430555,Falset,2016,2834,1411,1423,456,1777,601
281,170059,"Far d'Empordà, el",2016,553,277,276,100,355,98
282,250899,Farrera,2016,126,75,51,17,84,25
283,430568,"Fatarella, la",2016,1004,496,508,108,551,345
284,430574,"Febró, la",2016,40,26,14,1,27,12
285,081347,Figaró-Montmany,2016,1092,538,554,166,710,216
286,080804,Fígols,2016,40,23,17,4,22,14
287,259084,Fígols i Alinyà,2016,254,147,107,22,147,85
288,430580,"Figuera, la",2016,105,63,42,1,65,39
289,170669,Figueres,2016,45726,22652,23074,8207,30708,6811
290,430593,Figuerola del Camp,2016,341,165,176,63,214,64
291,170675,Flaçà,2016,1018,491,527,155,638,225
292,430607,Flix,2016,3677,1843,1834,392,2313,972
293,250925,"Floresta, la",2016,155,86,69,16,99,40
294,080826,Fogars de la Selva,2016,1452,752,700,210,982,260
295,080811,Fogars de Montclús,2016,462,245,217,96,289,77
296,170681,Foixà,2016,309,159,150,36,183,90
297,080832,Folgueroles,2016,2298,1158,1140,516,1448,334
298,250931,Fondarella,2016,794,396,398,108,547,139
299,080847,Fonollosa,2016,1401,732,669,207,946,248
300,170694,Fontanals de Cerdanya,2016,446,232,214,41,314,91
301,170708,Fontanilles,2016,140,77,63,12,82,46
302,170715,Fontcoberta,2016,1471,729,742,256,999,216
303,080850,Font-rubí,2016,1363,697,666,199,829,335
304,250946,Foradada,2016,172,98,74,18,102,52
305,179026,Forallac,2016,1723,859,864,248,1155,320
306,430614,Forès,2016,47,26,21,0,25,22
307,170736,Fornells de la Selva,2016,2547,1267,1280,515,1711,321
308,170741,Fortià,2016,721,346,375,125,452,144
309,080863,"Franqueses del Vallès, les",2016,19417,9855,9562,3820,13175,2422
310,430629,Freginals,2016,396,211,185,31,250,115
311,250962,"Fuliola, la",2016,1260,630,630,210,758,292
312,250978,Fulleda,2016,87,46,41,1,54,32
313,080902,Gaià,2016,160,88,72,27,112,21
314,430635,"Galera, la",2016,748,389,359,86,462,200
315,080879,Gallifa,2016,187,99,88,18,135,34
316,430640,Gandesa,2016,2999,1526,1473,435,1901,663
317,430653,Garcia,2016,601,306,295,90,354,157
318,430666,"Garidells, els",2016,193,94,99,22,135,36
319,080885,"Garriga, la",2016,15912,7728,8184,2813,10493,2606
320,170754,Garrigàs,2016,435,228,207,60,291,84
321,170767,Garrigoles,2016,163,89,74,16,100,47
322,170773,Garriguella,2016,854,428,426,156,521,177
323,080898,Gavà,2016,46266,22757,23509,7735,30858,7673
324,250984,Gavet de la Conca,2016,297,142,155,25,165,107
325,080919,Gelida,2016,7238,3640,3598,1374,4791,1073
326,170789,Ger,2016,436,230,206,65,284,87
327,259123,Gimenells i el Pla de la Font,2016,1111,570,541,141,701,269
328,430672,Ginestar,2016,778,407,371,86,470,222
329,170792,Girona,2016,98255,47149,51106,16944,66548,14763
330,080924,Gironella,2016,4829,2361,2468,656,2948,1225
331,080930,Gisclareny,2016,29,17,12,1,22,6
332,430688,Godall,2016,631,318,313,63,354,214
333,250997,Golmés,2016,1835,905,930,319,1207,309
334,170806,Gombrèn,2016,184,93,91,36,106,42
335,251001,Gósol,2016,228,130,98,10,158,60
336,080945,"Granada, la",2016,2091,1065,1026,372,1415,304
337,251018,"Granadella, la",2016,723,379,344,86,423,214
338,080958,Granera,2016,79,53,26,4,56,19
339,251023,"Granja d'Escarp, la",2016,977,519,458,106,635,236
340,080961,Granollers,2016,60174,29668,30506,9336,40618,10220
341,251039,Granyanella,2016,153,85,68,13,97,43
342,251057,Granyena de les Garrigues,2016,158,93,65,13,89,56
343,251044,Granyena de Segarra,2016,147,77,70,18,76,53
344,430691,Gratallops,2016,237,129,108,22,150,65
345,080977,Gualba,2016,1426,718,708,309,904,213
346,170813,Gualta,2016,376,201,175,62,244,70
347,080996,Guardiola de Berguedà,2016,897,474,423,99,578,220
348,430705,"Guiamets, els",2016,273,128,145,18,176,79
349,170828,Guils de Cerdanya,2016,531,281,250,76,373,82
350,251095,Guimerà,2016,275,147,128,21,139,115
351,259031,"Guingueta d'Àneu, la",2016,308,164,144,33,203,72
352,251109,Guissona,2016,6892,3639,3253,1352,4904,636
353,251116,Guixers,2016,146,94,52,17,89,40
354,081000,Gurb,2016,2559,1311,1248,432,1733,394
355,430712,Horta de Sant Joan,2016,1189,621,568,139,702,348
356,081017,"Hospitalet de Llobregat, l'",2016,254804,123505,131299,35760,166759,52285
357,081629,"Hostalets de Pierola, els",2016,2891,1494,1397,563,1951,377
358,170834,Hostalric,2016,4058,2051,2007,714,2650,694
359,081022,Igualada,2016,38987,19046,19941,6665,24877,7445
360,251155,Isona i Conca Dellà,2016,1046,552,494,112,618,316
361,170849,Isòvol,2016,276,153,123,31,193,52
362,251137,Ivars d'Urgell,2016,1578,826,752,208,940,430
363,251121,Ivars de Noguera,2016,351,181,170,37,224,90
364,251142,Ivorra,2016,114,61,53,9,63,42
365,170852,Jafre,2016,386,207,179,48,237,101
366,170865,"Jonquera, la",2016,3231,1632,1599,574,2195,462
367,081038,Jorba,2016,831,406,425,148,567,116
368,259101,Josa i Tuixén,2016,122,71,51,8,80,34
369,170871,Juià,2016,327,170,157,67,203,57
370,251180,Juncosa,2016,418,226,192,34,259,125
371,251193,Juneda,2016,3343,1730,1613,492,2096,755
372,251214,Les,2016,958,469,489,152,680,126
373,251229,Linyola,2016,2650,1330,1320,407,1692,551
374,081043,"Llacuna, la",2016,872,474,398,98,551,223
375,170887,Lladó,2016,752,373,379,158,479,115
376,251235,Lladorre,2016,226,107,119,30,152,44
377,251240,Lladurs,2016,187,100,87,15,116,56
378,081056,"Llagosta, la",2016,13247,6528,6719,2243,8563,2441
379,170890,Llagostera,2016,8266,4228,4038,1452,5424,1390
380,170904,Llambilles,2016,723,366,357,146,458,119
381,170911,Llanars,2016,514,270,244,69,324,121
382,170926,Llançà,2016,4934,2453,2481,677,3185,1072
383,251253,Llardecans,2016,476,248,228,42,263,171
384,251266,Llavorsí,2016,355,175,180,41,238,76
385,251207,Lleida,2016,138144,68284,69860,21725,92919,23500
386,170932,Llers,2016,1210,605,605,176,783,251
387,251272,Lles de Cerdanya,2016,247,144,103,25,155,67
388,081075,Lliçà d'Amunt,2016,14759,7557,7202,2532,9916,2311
389,081081,Lliçà de Vall,2016,6370,3239,3131,1009,4242,1119
390,251288,Llimiana,2016,150,88,62,9,89,52
391,081069,Llinars del Vallès,2016,9717,4821,4896,1599,6460,1658
392,170947,Llívia,2016,1467,792,675,187,1038,242
393,430727,"Lloar, el",2016,123,64,59,15,74,34
394,251291,Llobera,2016,203,110,93,27,126,50
395,430733,Llorac,2016,96,56,40,6,64,26
396,430748,Llorenç del Penedès,2016,2323,1155,1168,425,1474,424
397,170950,Lloret de Mar,2016,37042,18952,18090,5853,26292,4897
398,170963,"Llosses, les",2016,213,119,94,24,152,37
399,081094,Lluçà,2016,280,135,145,48,189,43
400,171024,Maçanet de Cabrenys,2016,740,375,365,81,450,209
401,171030,Maçanet de la Selva,2016,6819,3507,3312,1098,4519,1202
402,170979,Madremanya,2016,280,141,139,55,173,52
403,170985,Maià de Montcal,2016,433,228,205,65,279,89
404,251333,Maials,2016,950,513,437,103,573,274
405,251305,Maldà,2016,230,116,114,26,137,67
406,081108,Malgrat de Mar,2016,18295,9118,9177,2793,11950,3552
407,081115,Malla,2016,267,135,132,37,172,58
408,081120,Manlleu,2016,20104,10033,10071,3597,13056,3451
409,081136,Manresa,2016,74752,36545,38207,12029,47874,14849
410,430764,Marçà,2016,586,309,277,76,375,135
411,430751,Margalef,2016,97,59,38,3,60,34
412,082423,Marganell,2016,277,136,141,30,178,69
413,081141,Martorell,2016,27645,14073,13572,5184,18055,4406
414,081154,Martorelles,2016,4725,2356,2369,661,3147,917
415,430770,Mas de Barberans,2016,605,296,309,61,360,184
416,171002,Masarac,2016,289,151,138,40,193,56
417,430786,Masdenverge,2016,1088,555,533,140,688,260
418,081167,"Masies de Roda, les",2016,714,360,354,95,465,154
419,081173,"Masies de Voltregà, les",2016,3170,1564,1606,514,2123,533
420,430799,Masllorenç,2016,502,272,230,82,323,97
421,081189,"Masnou, el",2016,23119,11131,11988,3436,15420,4263
422,430803,"Masó, la",2016,290,155,135,39,163,88
423,430810,Maspujols,2016,774,400,374,135,522,117
424,081192,Masquefa,2016,8386,4220,4166,1597,5659,1130
425,430825,"Masroig, el",2016,494,273,221,62,276,156
426,251312,Massalcoreig,2016,571,313,258,44,395,132
427,171019,Massanes,2016,742,400,342,140,464,138
428,251327,Massoteres,2016,203,110,93,39,128,36
429,081206,Matadepera,2016,8984,4508,4476,1690,5880,1414
430,081213,Mataró,2016,125517,62355,63162,20886,83536,21095
431,171045,Medinyà,2016,0,0,0,0,0,0
432,081228,Mediona,2016,2282,1143,1139,404,1371,507
433,251348,Menàrguens,2016,847,473,374,71,564,212
434,170998,Meranges,2016,99,59,40,15,61,23
435,171058,Mieres,2016,317,161,156,39,206,72
436,430831,"Milà, el",2016,178,89,89,25,107,46
437,251351,Miralcamp,2016,1369,686,683,212,871,286
438,430846,Miravet,2016,737,398,339,103,443,191
439,081385,Moià,2016,5957,2995,2962,1046,3877,1034
440,430859,"Molar, el",2016,282,148,134,20,173,89
441,081234,Molins de Rei,2016,25359,12342,13017,4534,16677,4148
442,251370,Mollerussa,2016,14585,7465,7120,2755,9849,1981
443,171061,Mollet de Peralada,2016,180,98,82,29,93,58
444,081249,Mollet del Vallès,2016,51491,25498,25993,8742,34688,8061
445,171077,Molló,2016,335,163,172,48,201,86
446,251364,"Molsosa, la",2016,111,54,57,8,71,32
447,081287,Monistrol de Calders,2016,699,363,336,86,466,147
448,081271,Monistrol de Montserrat,2016,2867,1456,1411,412,1889,566
449,171096,Montagut i Oix,2016,929,485,444,131,610,188
450,430862,Montblanc,2016,7290,3682,3608,1126,4835,1329
451,430884,Montbrió del Camp,2016,2779,1428,1351,513,1866,400
452,081252,Montcada i Reixac,2016,34802,17170,17632,6168,23410,5224
453,081304,Montclar,2016,119,58,61,20,71,28
454,251399,Montellà i Martinet,2016,547,302,245,49,360,138
455,081311,Montesquiu,2016,931,465,466,157,582,192
456,251403,Montferrer i Castellbò,2016,1050,566,484,164,706,180
457,430897,Montferri,2016,400,217,183,77,260,63
458,251386,Montgai,2016,651,335,316,57,382,212
459,081265,Montgat,2016,11621,5759,5862,2032,7901,1688
460,081326,Montmajor,2016,471,234,237,63,286,122
461,081332,Montmaneu,2016,151,78,73,14,91,46
462,430901,"Montmell, el",2016,1397,747,650,224,915,258
463,081350,Montmeló,2016,8784,4299,4485,1369,5878,1537
464,251425,Montoliu de Lleida,2016,495,251,244,52,314,129
465,251410,Montoliu de Segarra,2016,188,105,83,24,110,54
466,251431,Montornès de Segarra,2016,100,50,50,14,50,36
467,081363,Montornès del Vallès,2016,16218,8220,7998,3022,10917,2279
468,430918,Mont-ral,2016,166,94,72,22,114,30
469,171100,Mont-ras,2016,1690,853,837,219,1154,317
470,430923,Mont-roig del Camp,2016,11521,5970,5551,1780,7753,1988
471,081379,Montseny,2016,320,166,154,47,193,80
472,430939,Móra d'Ebre,2016,5574,2765,2809,867,3684,1023
473,430944,Móra la Nova,2016,3104,1564,1540,423,2062,619
474,430957,"Morell, el",2016,3550,1808,1742,667,2429,454
475,430960,"Morera de Montsant, la",2016,153,89,64,19,102,32
476,081290,Muntanyola,2016,604,312,292,115,413,76
477,081398,Mura,2016,219,118,101,37,137,45
478,251459,Nalec,2016,100,52,48,4,57,39
479,250254,Naut Aran,2016,1764,899,865,266,1279,219
480,081402,Navarcles,2016,5988,2915,3073,849,3957,1182
481,081419,Navàs,2016,6045,3017,3028,920,3891,1234
482,171117,Navata,2016,1329,652,677,240,867,222
483,251462,Navès,2016,283,137,146,44,179,60
484,081424,"Nou de Berguedà, la",2016,151,75,76,13,90,48
485,430976,"Nou de Gaià, la",2016,546,268,278,111,321,114
486,430982,Nulles,2016,453,237,216,74,280,99
487,251484,Odèn,2016,259,150,109,18,171,70
488,081430,Òdena,2016,3607,1842,1765,687,2341,579
489,171122,Ogassa,2016,225,132,93,30,143,52
490,081458,Olèrdola,2016,3529,1824,1705,658,2334,537
491,081461,Olesa de Bonesvalls,2016,1723,898,825,309,1147,267
492,081477,Olesa de Montserrat,2016,23645,11844,11801,4459,15576,3610
493,251497,Oliana,2016,1844,929,915,212,1142,490
494,251500,Oliola,2016,220,123,97,20,139,61
495,251517,Olius,2016,929,488,441,203,576,150
496,081483,Olivella,2016,3569,1897,1672,720,2441,408
497,081496,Olost,2016,1185,599,586,137,763,285
498,171143,Olot,2016,34000,16892,17108,5186,22159,6655
499,251522,"Oluges, les",2016,152,81,71,13,83,56
500,081445,Olvan,2016,855,419,436,102,537,216
501,251538,"Omellons, els",2016,217,116,101,14,121,82
502,251543,"Omells de na Gaia, els",2016,137,74,63,9,84,44
503,171156,Ordis,2016,377,200,177,61,243,73
504,251556,Organyà,2016,804,399,405,88,480,236
505,081509,Orís,2016,310,157,153,40,220,50
506,081516,Oristà,2016,547,267,280,64,330,153
507,081521,Orpí,2016,139,76,63,19,91,29
508,081537,Òrrius,2016,702,370,332,115,478,109
509,251569,Os de Balaguer,2016,1022,514,508,170,634,218
510,171169,Osor,2016,434,221,213,58,279,97
511,251575,Ossó de Sió,2016,214,105,109,28,126,60
512,081542,Pacs del Penedès,2016,894,457,437,144,613,137
513,081555,Palafolls,2016,9133,4605,4528,1723,6234,1176
514,171175,Palafrugell,2016,22868,11342,11526,3962,14986,3920
515,171181,Palamós,2016,17677,8633,9044,2566,11751,3360
516,251581,"Palau d'Anglesola, el",2016,2153,1053,1100,344,1397,412
517,171194,Palau de Santa Eulàlia,2016,90,54,36,10,61,19
518,171215,Palau-sator,2016,297,156,141,48,180,69
519,171208,Palau-saverdera,2016,1471,732,739,276,891,304
520,081568,Palau-solità i Plegamans,2016,14494,7135,7359,2534,9783,2177
521,431009,"Pallaresos, els",2016,4597,2322,2275,1041,3117,439
522,081574,Pallejà,2016,11348,5656,5692,2147,7519,1682
523,430995,"Palma d'Ebre, la",2016,363,172,191,28,205,130
524,089058,"Palma de Cervelló, la",2016,3000,1494,1506,453,2104,443
525,171236,Palol de Revardit,2016,470,236,234,77,294,99
526,171241,Pals,2016,2423,1227,1196,359,1547,517
527,081580,"Papiol, el",2016,4075,2021,2054,718,2725,632
528,171254,Pardines,2016,158,85,73,20,99,39
529,081593,Parets del Vallès,2016,18837,9477,9360,3270,12907,2660
530,171267,Parlavà,2016,392,208,184,54,251,87
531,431016,Passanant i Belltall,2016,161,93,68,4,104,53
532,171289,Pau,2016,551,280,271,79,337,135
533,431021,Paüls,2016,580,280,300,62,328,190
534,171292,Pedret i Marzà,2016,180,98,82,33,116,31
535,251641,Penelles,2016,474,271,203,58,287,129
536,171306,"Pera, la",2016,441,208,233,70,266,105
537,081607,Perafita,2016,411,207,204,46,261,104
538,431037,Perafort,2016,1282,679,603,292,846,144
539,171328,Peralada,2016,1835,916,919,289,1200,346
540,251654,Peramola,2016,344,172,172,33,214,97
541,431042,"Perelló, el",2016,2903,1502,1401,367,1733,803
542,081614,Piera,2016,15001,7648,7353,2642,9863,2496
543,431055,"Piles, les",2016,207,112,95,35,132,40
544,081635,Pineda de Mar,2016,26240,13107,13133,3945,17124,5171
545,431068,"Pinell de Brai, el",2016,1014,510,504,113,607,294
546,251667,Pinell de Solsonès,2016,213,125,88,20,133,60
547,251673,Pinós,2016,297,160,137,46,179,72
548,431074,Pira,2016,500,268,232,90,320,90
549,431080,"Pla de Santa Maria, el",2016,2294,1191,1103,330,1519,445
550,081640,"Pla del Penedès, el",2016,1253,623,630,226,808,219
551,171334,"Planes d'Hostoles, les",2016,1662,834,828,229,980,453
552,171349,Planoles,2016,299,163,136,37,193,69
553,259118,"Plans de Sió, els",2016,523,280,243,51,315,157
554,251689,"Poal, el",2016,655,343,312,79,409,167
555,251692,"Pobla de Cérvoles, la",2016,206,115,91,18,126,62
556,081653,"Pobla de Claramunt, la",2016,2159,1091,1068,385,1370,404
557,081666,"Pobla de Lillet, la",2016,1110,542,568,81,658,371
558,431093,"Pobla de Mafumet, la",2016,3771,1939,1832,787,2696,288
559,431107,"Pobla de Massaluca, la",2016,333,179,154,36,176,121
560,431114,"Pobla de Montornès, la",2016,2806,1473,1333,477,1801,528
561,251713,"Pobla de Segur, la",2016,2973,1475,1498,416,1795,762
562,431129,Poboleda,2016,374,204,170,45,227,102
563,081672,Polinyà,2016,8300,4210,4090,1833,5693,774
564,431135,"Pont d'Armentera, el",2016,515,264,251,60,315,140
565,250306,"Pont de Bar, el",2016,165,92,73,23,97,45
566,171352,Pont de Molins,2016,517,255,262,79,347,91
567,251734,"Pont de Suert, el",2016,2293,1156,1137,312,1519,462
568,081825,"Pont de Vilomara i Rocafort, el",2016,3724,1919,1805,636,2441,647
569,431418,Pontils,2016,120,65,55,9,77,34
570,081688,Pontons,2016,453,259,194,43,313,97
571,171365,Pontós,2016,234,131,103,32,148,54
572,251728,Ponts,2016,2638,1310,1328,382,1668,588
573,171371,Porqueres,2016,4530,2238,2292,786,2986,758
574,431140,Porrera,2016,445,238,207,33,306,106
575,171404,"Port de la Selva, el",2016,994,522,472,113,620,261
576,171387,Portbou,2016,1170,576,594,93,687,390
577,251749,"Portella, la",2016,741,409,332,100,517,124
578,431153,Pradell de la Teixeta,2016,174,76,98,20,110,44
579,431166,Prades,2016,587,307,280,72,363,152
580,431172,Prat de Comte,2016,177,94,83,23,101,53
581,081691,"Prat de Llobregat, el",2016,63457,31163,32294,10077,41912,11468
582,431188,Pratdip,2016,691,366,325,68,397,226
583,081712,Prats de Lluçanès,2016,2565,1286,1279,314,1678,573
584,081705,"Prats de Rei, els",2016,535,284,251,62,340,133
585,251752,Prats i Sansor,2016,238,123,115,27,163,48
586,251765,Preixana,2016,382,197,185,46,201,135
587,251771,Preixens,2016,448,229,219,52,243,153
588,082303,Premià de Dalt,2016,10446,5260,5186,1766,6982,1698
589,081727,Premià de Mar,2016,27866,13617,14249,4322,18357,5187
590,171390,"Preses, les",2016,1781,889,892,307,1165,309
591,251790,Prullans,2016,208,103,105,24,126,58
592,171411,Puigcerdà,2016,8810,4407,4403,1389,6046,1375
593,081748,Puigdàlber,2016,512,253,259,99,319,94
594,251804,Puiggròs,2016,287,145,142,38,175,74
595,431191,Puigpelat,2016,1121,572,549,235,771,115
596,081751,Puig-reig,2016,4123,2001,2122,490,2541,1092
597,251811,Puigverd d'Agramunt,2016,237,133,104,31,147,59
598,251826,Puigverd de Lleida,2016,1373,707,666,218,886,269
599,081764,Pujalt,2016,198,107,91,32,121,45
600,081770,"Quar, la",2016,54,28,26,7,33,14
601,171426,Quart,2016,3478,1744,1734,754,2290,434
602,170433,Queralbs,2016,174,99,75,8,117,49
603,431205,Querol,2016,543,306,237,66,366,111
604,171432,Rabós,2016,188,92,96,20,109,59
605,081786,Rajadell,2016,533,269,264,72,346,115
606,431212,Rasquera,2016,819,399,420,85,476,258
607,171447,Regencós,2016,279,143,136,41,176,62
608,081799,Rellinars,2016,723,374,349,118,498,107
609,431227,Renau,2016,148,77,71,33,100,15
610,431233,Reus,2016,103615,50188,53427,18069,68155,17391
611,251832,Rialp,2016,669,347,322,94,465,110
612,431248,"Riba, la",2016,594,324,270,68,363,163
613,431251,Riba-roja d'Ebre,2016,1156,611,545,108,713,335
614,259059,Ribera d'Ondara,2016,446,227,219,51,271,124
615,251850,Ribera d'Urgellet,2016,962,504,458,151,626,185
616,171450,Ribes de Freser,2016,1785,882,903,182,1078,525
617,171463,Riells i Viabrea,2016,3927,2023,1904,652,2759,516
618,431264,"Riera de Gaià, la",2016,1694,846,848,374,1071,249
619,251863,Riner,2016,261,128,133,36,155,70
620,171479,Ripoll,2016,10583,5194,5389,1445,6735,2403
621,081803,Ripollet,2016,37648,18646,19002,7000,25222,5426
622,259139,Riu de Cerdanya,2016,97,55,42,5,75,17
623,171485,Riudarenes,2016,2120,1090,1030,355,1377,388
624,171498,Riudaura,2016,466,222,244,80,297,89
625,431270,Riudecanyes,2016,1116,587,529,193,704,219
626,431286,Riudecols,2016,1169,614,555,153,779,237
627,171501,Riudellots de la Selva,2016,2024,1023,1001,333,1387,304
628,431299,Riudoms,2016,6591,3397,3194,1160,4231,1200
629,171518,Riumors,2016,255,128,127,39,159,57
630,081810,"Roca del Vallès, la",2016,10599,5307,5292,1990,7069,1540
631,431303,Rocafort de Queralt,2016,251,133,118,34,136,81
632,431310,Roda de Berà,2016,6391,3309,3082,1050,4055,1286
633,081831,Roda de Ter,2016,6116,3001,3115,1029,3988,1099
634,431325,Rodonyà,2016,492,254,238,66,325,101
635,431331,Roquetes,2016,8165,4241,3924,1341,5410,1414
636,171523,Roses,2016,19438,9722,9716,3269,12785,3384
637,251898,Rosselló,2016,3029,1516,1513,516,2085,428
638,431346,"Rourell, el",2016,398,203,195,63,266,69
639,081846,Rubí,2016,75167,37221,37946,13085,51052,11030
640,081859,Rubió,2016,231,126,105,28,149,54
641,171539,Rupià,2016,253,129,124,39,157,57
642,089019,Rupit i Pruit,2016,277,142,135,26,170,81
643,081878,Sabadell,2016,208246,101341,106905,33915,136063,38268
644,081884,Sagàs,2016,152,83,69,28,98,26
645,251902,Salàs de Pallars,2016,340,183,157,38,209,93
646,081901,Saldes,2016,276,159,117,14,188,74
647,171544,Sales de Llierca,2016,137,71,66,20,101,16
648,081918,Sallent,2016,6592,3170,3422,903,4030,1659
649,431359,Salomó,2016,540,277,263,93,325,122
650,439057,Salou,2016,26386,13738,12648,4158,19217,3011
651,171557,Salt,2016,29404,15438,13966,6087,19720,3597
652,251919,Sanaüja,2016,425,216,209,52,256,117
653,081944,Sant Adrià de Besòs,2016,36496,18029,18467,6255,23953,6288
654,081957,Sant Agustí de Lluçanès,2016,92,46,46,7,65,20
655,081960,Sant Andreu de la Barca,2016,27434,13694,13740,5519,18204,3711
656,081976,Sant Andreu de Llavaneres,2016,10663,5274,5389,1871,7046,1746
657,171576,Sant Andreu Salou,2016,155,82,73,22,96,37
658,171833,Sant Aniol de Finestres,2016,371,197,174,59,244,68
659,081982,Sant Antoni de Vilamajor,2016,5862,2932,2930,1007,3998,857
660,081995,Sant Bartomeu del Grau,2016,850,444,406,110,587,153
661,082009,Sant Boi de Llobregat,2016,82402,40369,42033,13137,54281,14984
662,082016,Sant Boi de Lluçanès,2016,527,263,264,56,304,167
663,431362,Sant Carles de la Ràpita,2016,14718,7220,7498,2105,9456,3157
664,082037,Sant Cebrià de Vallalta,2016,3329,1732,1597,633,2230,466
665,082021,Sant Celoni,2016,17540,8719,8821,3067,11508,2965
666,082042,Sant Climent de Llobregat,2016,4024,2022,2002,813,2698,513
667,171582,Sant Climent Sescebes,2016,641,375,266,79,432,130
668,082055,Sant Cugat del Vallès,2016,88921,43254,45667,17887,59525,11509
669,082068,Sant Cugat Sesgarrigues,2016,973,475,498,171,609,193
670,251961,Sant Esteve de la Sarga,2016,139,87,52,10,89,40
671,082074,Sant Esteve de Palautordera,2016,2599,1277,1322,512,1734,353
672,082080,Sant Esteve Sesrovires,2016,7644,3820,3824,1387,5128,1129
673,171595,Sant Feliu de Buixalleu,2016,799,417,382,113,533,153
674,082107,Sant Feliu de Codines,2016,5968,3008,2960,1024,3983,961
675,171609,Sant Feliu de Guíxols,2016,21760,10763,10997,3405,14214,4141
676,082114,Sant Feliu de Llobregat,2016,44086,21405,22681,7436,28811,7839
677,171616,Sant Feliu de Pallerols,2016,1317,645,672,213,816,288
678,082129,Sant Feliu Sasserra,2016,612,323,289,82,388,142
679,171621,Sant Ferriol,2016,231,131,100,41,157,33
680,082093,Sant Fost de Campsentelles,2016,8650,4316,4334,1317,5706,1627
681,082135,Sant Fruitós de Bages,2016,8387,4161,4226,1538,5625,1224
682,171637,Sant Gregori,2016,3553,1787,1766,693,2341,519
683,251924,Sant Guim de Freixenet,2016,1059,553,506,154,650,255
684,251977,Sant Guim de la Plana,2016,170,94,76,19,99,52
685,171642,Sant Hilari Sacalm,2016,5570,2811,2759,849,3567,1154
686,082153,Sant Hipòlit de Voltregà,2016,3462,1701,1761,547,2257,658
687,081939,Sant Iscle de Vallalta,2016,1292,669,623,249,842,201
688,439023,Sant Jaume d'Enveja,2016,3516,1761,1755,508,2162,846
689,082166,Sant Jaume de Frontanyà,2016,27,18,9,2,16,9
690,171655,Sant Jaume de Llierca,2016,873,424,449,131,536,206
691,431378,Sant Jaume dels Domenys,2016,2543,1312,1231,481,1654,408
692,171674,Sant Joan de les Abadesses,2016,3342,1660,1682,406,2005,931
693,171680,Sant Joan de Mollet,2016,495,237,258,77,326,92
694,082188,Sant Joan de Vilatorrada,2016,10759,5390,5369,1810,6982,1967
695,082172,Sant Joan Despí,2016,33502,16356,17146,5818,22181,5503
696,171851,Sant Joan les Fonts,2016,2906,1454,1452,386,1816,704
697,171668,Sant Jordi Desvalls,2016,700,347,353,104,444,152
698,089030,Sant Julià de Cerdanyola,2016,251,139,112,30,158,63
699,171693,Sant Julià de Ramis,2016,3455,1747,1708,708,2307,440
700,082205,Sant Julià de Vilatorta,2016,3113,1523,1590,555,2060,498
701,179032,Sant Julià del Llor i Bonmatí,2016,1282,663,619,246,838,198
702,082212,Sant Just Desvern,2016,16927,8123,8804,2855,10887,3185
703,082227,Sant Llorenç d'Hortons,2016,2562,1302,1260,480,1714,368
704,171714,Sant Llorenç de la Muga,2016,247,126,121,35,157,55
705,251930,Sant Llorenç de Morunys,2016,966,474,492,116,567,283
706,082233,Sant Llorenç Savall,2016,2375,1208,1167,351,1508,516
707,082251,Sant Martí d'Albars,2016,108,54,54,12,63,33
708,082248,Sant Martí de Centelles,2016,1122,581,541,168,796,158
709,171729,Sant Martí de Llémena,2016,618,324,294,100,426,92
710,259025,Sant Martí de Riucorb,2016,674,353,321,77,376,221
711,082264,Sant Martí de Tous,2016,1190,603,587,240,724,226
712,082270,Sant Martí Sarroca,2016,3099,1516,1583,524,1987,588
713,082286,Sant Martí Sesgueioles,2016,371,190,181,53,245,73
714,171735,Sant Martí Vell,2016,250,128,122,40,158,52
715,082299,Sant Mateu de Bages,2016,618,311,307,56,365,197
716,171740,Sant Miquel de Campmajor,2016,226,119,107,34,147,45
717,171753,Sant Miquel de Fluvià,2016,742,387,355,95,509,138
718,171766,Sant Mori,2016,176,98,78,28,114,34
719,171772,Sant Pau de Segúries,2016,670,327,343,82,419,169
720,082310,Sant Pere de Ribes,2016,29842,14928,14914,5325,20368,4149
721,082325,Sant Pere de Riudebitlles,2016,2369,1187,1182,439,1421,509
722,082331,Sant Pere de Torelló,2016,2427,1246,1181,349,1587,491
723,082346,Sant Pere de Vilamajor,2016,4257,2133,2124,805,2826,626
724,171788,Sant Pere Pescador,2016,2134,1153,981,357,1450,327
725,081897,Sant Pere Sallavinera,2016,158,86,72,25,93,40
726,082359,Sant Pol de Mar,2016,4951,2450,2501,793,3139,1019
727,082362,Sant Quintí de Mediona,2016,2121,1079,1042,366,1352,403
728,082378,Sant Quirze de Besora,2016,2125,1052,1073,279,1292,554
729,082384,Sant Quirze del Vallès,2016,19664,9687,9977,3872,13340,2452
730,082397,Sant Quirze Safaja,2016,637,339,298,137,421,79
731,251945,Sant Ramon,2016,509,275,234,47,311,151
732,082401,Sant Sadurní d'Anoia,2016,12654,6221,6433,2238,8388,2028
733,082418,Sant Sadurní d'Osormort,2016,80,49,31,5,55,20
734,080983,Sant Salvador de Guardiola,2016,3141,1590,1551,570,2020,551
735,082628,Sant Vicenç de Castellet,2016,9235,4586,4649,1487,6026,1722
736,082649,Sant Vicenç de Montalt,2016,6182,3073,3109,1180,4051,951
737,082652,Sant Vicenç de Torelló,2016,1996,982,1014,331,1285,380
738,082634,Sant Vicenç dels Horts,2016,27961,13936,14025,4690,18941,4330
739,431384,Santa Bàrbara,2016,3774,1926,1848,558,2416,800
740,082439,Santa Cecília de Voltregà,2016,183,96,87,19,126,38
741,082444,Santa Coloma de Cervelló,2016,8073,3960,4113,1740,5361,972
742,171805,Santa Coloma de Farners,2016,12583,6361,6222,2239,8327,2017
743,082457,Santa Coloma de Gramenet,2016,117153,58288,58865,18084,76190,22879
744,431397,Santa Coloma de Queralt,2016,2726,1347,1379,440,1657,629
745,171812,Santa Cristina d'Aro,2016,5128,2571,2557,858,3427,843
746,082460,Santa Eugènia de Berga,2016,2246,1148,1098,311,1557,378
747,082476,Santa Eulàlia de Riuprimer,2016,1266,641,625,254,824,188
748,082482,Santa Eulàlia de Ronçana,2016,7049,3544,3505,1238,4620,1191
749,082495,Santa Fe del Penedès,2016,374,191,183,71,251,52
750,171827,Santa Llogaia d'Àlguema,2016,343,179,164,61,237,45
751,082508,Santa Margarida de Montbui,2016,9611,4800,4811,1727,6279,1605
752,082515,Santa Margarida i els Monjos,2016,7360,3769,3591,1493,4882,985
753,082589,Santa Maria d'Oló,2016,1054,542,512,154,653,247
754,082536,Santa Maria de Besora,2016,148,75,73,15,87,46
755,082567,Santa Maria de Martorelles,2016,861,436,425,150,586,125
756,082554,Santa Maria de Merlès,2016,178,87,91,39,109,30
757,082573,Santa Maria de Miralles,2016,132,71,61,15,85,32
758,082592,Santa Maria de Palautordera,2016,9194,4633,4561,1596,6185,1413
759,431401,Santa Oliva,2016,3260,1657,1603,574,2109,577
760,171848,Santa Pau,2016,1524,769,755,201,1001,322
761,082606,Santa Perpètua de Mogoda,2016,25556,12920,12636,4824,17219,3513
762,082613,Santa Susanna,2016,3323,1698,1625,581,2224,518
763,081923,Santpedor,2016,7520,3732,3788,1393,4923,1204
764,431423,Sarral,2016,1587,811,776,266,998,323
765,171864,Sarrià de Ter,2016,5035,2498,2537,868,3306,861
766,252017,Sarroca de Bellera,2016,117,69,48,1,80,36
767,252000,Sarroca de Lleida,2016,374,204,170,26,212,136
768,171870,"Saus, Camallera i Llampaies",2016,842,419,423,126,539,177
769,431439,Savallà del Comtat,2016,59,29,30,2,39,18
770,431444,"Secuita, la",2016,1692,850,842,292,1147,253
771,171886,"Selva de Mar, la",2016,188,106,82,13,130,45
772,431457,"Selva del Camp, la",2016,5591,2813,2778,984,3743,864
773,431460,Senan,2016,51,33,18,6,35,10
774,430445,"Sénia, la",2016,5654,2835,2819,837,3705,1112
775,252022,Senterada,2016,133,80,53,11,100,22
776,250352,"Sentiu de Sió, la",2016,462,239,223,49,291,122
777,082671,Sentmenat,2016,8700,4391,4309,1602,5907,1191
778,171903,Serinyà,2016,1132,580,552,196,733,203
779,252043,Seròs,2016,1912,1035,877,264,1212,436
780,171910,Serra de Daró,2016,209,116,93,35,125,49
781,171925,Setcases,2016,181,98,83,15,120,46
782,252038,"Seu d'Urgell, la",2016,12185,5864,6321,1798,8172,2215
783,082690,Seva,2016,3446,1734,1712,574,2269,603
784,252056,Sidamon,2016,734,383,351,120,496,118
785,171931,Sils,2016,5910,3000,2910,1057,3920,933
786,082704,Sitges,2016,28478,14232,14246,4361,19199,4918
787,170524,Siurana,2016,155,72,83,19,95,41
788,082711,Sobremunt,2016,83,33,50,6,58,19
789,252069,"Soleràs, el",2016,350,181,169,46,187,117
790,431476,Solivella,2016,619,314,305,75,372,172
791,252075,Solsona,2016,8914,4425,4489,1443,5817,1654
792,082726,Sora,2016,189,106,83,26,128,35
793,252081,Soriguera,2016,408,221,187,57,285,66
794,252094,Sort,2016,2145,1068,1077,354,1413,378
795,252108,Soses,2016,1698,880,818,276,1091,331
796,082732,Subirats,2016,2997,1554,1443,468,1954,575
797,252115,Sudanell,2016,867,481,386,104,558,205
798,252120,Sunyer,2016,350,200,150,27,241,82
799,082747,Súria,2016,5873,2841,3032,764,3749,1360
800,171946,Susqueda,2016,95,57,38,5,67,23
801,082763,Tagamanent,2016,316,170,146,46,221,49
802,082779,Talamanca,2016,186,106,80,20,125,41
803,252154,Talarn,2016,689,462,227,59,547,83
804,252167,Talavera,2016,257,141,116,26,143,88
805,171959,"Tallada d'Empordà, la",2016,451,233,218,67,289,95
806,082785,Taradell,2016,6321,3138,3183,1060,4125,1136
807,431482,Tarragona,2016,131094,63798,67296,21409,86712,22973
808,252173,Tàrrega,2016,16481,8192,8289,2934,10954,2593
809,252189,Tarrés,2016,100,57,43,17,58,25
810,252192,Tarroja de Segarra,2016,182,101,81,25,113,44
811,082750,Tavèrnoles,2016,318,161,157,47,218,53
812,082802,Tavertet,2016,112,62,50,10,75,27
813,082819,Teià,2016,6254,3073,3181,973,4082,1199
814,252206,Térmens,2016,1526,760,766,176,1004,346
815,171962,Terrades,2016,285,140,145,37,188,60
816,082798,Terrassa,2016,215121,105879,109242,37844,142124,35153
817,082824,Tiana,2016,8553,4082,4471,1495,5740,1318
818,252213,Tírvia,2016,143,68,75,11,98,34
819,252228,Tiurana,2016,73,35,38,4,45,24
820,431495,Tivenys,2016,887,451,436,97,517,273
821,431508,Tivissa,2016,1684,847,837,201,1028,455
822,082830,Tona,2016,7951,3930,4021,1371,5183,1397
823,252234,Torà,2016,1215,610,605,142,787,286
824,082845,Tordera,2016,16453,8343,8110,2920,10790,2743
825,082858,Torelló,2016,13877,6826,7051,2181,9136,2560
826,252249,"Torms, els",2016,149,84,65,12,80,57
827,252252,Tornabous,2016,882,473,409,117,533,232
828,252271,"Torre de Cabdella, la",2016,748,379,369,57,479,212
829,082861,"Torre de Claramunt, la",2016,3722,1898,1824,627,2533,562
830,431515,"Torre de Fontaubella, la",2016,134,69,65,20,77,37
831,431520,"Torre de l'Espanyol, la",2016,635,331,304,82,382,171
832,252265,Torrebesses,2016,293,155,138,28,175,90
833,431536,Torredembarra,2016,15460,7557,7903,2514,10210,2736
834,252287,Torrefarrera,2016,4630,2361,2269,981,3152,497
835,259078,Torrefeta i Florejacs,2016,590,310,280,61,351,178
836,252304,Torregrossa,2016,2166,1097,1069,296,1363,507
837,252311,Torrelameu,2016,703,401,302,82,464,157
838,082877,Torrelavit,2016,1413,737,676,241,918,254
839,082883,Torrelles de Foix,2016,2201,1171,1030,332,1433,436
840,082896,Torrelles de Llobregat,2016,5933,2934,2999,1181,4041,711
841,171978,Torrent,2016,163,91,72,22,103,38
842,252326,Torres de Segre,2016,2253,1155,1098,278,1551,424
843,252332,Torre-serona,2016,379,198,181,49,241,89
844,171984,Torroella de Fluvià,2016,711,379,332,101,496,114
845,171997,Torroella de Montgrí,2016,11506,5823,5683,1897,7645,1964
846,431541,Torroja del Priorat,2016,153,85,68,10,90,53
847,172001,Tortellà,2016,781,383,398,109,494,178
848,431554,Tortosa,2016,33743,16837,16906,5161,21852,6730
849,172018,Toses,2016,166,100,66,21,113,32
850,172023,Tossa de Mar,2016,5498,2788,2710,748,3696,1054
851,252347,Tremp,2016,6026,2976,3050,868,3800,1358
852,172044,Ullà,2016,1077,597,480,195,726,156
853,082900,Ullastrell,2016,2039,1023,1016,453,1306,280
854,172057,Ullastret,2016,288,144,144,48,180,60
855,431567,Ulldecona,2016,6368,3271,3097,1000,4107,1261
856,431573,Ulldemolins,2016,401,227,174,30,235,136
857,172039,Ultramort,2016,210,118,92,35,122,53
858,172060,Urús,2016,181,84,97,19,125,37
859,082917,Vacarisses,2016,6192,3189,3003,1319,4094,779
860,170144,"Vajol, la",2016,83,48,35,5,63,15
861,172076,"Vall d'en Bas, la",2016,2983,1505,1478,499,1910,574
862,172082,"Vall de Bianya, la",2016,1266,635,631,211,826,229
863,250432,"Vall de Boí, la",2016,1022,549,473,120,728,174
864,259010,Vall de Cardós,2016,356,194,162,43,233,80
865,082922,Vallbona d'Anoia,2016,1412,742,670,228,924,260
866,252385,Vallbona de les Monges,2016,241,127,114,21,133,87
867,082938,Vallcebre,2016,254,143,111,21,159,74
868,431589,Vallclara,2016,110,62,48,19,64,27
869,252402,Vallfogona de Balaguer,2016,1868,924,944,300,1245,323
870,171707,Vallfogona de Ripollès,2016,200,111,89,21,118,61
871,431592,Vallfogona de Riucorb,2016,94,57,37,1,58,35
872,082943,Vallgorguina,2016,2772,1409,1363,593,1851,328
873,082956,Vallirana,2016,14676,7331,7345,2719,9595,2362
874,172095,Vall-llobrega,2016,922,457,465,202,625,95
875,431606,Vallmoll,2016,1645,824,821,249,1113,283
876,082969,Vallromanes,2016,2525,1296,1229,531,1691,303
877,431613,Valls,2016,24285,12101,12184,4008,16059,4218
878,259062,"Valls d'Aguilar, les",2016,291,163,128,27,186,78
879,252398,"Valls de Valira, les",2016,817,418,399,107,553,157
880,431628,Vandellòs i l'Hospitalet de l'Infant,2016,6143,3074,3069,1036,4090,1017
881,259097,"Vansa i Fórnols, la",2016,200,103,97,11,133,56
882,082975,Veciana,2016,173,95,78,30,94,49
883,431634,"Vendrell, el",2016,36482,18162,18320,6305,23914,6263
884,172109,Ventalló,2016,802,403,399,122,507,173
885,252424,Verdú,2016,933,443,490,107,549,277
886,172116,Verges,2016,1150,559,591,179,694,277
887,431649,Vespella de Gaià,2016,421,231,190,69,267,85
888,082981,Vic,2016,43287,21590,21697,7847,28683,6757
889,172121,Vidrà,2016,176,91,85,26,121,29
890,172137,Vidreres,2016,7632,3949,3683,1273,5066,1293
891,252430,Vielha e Mijaran,2016,5459,2772,2687,777,4041,641
892,431652,Vilabella,2016,760,393,367,96,480,184
893,172142,Vilabertran,2016,919,467,452,159,568,192
894,172155,Vilablareix,2016,2636,1302,1334,454,1804,378
895,082994,Vilada,2016,430,228,202,25,266,139
896,172174,Viladamat,2016,466,238,228,60,302,104
897,172168,Viladasens,2016,224,114,110,35,154,35
898,083015,Viladecans,2016,65779,32673,33106,11854,43850,10075
899,083008,Viladecavalls,2016,7354,3663,3691,1266,5142,946
900,172180,Vilademuls,2016,808,426,382,142,511,155
901,172207,Viladrau,2016,1030,518,512,151,678,201
902,172214,Vilafant,2016,5466,2689,2777,913,3662,891
903,083054,Vilafranca del Penedès,2016,39365,19255,20110,6954,25765,6646
904,252445,Vilagrassa,2016,510,264,246,84,336,90
905,172235,Vilajuïga,2016,1155,570,585,199,755,201
906,431750,Vilalba dels Arcs,2016,658,331,327,62,379,217
907,083067,Vilalba Sasserra,2016,684,341,343,135,443,106
908,252458,Vilaller,2016,552,295,257,67,353,132
909,172240,Vilallonga de Ter,2016,400,204,196,40,255,105
910,431665,Vilallonga del Camp,2016,2255,1158,1097,462,1494,299
911,172253,Vilamacolum,2016,320,163,157,52,202,66
912,172266,Vilamalla,2016,1121,567,554,180,740,201
913,172272,Vilamaniscle,2016,202,109,93,35,136,31
914,252477,Vilamòs,2016,151,81,70,17,119,15
915,172288,Vilanant,2016,405,206,199,73,262,70
916,431671,Vilanova d'Escornalbou,2016,542,286,256,84,349,109
917,252483,Vilanova de Bellpuig,2016,1168,602,566,172,665,331
918,252496,Vilanova de l'Aguda,2016,213,105,108,20,123,70
919,252542,Vilanova de la Barca,2016,1054,535,519,147,670,237
920,252509,Vilanova de Meià,2016,414,232,182,44,246,124
921,431687,Vilanova de Prades,2016,118,62,56,16,72,30
922,083036,Vilanova de Sau,2016,309,153,156,26,204,79
923,252516,Vilanova de Segrià,2016,941,498,443,125,627,189
924,083020,Vilanova del Camí,2016,12409,6218,6191,2269,8240,1900
925,089024,Vilanova del Vallès,2016,5217,2637,2580,1175,3488,554
926,083073,Vilanova i la Geltrú,2016,65972,31973,33999,10250,43724,11998
927,431690,Vilaplana,2016,590,302,288,62,406,122
928,431704,Vila-rodona,2016,1255,647,608,205,818,232
929,172305,Vila-sacra,2016,713,341,372,136,446,131
930,252521,Vila-sana,2016,732,364,368,113,476,143
931,431711,Vila-seca,2016,21935,11021,10914,4176,15139,2620
932,082140,Vilassar de Dalt,2016,8953,4411,4542,1440,5903,1610
933,082191,Vilassar de Mar,2016,20678,9970,10708,3507,13506,3665
934,172229,Vilaür,2016,156,79,77,35,89,32
935,431726,Vilaverd,2016,452,235,217,78,280,94
936,431732,"Vilella Alta, la",2016,135,73,62,25,73,37
937,431747,"Vilella Baixa, la",2016,193,106,87,30,113,50
938,172333,Vilobí d'Onyar,2016,3163,1635,1528,568,2060,535
939,083041,Vilobí del Penedès,2016,1103,579,524,201,694,208
940,172327,Vilopriu,2016,201,108,93,35,120,46
941,252537,"Vilosell, el",2016,185,91,94,9,107,69
942,431763,Vimbodí i Poblet,2016,954,528,426,114,575,265
943,252555,Vinaixa,2016,499,257,242,50,314,135
944,431779,Vinebre,2016,430,215,215,68,260,102
945,431785,Vinyols i els Arcs,2016,1918,994,924,314,1285,319
946,083089,Viver i Serrateix,2016,162,86,76,25,92,45
947,430521,Xerta,2016,1190,574,616,128,736,326
948,000000,Catalunya,2016,7522596,3697368,3825228,1180054,4963265,1379277
0,250019,Abella de la Conca,2017,184,102,82,17,117,50
1,080018,Abrera,2017,12363,6283,6080,2339,8225,1799
2,250024,Àger,2017,586,315,271,49,355,182
3,250030,Agramunt,2017,5405,2706,2699,853,3520,1032
4,080023,Aguilar de Segarra,2017,263,142,121,40,166,57
5,170010,Agullana,2017,831,414,417,128,523,180
6,080142,Aiguafreda,2017,2514,1204,1310,351,1600,563
7,430017,Aiguamúrcia,2017,893,460,433,119,574,200
8,170025,Aiguaviva,2017,779,395,384,161,492,126
9,250387,Aitona,2017,2548,1321,1227,390,1572,586
10,250045,"Alamús, els",2017,777,411,366,114,493,170
11,250058,Alàs i Cerc,2017,351,178,173,48,205,98
12,250061,"Albagés, l'",2017,393,211,182,37,236,120
13,170031,Albanyà,2017,141,75,66,28,90,23
14,250077,Albatàrrec,2017,2275,1183,1092,355,1657,263
15,250083,Albesa,2017,1582,855,727,224,996,362
16,250096,"Albi, l'",2017,781,404,377,116,438,227
17,430022,Albinyana,2017,2340,1185,1155,347,1515,478
18,430038,"Albiol, l'",2017,479,247,232,99,315,65
19,170046,Albons,2017,769,381,388,130,496,143
20,430043,Alcanar,2017,9393,4738,4655,1309,6093,1991
21,250100,Alcanó,2017,243,121,122,28,140,75
22,250117,Alcarràs,2017,9363,4836,4527,1733,6491,1139
23,250122,Alcoletge,2017,3415,1773,1642,598,2410,407
24,430056,Alcover,2017,5163,2571,2592,902,3366,895
25,439044,"Aldea, l'",2017,4211,2215,1996,636,2683,892
26,430069,Aldover,2017,842,420,422,98,486,258
27,430075,"Aleixar, l'",2017,866,445,421,143,562,161
28,080039,Alella,2017,9625,4704,4921,1522,6223,1880
29,430081,Alfara de Carles,2017,369,199,170,39,216,114
30,250138,Alfarràs,2017,2879,1515,1364,406,1834,639
31,250143,Alfés,2017,313,162,151,35,190,88
32,430094,Alforja,2017,1799,923,876,253,1196,350
33,250156,Algerri,2017,417,222,195,35,230,152
34,250169,Alguaire,2017,2970,1562,1408,433,1914,623
35,250175,Alins,2017,286,152,134,34,163,89
36,430108,Alió,2017,408,195,213,62,252,94
37,250194,Almacelles,2017,6857,3577,3280,1008,4538,1311
38,250208,Almatret,2017,319,174,145,10,191,118
39,250215,Almenar,2017,3468,1838,1630,439,2259,770
40,430115,Almoster,2017,1361,682,679,187,978,196
41,250220,Alòs de Balaguer,2017,128,74,54,9,68,51
42,170062,Alp,2017,1499,775,724,208,1081,210
43,080044,Alpens,2017,277,144,133,44,183,50
44,250236,Alpicat,2017,6285,3146,3139,1189,4291,805
45,250241,Alt Àneu,2017,405,229,176,32,284,89
46,430120,Altafulla,2017,5089,2485,2604,883,3359,847
47,170078,Amer,2017,2242,1090,1152,309,1387,546
48,430136,"Ametlla de Mar, l'",2017,6887,3473,3414,1027,4256,1604
49,080057,"Ametlla del Vallès, l'",2017,8368,4228,4140,1468,5770,1130
50,439060,"Ampolla, l'",2017,3334,1699,1635,414,2085,835
51,430141,Amposta,2017,20572,10331,10241,3349,13485,3738
52,170084,Anglès,2017,5479,2713,2766,953,3487,1039
53,250273,Anglesola,2017,1324,665,659,201,792,331
54,250292,Arbeca,2017,2231,1129,1102,260,1377,594
55,430167,"Arboç, l'",2017,5489,2822,2667,1026,3597,866
56,430154,Arbolí,2017,123,70,53,8,89,26
57,170097,Arbúcies,2017,6427,3307,3120,1110,4196,1121
58,080060,Arenys de Mar,2017,15368,7457,7911,2199,9906,3263
59,080076,Arenys de Munt,2017,8728,4380,4348,1496,5753,1479
60,170101,Argelaguer,2017,423,219,204,52,288,83
61,080082,Argençola,2017,220,113,107,26,153,41
62,430173,"Argentera, l'",2017,135,76,59,7,92,36
63,080095,Argentona,2017,12133,5947,6186,2048,8016,2069
64,170118,"Armentera, l'",2017,949,480,469,159,598,192
65,430189,Arnes,2017,459,234,225,47,243,169
66,250313,Arres,2017,59,37,22,4,47,8
67,250328,Arsèguel,2017,82,48,34,13,56,13
68,080109,Artés,2017,5585,2822,2763,898,3708,979
69,250334,Artesa de Lleida,2017,1527,795,732,228,1003,296
70,250349,Artesa de Segre,2017,3508,1791,1717,516,2248,744
71,430192,Ascó,2017,1690,868,822,198,1134,358
72,250365,Aspa,2017,214,107,107,18,127,69
73,250371,"Avellanes i Santa Linya, les",2017,455,262,193,54,257,144
74,080116,Avià,2017,2249,1112,1137,351,1435,463
75,080121,Avinyó,2017,2240,1119,1121,332,1423,485
76,170123,Avinyonet de Puigventós,2017,1565,781,784,293,1104,168
77,080137,Avinyonet del Penedès,2017,1653,873,780,239,1091,323
78,080155,Badalona,2017,215848,106216,109632,34145,142089,39614
79,089045,Badia del Vallès,2017,13466,6586,6880,2087,8735,2644
80,080168,Bagà,2017,2149,1061,1088,239,1367,543
81,250390,Baix Pallars,2017,341,183,158,42,228,71
82,250404,Balaguer,2017,16670,8420,8250,2895,10865,2910
83,080174,Balenyà,2017,3665,1844,1821,606,2492,567
84,080180,Balsareny,2017,3240,1618,1622,400,2112,728
85,430206,Banyeres del Penedès,2017,3121,1572,1549,574,2053,494
86,170157,Banyoles,2017,19397,9644,9753,3570,12556,3271
87,250411,Barbens,2017,933,497,436,115,589,229
88,430213,Barberà de la Conca,2017,477,254,223,74,290,113
89,082520,Barberà del Vallès,2017,32860,16211,16649,5681,22042,5137
90,080193,Barcelona,2017,1620809,766625,854184,205286,1066776,348747
91,250426,"Baronia de Rialb, la",2017,235,124,111,18,136,81
92,170160,Bàscara,2017,989,514,475,158,601,230
93,250447,Bassella,2017,229,109,120,24,144,61
94,430228,Batea,2017,1938,965,973,257,1114,567
95,250450,Bausen,2017,67,33,34,3,39,25
96,080207,Begues,2017,6830,3375,3455,1300,4681,849
97,170139,Begur,2017,3933,1974,1959,476,2639,818
98,250463,Belianes,2017,519,261,258,58,298,163
99,251706,Bellaguarda,2017,305,159,146,18,181,106
100,170182,Bellcaire d'Empordà,2017,668,328,340,113,415,140
101,250479,Bellcaire d'Urgell,2017,1237,623,614,166,733,338
102,250485,Bell-lloc d'Urgell,2017,2321,1157,1164,342,1489,490
103,250498,Bellmunt d'Urgell,2017,188,92,96,24,113,51
104,430234,Bellmunt del Priorat,2017,290,146,144,21,185,84
105,080214,Bellprat,2017,74,46,28,2,46,26
106,250501,Bellpuig,2017,4985,2591,2394,791,3302,892
107,430249,Bellvei,2017,2193,1125,1068,427,1384,382
108,250518,Bellver de Cerdanya,2017,1973,1014,959,285,1260,428
109,250523,Bellvís,2017,2276,1157,1119,323,1404,549
110,250539,Benavent de Segrià,2017,1442,753,689,249,984,209
111,430252,Benifallet,2017,721,345,376,59,422,240
112,430265,Benissanet,2017,1172,631,541,142,752,278
113,080229,Berga,2017,16115,7945,8170,2316,10203,3596
114,170195,Besalú,2017,2443,1153,1290,395,1470,578
115,170209,Bescanó,2017,4929,2479,2450,1006,3161,762
116,170216,Beuda,2017,181,101,80,34,119,28
117,080235,Bigues i Riells del Fai,2017,8957,4569,4388,1633,6026,1298
118,250557,Biosca,2017,186,99,87,12,110,64
119,170221,"Bisbal d'Empordà, la",2017,10775,5365,5410,1967,7042,1766
120,430271,"Bisbal de Falset, la",2017,217,117,100,28,124,65
121,430287,"Bisbal del Penedès, la",2017,3460,1846,1614,529,2224,707
122,172348,Biure,2017,230,118,112,24,144,62
123,430290,Blancafort,2017,381,199,182,47,237,97
124,170237,Blanes,2017,38813,19333,19480,5783,25905,7125
125,170293,Boadella i les Escaules,2017,267,140,127,36,172,59
126,170242,Bolvir,2017,380,199,181,57,247,76
127,430304,Bonastre,2017,661,333,328,128,429,104
128,250576,"Bòrdes, Es",2017,252,140,112,30,176,46
129,170255,Bordils,2017,1693,854,839,272,1131,290
130,250582,"Borges Blanques, les",2017,6005,3068,2937,924,3813,1268
131,430311,"Borges del Camp, les",2017,2080,1057,1023,387,1294,399
132,170268,Borrassà,2017,715,367,348,129,450,136
133,080240,Borredà,2017,480,267,213,49,311,120
134,250595,Bossòst,2017,1120,546,574,166,757,197
135,430326,Bot,2017,609,306,303,56,321,232
136,430332,Botarell,2017,1078,566,512,195,743,140
137,250560,Bovera,2017,266,147,119,18,145,103
138,430347,Bràfim,2017,672,335,337,118,402,152
139,170274,Breda,2017,3740,1844,1896,528,2430,782
140,080253,"Bruc, el",2017,1988,1073,915,373,1350,265
141,080266,"Brull, el",2017,258,139,119,49,168,41
142,170280,Brunyola i Sant Martí Sapresa,2017,369,185,184,54,227,88
143,430350,Cabacés,2017,309,159,150,45,181,83
144,250609,Cabanabona,2017,81,35,46,5,47,29
145,170314,Cabanelles,2017,265,150,115,44,159,62
146,170307,Cabanes,2017,903,490,413,136,568,199
147,080272,"Cabanyes, les",2017,947,484,463,199,625,123
148,250616,Cabó,2017,93,51,42,11,56,26
149,430363,Cabra del Camp,2017,1131,592,539,175,723,233
150,080288,Cabrera d'Anoia,2017,1364,724,640,227,940,197
151,080291,Cabrera de Mar,2017,4594,2325,2269,733,3109,752
152,080305,Cabrils,2017,7296,3602,3694,1310,5007,979
153,170329,Cadaqués,2017,2794,1359,1435,417,1896,481
154,080312,Calaf,2017,3477,1776,1701,565,2200,712
155,430379,Calafell,2017,24898,12541,12357,3860,16314,4724
156,080348,Calders,2017,962,497,465,148,640,174
157,080327,Caldes d'Estrac,2017,2823,1356,1467,410,1859,554
158,170335,Caldes de Malavella,2017,7351,3646,3705,1315,4810,1226
159,080333,Caldes de Montbui,2017,17187,8524,8663,2813,11305,3069
160,080351,Calella,2017,18481,9015,9466,2678,12049,3754
161,080370,Calldetenes,2017,2446,1238,1208,384,1663,399
162,080386,Callús,2017,2067,1008,1059,378,1322,367
163,080364,Calonge de Segarra,2017,198,100,98,22,120,56
164,170340,Calonge i Sant Antoni,2017,10804,5409,5395,1599,7094,2111
165,250621,Camarasa,2017,863,439,424,88,521,254
166,439039,Camarles,2017,3270,1661,1609,473,2020,777
167,430385,Cambrils,2017,32855,16099,16756,5859,21850,5146
168,170353,Camós,2017,687,343,344,100,422,165
169,170366,Campdevànol,2017,3243,1585,1658,417,1973,853
170,170372,Campelles,2017,135,70,65,13,90,32
171,080399,Campins,2017,498,260,238,72,355,71
172,170388,Campllong,2017,525,257,268,121,345,59
173,170391,Camprodon,2017,2214,1091,1123,279,1346,589
174,250637,Canejan,2017,88,51,37,4,59,25
175,170405,Canet d'Adri,2017,703,358,345,123,449,131
176,080403,Canet de Mar,2017,14423,7008,7415,2301,9149,2973
177,439076,"Canonja, la",2017,5804,2849,2955,1040,3895,869
178,080410,Canovelles,2017,16145,8326,7819,3047,10661,2437
179,080425,Cànoves i Samalús,2017,2906,1472,1434,502,1910,494
180,170412,Cantallops,2017,322,162,160,47,197,78
181,080431,Canyelles,2017,4388,2251,2137,785,2982,621
182,430398,Capafonts,2017,102,54,48,6,68,28
183,430402,Capçanes,2017,403,201,202,41,245,117
184,080446,Capellades,2017,5225,2582,2643,802,3325,1098
185,170427,Capmany,2017,623,316,307,99,371,153
186,080459,Capolat,2017,99,47,52,24,60,15
187,080462,Cardedeu,2017,18210,8951,9259,3396,12055,2759
188,080478,Cardona,2017,4728,2316,2412,592,2884,1252
189,080484,Carme,2017,791,407,384,111,511,169
190,430419,Caseres,2017,234,118,116,16,138,80
191,170448,Cassà de la Selva,2017,10231,5199,5032,1795,6778,1658
192,080497,Casserres,2017,1557,767,790,194,955,408
193,080575,Castell de l'Areny,2017,69,40,29,6,50,13
194,259046,Castell de Mur,2017,168,94,74,14,101,53
195,250642,Castellar de la Ribera,2017,140,72,68,27,73,40
196,080522,Castellar de n'Hug,2017,159,86,73,12,112,35
197,080500,Castellar del Riu,2017,166,96,70,22,104,40
198,080517,Castellar del Vallès,2017,23776,11702,12074,4189,15914,3673
199,080538,Castellbell i el Vilar,2017,3618,1856,1762,582,2335,701
200,080543,Castellbisbal,2017,12297,6220,6077,2387,8332,1578
201,080556,Castellcir,2017,723,373,350,130,491,102
202,250674,Castelldans,2017,943,506,437,104,613,226
203,080569,Castelldefels,2017,65954,32562,33392,11213,45411,9330
204,080581,Castellet i la Gornal,2017,2233,1132,1101,339,1448,446
205,170464,Castellfollit de la Roca,2017,951,486,465,135,571,245
206,080608,Castellfollit de Riubregós,2017,160,91,69,11,103,46
207,080594,Castellfollit del Boix,2017,440,225,215,72,282,86
208,080615,Castellgalí,2017,2017,1056,961,353,1317,347
209,080620,Castellnou de Bages,2017,1303,658,645,266,861,176
210,250680,Castellnou de Seana,2017,686,362,324,90,411,185
211,170470,Castelló d'Empúries,2017,10791,5474,5317,1692,7099,2000
212,250693,Castelló de Farfanya,2017,542,289,253,64,318,160
213,080636,Castellolí,2017,599,289,310,114,384,101
214,170486,Castell-Platja d'Aro,2017,10593,5214,5379,1567,7089,1937
215,250707,Castellserà,2017,1008,507,501,117,607,284
216,080641,Castellterçol,2017,2374,1182,1192,343,1493,538
217,430424,Castellvell del Camp,2017,2849,1425,1424,520,1957,372
218,080654,Castellví de la Marca,2017,1554,772,782,224,999,331
219,080667,Castellví de Rosanes,2017,1826,898,928,293,1251,282
220,430430,"Catllar, el",2017,4251,2195,2056,709,2958,584
221,250714,Cava,2017,52,32,20,3,31,18
222,171899,"Cellera de Ter, la",2017,2006,1004,1002,308,1228,470
223,170499,Celrà,2017,5376,2695,2681,1181,3655,540
224,080673,Centelles,2017,7417,3632,3785,1256,4726,1435
225,082687,Cercs,2017,1166,573,593,114,712,340
226,082665,Cerdanyola del Vallès,2017,57723,28289,29434,8604,38845,10274
227,080689,Cervelló,2017,8909,4443,4466,1524,5968,1417
228,250729,Cervera,2017,9037,4559,4478,1600,5940,1497
229,250735,Cervià de les Garrigues,2017,660,348,312,62,391,207
230,170502,Cervià de Ter,2017,923,473,450,165,588,170
231,170519,Cistella,2017,304,152,152,47,189,68
232,250740,Ciutadilla,2017,202,109,93,19,119,64
233,250753,Clariana de Cardener,2017,145,72,73,18,99,28
234,250766,"Cogul, el",2017,162,87,75,9,91,62
235,170545,Colera,2017,481,242,239,38,308,135
236,250772,Coll de Nargó,2017,558,286,272,60,354,144
237,080692,Collbató,2017,4394,2274,2120,904,2914,576
238,430458,Colldejou,2017,170,91,79,16,115,39
239,080706,Collsuspina,2017,338,177,161,60,218,60
240,170558,Colomers,2017,179,88,91,19,111,49
241,251636,"Coma i la Pedra, la",2017,259,157,102,18,193,48
242,251615,Conca de Dalt,2017,445,233,212,52,263,130
243,430461,Conesa,2017,111,57,54,7,71,33
244,430477,Constantí,2017,6493,3368,3125,1239,4342,912
245,080713,Copons,2017,316,158,158,56,193,67
246,430483,Corbera d'Ebre,2017,1061,566,495,126,643,292
247,080728,Corbera de Llobregat,2017,14439,7220,7219,2579,9846,2014
248,250788,Corbins,2017,1411,764,647,223,902,286
249,170577,Corçà,2017,1245,633,612,205,769,271
250,080734,Cornellà de Llobregat,2017,86610,42023,44587,13153,56036,17421
251,170561,Cornellà del Terri,2017,2280,1169,1111,368,1445,467
252,430496,Cornudella de Montsant,2017,953,503,450,110,630,213
253,430509,Creixell,2017,3465,1761,1704,513,2142,810
254,170583,Crespià,2017,259,131,128,45,163,51
255,179011,"Cruïlles, Monells i Sant Sadurní de l'Heura",2017,1296,660,636,199,854,243
256,080749,Cubelles,2017,14715,7428,7287,2583,9713,2419
257,250791,Cubells,2017,373,198,175,36,227,110
258,430516,Cunit,2017,12041,5902,6139,1870,7471,2700
259,170600,Darnius,2017,564,279,285,66,343,155
260,170617,Das,2017,223,121,102,46,142,35
261,439018,Deltebre,2017,11499,5793,5706,1611,7403,2485
262,080752,Dosrius,2017,5198,2622,2576,932,3571,695
263,430537,Duesaigües,2017,243,140,103,24,162,57
264,170622,"Escala, l'",2017,10407,5313,5094,1399,6778,2230
265,080765,Esparreguera,2017,21889,11088,10801,3655,14787,3447
266,170638,Espinelves,2017,203,99,104,30,131,42
267,250812,"Espluga Calba, l'",2017,363,182,181,38,195,130
268,430542,"Espluga de Francolí, l'",2017,3756,1807,1949,536,2416,804
269,080771,Esplugues de Llobregat,2017,45890,21967,23923,6488,29062,10340
270,170643,Espolla,2017,423,209,214,55,253,115
271,170656,Esponellà,2017,432,216,216,78,260,94
272,250827,Espot,2017,365,194,171,36,262,67
273,080787,"Espunyola, l'",2017,240,123,117,23,160,57
274,082541,"Esquirol, l'",2017,2161,1098,1063,281,1389,491
275,250886,Estamariu,2017,124,72,52,18,64,42
276,080790,"Estany, l'",2017,405,201,204,53,242,110
277,250851,Estaràs,2017,158,85,73,12,97,49
278,250864,Esterri d'Àneu,2017,769,369,400,98,545,126
279,250870,Esterri de Cardós,2017,67,34,33,10,46,11
280,430555,Falset,2017,2820,1409,1411,457,1761,602
281,170059,"Far d'Empordà, el",2017,568,286,282,99,364,105
282,250899,Farrera,2017,121,70,51,14,83,24
283,430568,"Fatarella, la",2017,980,482,498,105,535,340
284,430574,"Febró, la",2017,42,27,15,1,28,13
285,081347,Figaró-Montmany,2017,1077,533,544,161,708,208
286,080804,Fígols,2017,42,24,18,3,22,17
287,259084,Fígols i Alinyà,2017,245,139,106,22,146,77
288,430580,"Figuera, la",2017,102,59,43,2,60,40
289,170669,Figueres,2017,45961,22733,23228,8279,30760,6922
290,430593,Figuerola del Camp,2017,330,160,170,57,206,67
291,170675,Flaçà,2017,1050,509,541,166,663,221
292,430607,Flix,2017,3605,1807,1798,376,2259,970
293,250925,"Floresta, la",2017,155,83,72,14,103,38
294,080826,Fogars de la Selva,2017,1448,747,701,207,983,258
295,080811,Fogars de Montclús,2017,458,245,213,95,283,80
296,170681,Foixà,2017,313,163,150,32,192,89
297,080832,Folgueroles,2017,2298,1164,1134,508,1461,329
298,250931,Fondarella,2017,796,394,402,104,549,143
299,080847,Fonollosa,2017,1412,736,676,202,947,263
300,170694,Fontanals de Cerdanya,2017,448,235,213,44,311,93
301,170708,Fontanilles,2017,138,78,60,10,83,45
302,170715,Fontcoberta,2017,1481,737,744,257,991,233
303,080850,Font-rubí,2017,1358,696,662,202,838,318
304,250946,Foradada,2017,170,98,72,19,98,53
305,179026,Forallac,2017,1708,848,860,247,1121,340
306,430614,Forès,2017,45,27,18,0,23,22
307,170736,Fornells de la Selva,2017,2613,1294,1319,525,1751,337
308,170741,Fortià,2017,726,352,374,114,469,143
309,080863,"Franqueses del Vallès, les",2017,19584,9961,9623,3823,13282,2479
310,430629,Freginals,2017,397,208,189,36,250,111
311,250962,"Fuliola, la",2017,1237,624,613,200,747,290
312,250978,Fulleda,2017,86,43,43,2,53,31
313,080902,Gaià,2017,162,89,73,25,114,23
314,430635,"Galera, la",2017,719,370,349,77,447,195
315,080879,Gallifa,2017,180,97,83,16,128,36
316,430640,Gandesa,2017,3011,1540,1471,444,1903,664
317,430653,Garcia,2017,531,269,262,63,312,156
318,430666,"Garidells, els",2017,194,95,99,23,134,37
319,080885,"Garriga, la",2017,15984,7752,8232,2784,10555,2645
320,170754,Garrigàs,2017,436,230,206,67,291,78
321,170767,Garrigoles,2017,172,96,76,20,106,46
322,170773,Garriguella,2017,851,418,433,153,530,168
323,080898,Gavà,2017,46538,22830,23708,7812,30910,7816
324,250984,Gavet de la Conca,2017,280,132,148,22,154,104
325,080919,Gelida,2017,7299,3692,3607,1353,4838,1108
326,170789,Ger,2017,423,219,204,65,269,89
327,259123,Gimenells i el Pla de la Font,2017,1107,579,528,146,699,262
328,430672,Ginestar,2017,777,406,371,79,476,222
329,170792,Girona,2017,99013,47379,51634,16982,66865,15166
330,080924,Gironella,2017,4808,2357,2451,664,2901,1243
331,080930,Gisclareny,2017,27,15,12,1,21,5
332,430688,Godall,2017,608,307,301,59,338,211
333,250997,Golmés,2017,1852,916,936,322,1207,323
334,170806,Gombrèn,2017,185,95,90,38,106,41
335,251001,Gósol,2017,222,121,101,10,152,60
336,080945,"Granada, la",2017,2112,1076,1036,376,1426,310
337,251018,"Granadella, la",2017,737,388,349,89,433,215
338,080958,Granera,2017,78,55,23,4,57,17
339,251023,"Granja d'Escarp, la",2017,971,522,449,103,633,235
340,080961,Granollers,2017,60695,29897,30798,9364,40794,10537
341,251039,Granyanella,2017,147,81,66,10,94,43
342,251057,Granyena de les Garrigues,2017,158,95,63,15,86,57
343,251044,Granyena de Segarra,2017,143,73,70,18,72,53
344,430691,Gratallops,2017,237,128,109,20,153,64
345,080977,Gualba,2017,1423,718,705,310,911,202
346,170813,Gualta,2017,392,219,173,58,263,71
347,080996,Guardiola de Berguedà,2017,904,476,428,98,577,229
348,430705,"Guiamets, els",2017,272,126,146,18,171,83
349,170828,Guils de Cerdanya,2017,525,278,247,63,371,91
350,251095,Guimerà,2017,273,148,125,23,140,110
351,259031,"Guingueta d'Àneu, la",2017,311,166,145,35,204,72
352,251109,Guissona,2017,7014,3721,3293,1387,4972,655
353,251116,Guixers,2017,140,86,54,15,84,41
354,081000,Gurb,2017,2616,1338,1278,439,1763,414
355,430712,Horta de Sant Joan,2017,1171,610,561,139,693,339
356,081017,"Hospitalet de Llobregat, l'",2017,257349,124443,132906,36209,168482,52658
357,081629,"Hostalets de Pierola, els",2017,2901,1494,1407,565,1953,383
358,170834,Hostalric,2017,4106,2060,2046,720,2699,687
359,081022,Igualada,2017,39316,19255,20061,6632,25095,7589
360,251155,Isona i Conca Dellà,2017,1027,544,483,115,594,318
361,170849,Isòvol,2017,270,152,118,33,183,54
362,251137,Ivars d'Urgell,2017,1568,820,748,218,921,429
363,251121,Ivars de Noguera,2017,332,175,157,30,219,83
364,251142,Ivorra,2017,107,57,50,5,61,41
365,170852,Jafre,2017,393,213,180,50,244,99
366,170865,"Jonquera, la",2017,3157,1595,1562,545,2134,478
367,081038,Jorba,2017,823,413,410,143,562,118
368,259101,Josa i Tuixén,2017,115,68,47,6,73,36
369,170871,Juià,2017,334,186,148,67,205,62
370,251180,Juncosa,2017,408,217,191,33,250,125
371,251193,Juneda,2017,3383,1766,1617,506,2128,749
372,251214,Les,2017,955,471,484,147,683,125
373,251229,Linyola,2017,2626,1317,1309,382,1684,560
374,081043,"Llacuna, la",2017,863,469,394,88,557,218
375,170887,Lladó,2017,773,377,396,159,492,122
376,251235,Lladorre,2017,225,108,117,28,150,47
377,251240,Lladurs,2017,183,95,88,14,113,56
378,081056,"Llagosta, la",2017,13343,6586,6757,2244,8600,2499
379,170890,Llagostera,2017,8229,4201,4028,1436,5393,1400
380,170904,Llambilles,2017,716,363,353,133,460,123
381,170911,Llanars,2017,507,272,235,70,317,120
382,170926,Llançà,2017,4796,2361,2435,679,3063,1054
383,251253,Llardecans,2017,470,246,224,40,269,161
384,251266,Llavorsí,2017,359,173,186,47,241,71
385,251207,Lleida,2017,137327,67855,69472,21508,92006,23813
386,170932,Llers,2017,1211,602,609,178,777,256
387,251272,Lles de Cerdanya,2017,253,144,109,28,158,67
388,081075,Lliçà d'Amunt,2017,14933,7623,7310,2503,10045,2385
389,081081,Lliçà de Vall,2017,6386,3248,3138,999,4239,1148
390,251288,Llimiana,2017,142,83,59,9,86,47
391,081069,Llinars del Vallès,2017,9749,4856,4893,1543,6500,1706
392,170947,Llívia,2017,1415,758,657,175,998,242
393,430727,"Lloar, el",2017,117,60,57,14,67,36
394,251291,Llobera,2017,201,110,91,26,122,53
395,430733,Llorac,2017,93,52,41,5,61,27
396,430748,Llorenç del Penedès,2017,2302,1142,1160,409,1468,425
397,170950,Lloret de Mar,2017,36878,18857,18021,5865,25990,5023
398,170963,"Llosses, les",2017,210,116,94,30,139,41
399,081094,Lluçà,2017,279,137,142,49,184,46
400,171024,Maçanet de Cabrenys,2017,706,345,361,71,429,206
401,171030,Maçanet de la Selva,2017,6822,3530,3292,1084,4540,1198
402,170979,Madremanya,2017,284,141,143,54,174,56
403,170985,Maià de Montcal,2017,409,216,193,58,255,96
404,251333,Maials,2017,945,521,424,97,571,277
405,251305,Maldà,2017,227,114,113,24,139,64
406,081108,Malgrat de Mar,2017,18345,9181,9164,2755,12003,3587
407,081115,Malla,2017,264,136,128,37,168,59
408,081120,Manlleu,2017,20007,9984,10023,3489,13043,3475
409,081136,Manresa,2017,75152,36748,38404,12044,48115,14993
410,430764,Marçà,2017,602,322,280,83,384,135
411,430751,Margalef,2017,101,60,41,3,65,33
412,082423,Marganell,2017,254,124,130,25,163,66
413,081141,Martorell,2017,27681,14100,13581,5086,18093,4502
414,081154,Martorelles,2017,4742,2384,2358,661,3130,951
415,430770,Mas de Barberans,2017,584,288,296,54,348,182
416,171002,Masarac,2017,279,146,133,35,187,57
417,430786,Masdenverge,2017,1067,551,516,133,678,256
418,081167,"Masies de Roda, les",2017,714,355,359,102,455,157
419,081173,"Masies de Voltregà, les",2017,3140,1550,1590,494,2099,547
420,430799,Masllorenç,2017,496,268,228,77,328,91
421,081189,"Masnou, el",2017,23288,11209,12079,3469,15490,4329
422,430803,"Masó, la",2017,281,153,128,38,163,80
423,430810,Maspujols,2017,791,403,388,143,524,124
424,081192,Masquefa,2017,8514,4271,4243,1620,5727,1167
425,430825,"Masroig, el",2017,510,283,227,59,300,151
426,251312,Massalcoreig,2017,588,335,253,44,417,127
427,171019,Massanes,2017,721,392,329,136,452,133
428,251327,Massoteres,2017,214,116,98,37,137,40
429,081206,Matadepera,2017,9186,4599,4587,1732,5998,1456
430,081213,Mataró,2017,126127,62517,63610,20955,83696,21476
431,171045,Medinyà,2017,0,0,0,0,0,0
432,081228,Mediona,2017,2251,1131,1120,397,1359,495
433,251348,Menàrguens,2017,819,458,361,69,539,211
434,170998,Meranges,2017,99,61,38,15,59,25
435,171058,Mieres,2017,318,162,156,38,206,74
436,430831,"Milà, el",2017,182,92,90,29,109,44
437,251351,Miralcamp,2017,1358,684,674,215,856,287
438,430846,Miravet,2017,726,389,337,100,436,190
439,081385,Moià,2017,6065,3085,2980,1036,3967,1062
440,430859,"Molar, el",2017,286,151,135,19,176,91
441,081234,Molins de Rei,2017,25492,12407,13085,4558,16692,4242
442,251370,Mollerussa,2017,14574,7437,7137,2719,9831,2024
443,171061,Mollet de Peralada,2017,186,98,88,32,96,58
444,081249,Mollet del Vallès,2017,51128,25210,25918,8538,34354,8236
445,171077,Molló,2017,342,164,178,50,205,87
446,251364,"Molsosa, la",2017,109,53,56,7,72,30
447,081287,Monistrol de Calders,2017,677,356,321,79,452,146
448,081271,Monistrol de Montserrat,2017,2935,1489,1446,430,1921,584
449,171096,Montagut i Oix,2017,919,486,433,130,603,186
450,430862,Montblanc,2017,7307,3682,3625,1113,4828,1366
451,430884,Montbrió del Camp,2017,2806,1453,1353,527,1865,414
452,081252,Montcada i Reixac,2017,35063,17261,17802,6117,23650,5296
453,081304,Montclar,2017,121,61,60,22,69,30
454,251399,Montellà i Martinet,2017,554,305,249,51,368,135
455,081311,Montesquiu,2017,960,481,479,166,592,202
456,251403,Montferrer i Castellbò,2017,1092,591,501,183,714,195
457,430897,Montferri,2017,388,209,179,73,248,67
458,251386,Montgai,2017,636,332,304,52,373,211
459,081265,Montgat,2017,11748,5788,5960,2064,7980,1704
460,081326,Montmajor,2017,459,235,224,63,274,122
461,081332,Montmaneu,2017,153,85,68,12,95,46
462,430901,"Montmell, el",2017,1405,747,658,219,927,259
463,081350,Montmeló,2017,8748,4271,4477,1350,5802,1596
464,251425,Montoliu de Lleida,2017,469,234,235,52,287,130
465,251410,Montoliu de Segarra,2017,178,98,80,20,101,57
466,251431,Montornès de Segarra,2017,97,46,51,13,49,35
467,081363,Montornès del Vallès,2017,16240,8206,8034,3001,10902,2337
468,430918,Mont-ral,2017,164,97,67,19,114,31
469,171100,Mont-ras,2017,1725,871,854,230,1154,341
470,430923,Mont-roig del Camp,2017,11597,6035,5562,1807,7737,2053
471,081379,Montseny,2017,343,174,169,55,204,84
472,430939,Móra d'Ebre,2017,5625,2801,2824,859,3704,1062
473,430944,Móra la Nova,2017,3070,1542,1528,418,2039,613
474,430957,"Morell, el",2017,3631,1850,1781,685,2493,453
475,430960,"Morera de Montsant, la",2017,158,90,68,16,112,30
476,081290,Muntanyola,2017,613,316,297,119,414,80
477,081398,Mura,2017,227,124,103,39,142,46
478,251459,Nalec,2017,101,54,47,6,58,37
479,250254,Naut Aran,2017,1781,916,865,265,1277,239
480,081402,Navarcles,2017,5950,2895,3055,841,3896,1213
481,081419,Navàs,2017,6020,2997,3023,918,3853,1249
482,171117,Navata,2017,1307,646,661,224,855,228
483,251462,Navès,2017,288,144,144,42,184,62
484,081424,"Nou de Berguedà, la",2017,157,80,77,13,95,49
485,430976,"Nou de Gaià, la",2017,563,275,288,114,336,113
486,430982,Nulles,2017,464,249,215,75,286,103
487,251484,Odèn,2017,256,150,106,19,161,76
488,081430,Òdena,2017,3614,1855,1759,693,2332,589
489,171122,Ogassa,2017,228,133,95,30,148,50
490,081458,Olèrdola,2017,3565,1823,1742,654,2364,547
491,081461,Olesa de Bonesvalls,2017,1734,915,819,307,1153,274
492,081477,Olesa de Montserrat,2017,23552,11734,11818,4407,15488,3657
493,251497,Oliana,2017,1826,918,908,199,1128,499
494,251500,Oliola,2017,211,113,98,19,133,59
495,251517,Olius,2017,931,497,434,195,579,157
496,081483,Olivella,2017,3655,1929,1726,742,2479,434
497,081496,Olost,2017,1197,602,595,144,776,277
498,171143,Olot,2017,34194,16974,17220,5200,22261,6733
499,251522,"Oluges, les",2017,155,81,74,13,84,58
500,081445,Olvan,2017,844,410,434,99,536,209
501,251538,"Omellons, els",2017,210,111,99,13,113,84
502,251543,"Omells de na Gaia, els",2017,135,72,63,8,84,43
503,171156,Ordis,2017,364,194,170,57,226,81
504,251556,Organyà,2017,801,401,400,99,465,237
505,081509,Orís,2017,316,160,156,46,215,55
506,081516,Oristà,2017,547,267,280,64,323,160
507,081521,Orpí,2017,134,74,60,19,88,27
508,081537,Òrrius,2017,694,359,335,115,472,107
509,251569,Os de Balaguer,2017,1013,514,499,166,634,213
510,171169,Osor,2017,421,217,204,55,269,97
511,251575,Ossó de Sió,2017,213,106,107,31,122,60
512,081542,Pacs del Penedès,2017,902,455,447,145,613,144
513,081555,Palafolls,2017,9171,4629,4542,1707,6262,1202
514,171175,Palafrugell,2017,22725,11274,11451,3934,14790,4001
515,171181,Palamós,2017,17743,8651,9092,2545,11791,3407
516,251581,"Palau d'Anglesola, el",2017,2183,1072,1111,356,1416,411
517,171194,Palau de Santa Eulàlia,2017,96,58,38,10,65,21
518,171215,Palau-sator,2017,285,151,134,47,171,67
519,171208,Palau-saverdera,2017,1456,714,742,271,872,313
520,081568,Palau-solità i Plegamans,2017,14626,7170,7456,2514,9875,2237
521,431009,"Pallaresos, els",2017,4635,2348,2287,1012,3145,478
522,081574,Pallejà,2017,11416,5690,5726,2137,7572,1707
523,430995,"Palma d'Ebre, la",2017,356,171,185,25,198,133
524,089058,"Palma de Cervelló, la",2017,2998,1475,1523,446,2090,462
525,171236,Palol de Revardit,2017,476,237,239,80,294,102
526,171241,Pals,2017,2469,1246,1223,354,1546,569
527,081580,"Papiol, el",2017,4102,2029,2073,721,2729,652
528,171254,Pardines,2017,160,89,71,23,100,37
529,081593,Parets del Vallès,2017,18970,9532,9438,3336,12884,2750
530,171267,Parlavà,2017,394,206,188,51,251,92
531,431016,Passanant i Belltall,2017,149,85,64,4,91,54
532,171289,Pau,2017,537,277,260,73,328,136
533,431021,Paüls,2017,567,276,291,60,322,185
534,171292,Pedret i Marzà,2017,186,98,88,32,120,34
535,251641,Penelles,2017,463,265,198,57,279,127
536,171306,"Pera, la",2017,457,219,238,80,275,102
537,081607,Perafita,2017,411,210,201,47,259,105
538,431037,Perafort,2017,1253,654,599,271,836,146
539,171328,Peralada,2017,1859,920,939,274,1223,362
540,251654,Peramola,2017,341,169,172,27,215,99
541,431042,"Perelló, el",2017,2884,1492,1392,385,1715,784
542,081614,Piera,2017,15194,7743,7451,2630,10009,2555
543,431055,"Piles, les",2017,216,116,100,41,132,43
544,081635,Pineda de Mar,2017,26349,13147,13202,3904,17109,5336
545,431068,"Pinell de Brai, el",2017,1012,509,503,116,599,297
546,251667,Pinell de Solsonès,2017,211,123,88,18,134,59
547,251673,Pinós,2017,312,163,149,48,195,69
548,431074,Pira,2017,500,269,231,81,324,95
549,431080,"Pla de Santa Maria, el",2017,2266,1166,1100,313,1503,450
550,081640,"Pla del Penedès, el",2017,1232,612,620,225,792,215
551,171334,"Planes d'Hostoles, les",2017,1629,828,801,214,953,462
552,171349,Planoles,2017,303,168,135,39,191,73
553,259118,"Plans de Sió, els",2017,509,267,242,48,317,144
554,251689,"Poal, el",2017,637,333,304,73,400,164
555,251692,"Pobla de Cérvoles, la",2017,194,109,85,16,118,60
556,081653,"Pobla de Claramunt, la",2017,2190,1109,1081,385,1386,419
557,081666,"Pobla de Lillet, la",2017,1097,537,560,73,643,381
558,431093,"Pobla de Mafumet, la",2017,3854,1983,1871,815,2746,293
559,431107,"Pobla de Massaluca, la",2017,335,184,151,35,183,117
560,431114,"Pobla de Montornès, la",2017,2795,1468,1327,478,1791,526
561,251713,"Pobla de Segur, la",2017,2949,1462,1487,408,1774,767
562,431129,Poboleda,2017,356,198,158,42,220,94
563,081672,Polinyà,2017,8383,4232,4151,1823,5754,806
564,431135,"Pont d'Armentera, el",2017,501,252,249,56,305,140
565,250306,"Pont de Bar, el",2017,171,94,77,24,100,47
566,171352,Pont de Molins,2017,531,265,266,84,352,95
567,251734,"Pont de Suert, el",2017,2265,1140,1125,298,1497,470
568,081825,"Pont de Vilomara i Rocafort, el",2017,3794,1954,1840,650,2481,663
569,431418,Pontils,2017,118,65,53,10,69,39
570,081688,Pontons,2017,456,253,203,47,314,95
571,171365,Pontós,2017,240,133,107,40,147,53
572,251728,Ponts,2017,2622,1292,1330,368,1674,580
573,171371,Porqueres,2017,4594,2271,2323,793,3013,788
574,431140,Porrera,2017,441,236,205,36,300,105
575,171404,"Port de la Selva, el",2017,992,508,484,111,622,259
576,171387,Portbou,2017,1107,543,564,91,650,366
577,251749,"Portella, la",2017,708,395,313,88,494,126
578,431153,Pradell de la Teixeta,2017,163,76,87,17,105,41
579,431166,Prades,2017,599,317,282,77,372,150
580,431172,Prat de Comte,2017,181,98,83,21,104,56
581,081691,"Prat de Llobregat, el",2017,63897,31364,32533,10117,42042,11738
582,431188,Pratdip,2017,718,374,344,74,397,247
583,081712,Prats de Lluçanès,2017,2533,1265,1268,309,1666,558
584,081705,"Prats de Rei, els",2017,535,285,250,68,341,126
585,251752,Prats i Sansor,2017,232,119,113,23,163,46
586,251765,Preixana,2017,381,199,182,43,202,136
587,251771,Preixens,2017,443,228,215,51,244,148
588,082303,Premià de Dalt,2017,10345,5188,5157,1739,6867,1739
589,081727,Premià de Mar,2017,28049,13698,14351,4310,18387,5352
590,171390,"Preses, les",2017,1764,874,890,302,1144,318
591,251790,Prullans,2017,224,110,114,33,137,54
592,171411,Puigcerdà,2017,8839,4425,4414,1365,6104,1370
593,081748,Puigdàlber,2017,506,253,253,98,318,90
594,251804,Puiggròs,2017,280,141,139,36,177,67
595,431191,Puigpelat,2017,1147,588,559,238,797,112
596,081751,Puig-reig,2017,4086,1996,2090,512,2496,1078
597,251811,Puigverd d'Agramunt,2017,228,127,101,27,141,60
598,251826,Puigverd de Lleida,2017,1350,694,656,207,875,268
599,081764,Pujalt,2017,203,110,93,34,122,47
600,081770,"Quar, la",2017,57,30,27,11,30,16
601,171426,Quart,2017,3570,1786,1784,785,2318,467
602,170433,Queralbs,2017,176,98,78,10,121,45
603,431205,Querol,2017,532,298,234,66,349,117
604,171432,Rabós,2017,175,86,89,18,103,54
605,081786,Rajadell,2017,536,271,265,71,344,121
606,431212,Rasquera,2017,796,396,400,85,461,250
607,171447,Regencós,2017,279,143,136,38,175,66
608,081799,Rellinars,2017,735,379,356,117,508,110
609,431227,Renau,2017,153,78,75,34,106,13
610,431233,Reus,2017,103123,49805,53318,17877,67484,17762
611,251832,Rialp,2017,666,345,321,93,462,111
612,431248,"Riba, la",2017,590,322,268,69,358,163
613,431251,Riba-roja d'Ebre,2017,1116,589,527,107,688,321
614,259059,Ribera d'Ondara,2017,433,222,211,49,263,121
615,251850,Ribera d'Urgellet,2017,936,483,453,144,613,179
616,171450,Ribes de Freser,2017,1783,887,896,182,1079,522
617,171463,Riells i Viabrea,2017,3922,2026,1896,629,2758,535
618,431264,"Riera de Gaià, la",2017,1704,851,853,368,1079,257
619,251863,Riner,2017,262,130,132,42,157,63
620,171479,Ripoll,2017,10611,5236,5375,1454,6736,2421
621,081803,Ripollet,2017,37899,18776,19123,7020,25339,5540
622,259139,Riu de Cerdanya,2017,93,55,38,4,72,17
623,171485,Riudarenes,2017,2145,1106,1039,357,1395,393
624,171498,Riudaura,2017,475,229,246,84,297,94
625,431270,Riudecanyes,2017,1101,576,525,190,699,212
626,431286,Riudecols,2017,1165,611,554,153,784,228
627,171501,Riudellots de la Selva,2017,2029,1024,1005,324,1395,310
628,431299,Riudoms,2017,6515,3357,3158,1130,4180,1205
629,171518,Riumors,2017,266,133,133,43,163,60
630,081810,"Roca del Vallès, la",2017,10536,5275,5261,1931,7048,1557
631,431303,Rocafort de Queralt,2017,241,124,117,32,130,79
632,431310,Roda de Berà,2017,6354,3273,3081,992,4029,1333
633,081831,Roda de Ter,2017,6125,2998,3127,1040,3984,1101
634,431325,Rodonyà,2017,498,262,236,58,339,101
635,431331,Roquetes,2017,8084,4194,3890,1310,5358,1416
636,171523,Roses,2017,19216,9645,9571,3165,12627,3424
637,251898,Rosselló,2017,3083,1549,1534,525,2118,440
638,431346,"Rourell, el",2017,369,184,185,55,248,66
639,081846,Rubí,2017,75568,37444,38124,13083,51092,11393
640,081859,Rubió,2017,230,124,106,30,146,54
641,171539,Rupià,2017,264,134,130,42,163,59
642,089019,Rupit i Pruit,2017,281,143,138,26,168,87
643,081878,Sabadell,2017,209931,102153,107778,34133,136915,38883
644,081884,Sagàs,2017,155,84,71,31,95,29
645,251902,Salàs de Pallars,2017,337,180,157,39,205,93
646,081901,Saldes,2017,275,157,118,11,192,72
647,171544,Sales de Llierca,2017,147,76,71,23,106,18
648,081918,Sallent,2017,6594,3173,3421,906,4006,1682
649,431359,Salomó,2017,545,284,261,95,330,120
650,439057,Salou,2017,26233,13618,12615,4156,18926,3151
651,171557,Salt,2017,29836,15685,14151,6178,19970,3688
652,251919,Sanaüja,2017,401,209,192,45,235,121
653,081944,Sant Adrià de Besòs,2017,36624,18041,18583,6234,24095,6295
654,081957,Sant Agustí de Lluçanès,2017,86,44,42,7,57,22
655,081960,Sant Andreu de la Barca,2017,27303,13568,13735,5375,18074,3854
656,081976,Sant Andreu de Llavaneres,2017,10758,5326,5432,1830,7144,1784
657,171576,Sant Andreu Salou,2017,150,79,71,23,91,36
658,171833,Sant Aniol de Finestres,2017,363,195,168,59,233,71
659,081982,Sant Antoni de Vilamajor,2017,6005,2990,3015,1015,4079,911
660,081995,Sant Bartomeu del Grau,2017,858,452,406,124,571,163
661,082009,Sant Boi de Llobregat,2017,82142,40246,41896,12967,53906,15269
662,082016,Sant Boi de Lluçanès,2017,515,258,257,55,301,159
663,431362,Sant Carles de la Ràpita,2017,14902,7295,7607,2093,9600,3209
664,082037,Sant Cebrià de Vallalta,2017,3310,1728,1582,620,2212,478
665,082021,Sant Celoni,2017,17588,8784,8804,3017,11551,3020
666,082042,Sant Climent de Llobregat,2017,4038,2038,2000,802,2706,530
667,171582,Sant Climent Sescebes,2017,636,372,264,81,425,130
668,082055,Sant Cugat del Vallès,2017,89516,43515,46001,17802,59801,11913
669,082068,Sant Cugat Sesgarrigues,2017,980,475,505,174,609,197
670,251961,Sant Esteve de la Sarga,2017,130,77,53,6,88,36
671,082074,Sant Esteve de Palautordera,2017,2648,1309,1339,511,1776,361
672,082080,Sant Esteve Sesrovires,2017,7670,3838,3832,1340,5190,1140
673,171595,Sant Feliu de Buixalleu,2017,825,431,394,112,547,166
674,082107,Sant Feliu de Codines,2017,6045,3063,2982,992,4074,979
675,171609,Sant Feliu de Guíxols,2017,21721,10712,11009,3385,14124,4212
676,082114,Sant Feliu de Llobregat,2017,44198,21424,22774,7343,28789,8066
677,171616,Sant Feliu de Pallerols,2017,1342,647,695,216,831,295
678,082129,Sant Feliu Sasserra,2017,606,321,285,82,382,142
679,171621,Sant Ferriol,2017,228,125,103,42,150,36
680,082093,Sant Fost de Campsentelles,2017,8664,4299,4365,1313,5647,1704
681,082135,Sant Fruitós de Bages,2017,8512,4199,4313,1534,5686,1292
682,171637,Sant Gregori,2017,3636,1857,1779,702,2386,548
683,251924,Sant Guim de Freixenet,2017,1028,538,490,150,634,244
684,251977,Sant Guim de la Plana,2017,177,101,76,20,105,52
685,171642,Sant Hilari Sacalm,2017,5578,2801,2777,869,3534,1175
686,082153,Sant Hipòlit de Voltregà,2017,3453,1699,1754,532,2261,660
687,081939,Sant Iscle de Vallalta,2017,1295,663,632,240,850,205
688,439023,Sant Jaume d'Enveja,2017,3479,1748,1731,480,2148,851
689,082166,Sant Jaume de Frontanyà,2017,30,19,11,3,18,9
690,171655,Sant Jaume de Llierca,2017,852,410,442,118,524,210
691,431378,Sant Jaume dels Domenys,2017,2561,1319,1242,485,1655,421
692,171674,Sant Joan de les Abadesses,2017,3270,1631,1639,383,1960,927
693,171680,Sant Joan de Mollet,2017,498,236,262,74,327,97
694,082188,Sant Joan de Vilatorrada,2017,10802,5402,5400,1826,6967,2009
695,082172,Sant Joan Despí,2017,33873,16500,17373,5836,22397,5640
696,171851,Sant Joan les Fonts,2017,2931,1478,1453,410,1810,711
697,171668,Sant Jordi Desvalls,2017,732,357,375,117,460,155
698,089030,Sant Julià de Cerdanyola,2017,242,133,109,27,156,59
699,171693,Sant Julià de Ramis,2017,3447,1750,1697,671,2326,450
700,082205,Sant Julià de Vilatorta,2017,3101,1528,1573,558,2030,513
701,179032,Sant Julià del Llor i Bonmatí,2017,1321,683,638,260,863,198
702,082212,Sant Just Desvern,2017,17201,8235,8966,2906,11000,3295
703,082227,Sant Llorenç d'Hortons,2017,2547,1292,1255,459,1706,382
704,171714,Sant Llorenç de la Muga,2017,251,133,118,36,163,52
705,251930,Sant Llorenç de Morunys,2017,949,470,479,109,560,280
706,082233,Sant Llorenç Savall,2017,2361,1195,1166,345,1500,516
707,082251,Sant Martí d'Albars,2017,110,55,55,12,65,33
708,082248,Sant Martí de Centelles,2017,1125,581,544,177,788,160
709,171729,Sant Martí de Llémena,2017,612,314,298,101,421,90
710,259025,Sant Martí de Riucorb,2017,661,347,314,71,366,224
711,082264,Sant Martí de Tous,2017,1196,610,586,231,741,224
712,082270,Sant Martí Sarroca,2017,3197,1571,1626,537,2053,607
713,082286,Sant Martí Sesgueioles,2017,354,183,171,42,237,75
714,171735,Sant Martí Vell,2017,245,126,119,35,157,53
715,082299,Sant Mateu de Bages,2017,611,308,303,57,355,199
716,171740,Sant Miquel de Campmajor,2017,226,119,107,37,145,44
717,171753,Sant Miquel de Fluvià,2017,746,390,356,106,502,138
718,171766,Sant Mori,2017,175,94,81,25,118,32
719,171772,Sant Pau de Segúries,2017,672,330,342,86,422,164
720,082310,Sant Pere de Ribes,2017,30142,15095,15047,5225,20644,4273
721,082325,Sant Pere de Riudebitlles,2017,2343,1170,1173,431,1400,512
722,082331,Sant Pere de Torelló,2017,2437,1263,1174,355,1600,482
723,082346,Sant Pere de Vilamajor,2017,4313,2150,2163,771,2910,632
724,171788,Sant Pere Pescador,2017,2040,1102,938,324,1386,330
725,081897,Sant Pere Sallavinera,2017,156,86,70,25,89,42
726,082359,Sant Pol de Mar,2017,5062,2503,2559,804,3177,1081
727,082362,Sant Quintí de Mediona,2017,2170,1109,1061,386,1370,414
728,082378,Sant Quirze de Besora,2017,2092,1031,1061,276,1268,548
729,082384,Sant Quirze del Vallès,2017,19867,9715,10152,3854,13410,2603
730,082397,Sant Quirze Safaja,2017,627,330,297,132,417,78
731,251945,Sant Ramon,2017,507,275,232,48,307,152
732,082401,Sant Sadurní d'Anoia,2017,12749,6276,6473,2244,8417,2088
733,082418,Sant Sadurní d'Osormort,2017,79,48,31,4,54,21
734,080983,Sant Salvador de Guardiola,2017,3127,1584,1543,553,2017,557
735,082628,Sant Vicenç de Castellet,2017,9300,4617,4683,1499,6071,1730
736,082649,Sant Vicenç de Montalt,2017,6272,3136,3136,1161,4096,1015
737,082652,Sant Vicenç de Torelló,2017,1998,985,1013,328,1292,378
738,082634,Sant Vicenç dels Horts,2017,27982,13932,14050,4605,18972,4405
739,431384,Santa Bàrbara,2017,3797,1933,1864,562,2429,806
740,082439,Santa Cecília de Voltregà,2017,189,97,92,25,127,37
741,082444,Santa Coloma de Cervelló,2017,8082,3965,4117,1692,5379,1011
742,171805,Santa Coloma de Farners,2017,12854,6461,6393,2284,8510,2060
743,082457,Santa Coloma de Gramenet,2017,117597,58452,59145,18231,76178,23188
744,431397,Santa Coloma de Queralt,2017,2695,1334,1361,431,1624,640
745,171812,Santa Cristina d'Aro,2017,5194,2600,2594,895,3430,869
746,082460,Santa Eugènia de Berga,2017,2259,1156,1103,325,1551,383
747,082476,Santa Eulàlia de Riuprimer,2017,1289,652,637,265,832,192
748,082482,Santa Eulàlia de Ronçana,2017,7124,3578,3546,1231,4667,1226
749,082495,Santa Fe del Penedès,2017,380,196,184,69,257,54
750,171827,Santa Llogaia d'Àlguema,2017,353,184,169,67,238,48
751,082508,Santa Margarida de Montbui,2017,9748,4875,4873,1725,6362,1661
752,082515,Santa Margarida i els Monjos,2017,7480,3801,3679,1517,4942,1021
753,082589,Santa Maria d'Oló,2017,1030,521,509,150,636,244
754,082536,Santa Maria de Besora,2017,147,75,72,15,90,42
755,082567,Santa Maria de Martorelles,2017,858,436,422,146,585,127
756,082554,Santa Maria de Merlès,2017,190,91,99,42,120,28
757,082573,Santa Maria de Miralles,2017,123,65,58,14,78,31
758,082592,Santa Maria de Palautordera,2017,9286,4662,4624,1586,6226,1474
759,431401,Santa Oliva,2017,3315,1679,1636,597,2125,593
760,171848,Santa Pau,2017,1549,777,772,209,1005,335
761,082606,Santa Perpètua de Mogoda,2017,25574,12900,12674,4753,17188,3633
762,082613,Santa Susanna,2017,3352,1690,1662,565,2239,548
763,081923,Santpedor,2017,7496,3709,3787,1394,4854,1248
764,431423,Sarral,2017,1560,789,771,264,982,314
765,171864,Sarrià de Ter,2017,5052,2484,2568,879,3307,866
766,252017,Sarroca de Bellera,2017,120,69,51,4,79,37
767,252000,Sarroca de Lleida,2017,370,201,169,30,208,132
768,171870,"Saus, Camallera i Llampaies",2017,839,415,424,131,529,179
769,431439,Savallà del Comtat,2017,56,28,28,1,37,18
770,431444,"Secuita, la",2017,1676,841,835,290,1129,257
771,171886,"Selva de Mar, la",2017,191,109,82,13,124,54
772,431457,"Selva del Camp, la",2017,5546,2786,2760,955,3724,867
773,431460,Senan,2017,49,33,16,6,31,12
774,430445,"Sénia, la",2017,5652,2837,2815,813,3721,1118
775,252022,Senterada,2017,136,79,57,9,105,22
776,250352,"Sentiu de Sió, la",2017,445,229,216,44,277,124
777,082671,Sentmenat,2017,8818,4455,4363,1585,5984,1249
778,171903,Serinyà,2017,1117,577,540,189,723,205
779,252043,Seròs,2017,1895,1020,875,268,1198,429
780,171910,Serra de Daró,2017,206,113,93,33,125,48
781,171925,Setcases,2017,182,97,85,16,120,46
782,252038,"Seu d'Urgell, la",2017,12015,5789,6226,1771,8012,2232
783,082690,Seva,2017,3451,1726,1725,573,2269,609
784,252056,Sidamon,2017,732,383,349,126,489,117
785,171931,Sils,2017,5910,2996,2914,1039,3915,956
786,082704,Sitges,2017,28527,14279,14248,4253,19175,5099
787,170524,Siurana,2017,159,74,85,21,99,39
788,082711,Sobremunt,2017,84,36,48,8,58,18
789,252069,"Soleràs, el",2017,346,183,163,45,190,111
790,431476,Solivella,2017,614,312,302,69,372,173
791,252075,Solsona,2017,8974,4444,4530,1429,5883,1662
792,082726,Sora,2017,193,112,81,28,129,36
793,252081,Soriguera,2017,403,220,183,55,283,65
794,252094,Sort,2017,2128,1056,1072,326,1422,380
795,252108,Soses,2017,1719,889,830,290,1086,343
796,082732,Subirats,2017,3013,1550,1463,468,1966,579
797,252115,Sudanell,2017,874,482,392,101,567,206
798,252120,Sunyer,2017,359,209,150,30,251,78
799,082747,Súria,2017,5911,2882,3029,778,3772,1361
800,171946,Susqueda,2017,98,56,42,7,68,23
801,082763,Tagamanent,2017,326,172,154,54,224,48
802,082779,Talamanca,2017,193,110,83,27,123,43
803,252154,Talarn,2017,702,476,226,55,562,85
804,252167,Talavera,2017,250,141,109,27,140,83
805,171959,"Tallada d'Empordà, la",2017,450,234,216,65,284,101
806,082785,Taradell,2017,6344,3159,3185,1054,4119,1171
807,431482,Tarragona,2017,131507,63941,67566,21324,86765,23418
808,252173,Tàrrega,2017,16599,8230,8369,2975,10981,2643
809,252189,Tarrés,2017,99,56,43,16,57,26
810,252192,Tarroja de Segarra,2017,181,99,82,27,109,45
811,082750,Tavèrnoles,2017,317,159,158,49,213,55
812,082802,Tavertet,2017,116,62,54,11,75,30
813,082819,Teià,2017,6333,3117,3216,986,4103,1244
814,252206,Térmens,2017,1442,720,722,179,919,344
815,171962,Terrades,2017,306,149,157,43,205,58
816,082798,Terrassa,2017,216428,106557,109871,37974,142740,35714
817,082824,Tiana,2017,8645,4136,4509,1520,5787,1338
818,252213,Tírvia,2017,141,69,72,12,95,34
819,252228,Tiurana,2017,76,37,39,4,50,22
820,431495,Tivenys,2017,879,448,431,98,514,267
821,431508,Tivissa,2017,1677,841,836,205,1014,458
822,082830,Tona,2017,8114,4008,4106,1383,5322,1409
823,252234,Torà,2017,1223,613,610,143,789,291
824,082845,Tordera,2017,16637,8427,8210,2948,10876,2813
825,082858,Torelló,2017,13995,6914,7081,2202,9169,2624
826,252249,"Torms, els",2017,147,83,64,9,83,55
827,252252,Tornabous,2017,858,465,393,110,523,225
828,252271,"Torre de Cabdella, la",2017,754,386,368,60,474,220
829,082861,"Torre de Claramunt, la",2017,3707,1900,1807,607,2525,575
830,431515,"Torre de Fontaubella, la",2017,137,72,65,20,74,43
831,431520,"Torre de l'Espanyol, la",2017,634,327,307,73,395,166
832,252265,Torrebesses,2017,290,155,135,27,171,92
833,431536,Torredembarra,2017,15726,7667,8059,2511,10360,2855
834,252287,Torrefarrera,2017,4653,2363,2290,992,3155,506
835,259078,Torrefeta i Florejacs,2017,591,313,278,62,364,165
836,252304,Torregrossa,2017,2192,1113,1079,319,1366,507
837,252311,Torrelameu,2017,715,403,312,86,474,155
838,082877,Torrelavit,2017,1400,726,674,230,906,264
839,082883,Torrelles de Foix,2017,2243,1202,1041,332,1491,420
840,082896,Torrelles de Llobregat,2017,5950,2934,3016,1173,4049,728
841,171978,Torrent,2017,161,90,71,21,99,41
842,252326,Torres de Segre,2017,2225,1130,1095,260,1544,421
843,252332,Torre-serona,2017,363,185,178,41,238,84
844,171984,Torroella de Fluvià,2017,688,367,321,99,479,110
845,171997,Torroella de Montgrí,2017,11516,5842,5674,1896,7604,2016
846,431541,Torroja del Priorat,2017,149,82,67,9,89,51
847,172001,Tortellà,2017,783,380,403,112,495,176
848,431554,Tortosa,2017,33445,16613,16832,5139,21456,6850
849,172018,Toses,2017,168,99,69,20,115,33
850,172023,Tossa de Mar,2017,5542,2792,2750,737,3732,1073
851,252347,Tremp,2017,5906,2910,2996,853,3706,1347
852,172044,Ullà,2017,1138,626,512,214,768,156
853,082900,Ullastrell,2017,2054,1042,1012,441,1323,290
854,172057,Ullastret,2017,295,148,147,51,182,62
855,431567,Ulldecona,2017,6321,3252,3069,972,4078,1271
856,431573,Ulldemolins,2017,395,226,169,27,235,133
857,172039,Ultramort,2017,216,121,95,39,120,57
858,172060,Urús,2017,173,81,92,13,121,39
859,082917,Vacarisses,2017,6328,3239,3089,1319,4209,800
860,170144,"Vajol, la",2017,85,47,38,8,61,16
861,172076,"Vall d'en Bas, la",2017,3018,1519,1499,506,1921,591
862,172082,"Vall de Bianya, la",2017,1265,633,632,208,832,225
863,250432,"Vall de Boí, la",2017,1015,537,478,123,715,177
864,259010,Vall de Cardós,2017,360,191,169,41,239,80
865,082922,Vallbona d'Anoia,2017,1412,738,674,217,927,268
866,252385,Vallbona de les Monges,2017,226,122,104,20,123,83
867,082938,Vallcebre,2017,251,142,109,19,153,79
868,431589,Vallclara,2017,103,62,41,16,62,25
869,252402,Vallfogona de Balaguer,2017,1867,929,938,310,1228,329
870,171707,Vallfogona de Ripollès,2017,204,112,92,23,119,62
871,431592,Vallfogona de Riucorb,2017,87,51,36,0,52,35
872,082943,Vallgorguina,2017,2789,1414,1375,597,1864,328
873,082956,Vallirana,2017,14784,7408,7376,2689,9674,2421
874,172095,Vall-llobrega,2017,924,464,460,206,622,96
875,431606,Vallmoll,2017,1702,864,838,267,1152,283
876,082969,Vallromanes,2017,2514,1280,1234,526,1674,314
877,431613,Valls,2017,24112,11978,12134,3969,15877,4266
878,259062,"Valls d'Aguilar, les",2017,277,152,125,23,176,78
879,252398,"Valls de Valira, les",2017,808,418,390,105,547,156
880,431628,Vandellòs i l'Hospitalet de l'Infant,2017,6294,3155,3139,1070,4174,1050
881,259097,"Vansa i Fórnols, la",2017,180,96,84,8,119,53
882,082975,Veciana,2017,167,94,73,30,86,51
883,431634,"Vendrell, el",2017,36568,18145,18423,6138,23911,6519
884,172109,Ventalló,2017,793,397,396,124,498,171
885,252424,Verdú,2017,924,441,483,116,551,257
886,172116,Verges,2017,1159,558,601,179,698,282
887,431649,Vespella de Gaià,2017,424,234,190,70,265,89
888,082981,Vic,2017,43964,21933,22031,7782,29342,6840
889,172121,Vidrà,2017,177,89,88,25,120,32
890,172137,Vidreres,2017,7652,3949,3703,1250,5100,1302
891,252430,Vielha e Mijaran,2017,5512,2811,2701,799,4037,676
892,431652,Vilabella,2017,749,388,361,88,482,179
893,172142,Vilabertran,2017,919,468,451,159,568,192
894,172155,Vilablareix,2017,2691,1328,1363,475,1815,401
895,082994,Vilada,2017,424,222,202,27,256,141
896,172174,Viladamat,2017,468,241,227,62,300,106
897,172168,Viladasens,2017,216,112,104,34,141,41
898,083015,Viladecans,2017,65993,32731,33262,11773,43871,10349
899,083008,Viladecavalls,2017,7392,3660,3732,1219,5183,990
900,172180,Vilademuls,2017,789,415,374,136,504,149
901,172207,Viladrau,2017,1038,517,521,153,681,204
902,172214,Vilafant,2017,5465,2700,2765,905,3652,908
903,083054,Vilafranca del Penedès,2017,39532,19333,20199,6933,25778,6821
904,252445,Vilagrassa,2017,522,270,252,89,339,94
905,172235,Vilajuïga,2017,1123,561,562,177,760,186
906,431750,Vilalba dels Arcs,2017,643,323,320,63,375,205
907,083067,Vilalba Sasserra,2017,690,347,343,127,453,110
908,252458,Vilaller,2017,547,292,255,62,361,124
909,172240,Vilallonga de Ter,2017,406,213,193,38,264,104
910,431665,Vilallonga del Camp,2017,2340,1200,1140,501,1530,309
911,172253,Vilamacolum,2017,325,168,157,56,200,69
912,172266,Vilamalla,2017,1146,579,567,193,756,197
913,172272,Vilamaniscle,2017,199,108,91,31,132,36
914,252477,Vilamòs,2017,151,83,68,13,124,14
915,172288,Vilanant,2017,401,201,200,69,259,73
916,431671,Vilanova d'Escornalbou,2017,521,275,246,77,336,108
917,252483,Vilanova de Bellpuig,2017,1159,587,572,175,636,348
918,252496,Vilanova de l'Aguda,2017,206,102,104,16,124,66
919,252542,Vilanova de la Barca,2017,1044,533,511,141,659,244
920,252509,Vilanova de Meià,2017,401,224,177,40,236,125
921,431687,Vilanova de Prades,2017,121,63,58,17,76,28
922,083036,Vilanova de Sau,2017,313,153,160,29,209,75
923,252516,Vilanova de Segrià,2017,943,497,446,129,622,192
924,083020,Vilanova del Camí,2017,12332,6173,6159,2225,8171,1936
925,089024,Vilanova del Vallès,2017,5285,2664,2621,1183,3533,569
926,083073,Vilanova i la Geltrú,2017,66077,31979,34098,10197,43676,12204
927,431690,Vilaplana,2017,585,299,286,66,398,121
928,431704,Vila-rodona,2017,1259,653,606,210,818,231
929,172305,Vila-sacra,2017,706,345,361,138,439,129
930,252521,Vila-sana,2017,721,356,365,112,471,138
931,431711,Vila-seca,2017,21993,11062,10931,4229,15063,2701
932,082140,Vilassar de Dalt,2017,8961,4412,4549,1438,5894,1629
933,082191,Vilassar de Mar,2017,20636,9932,10704,3445,13384,3807
934,172229,Vilaür,2017,145,74,71,30,84,31
935,431726,Vilaverd,2017,440,228,212,73,279,88
936,431732,"Vilella Alta, la",2017,127,69,58,22,71,34
937,431747,"Vilella Baixa, la",2017,200,111,89,27,119,54
938,172333,Vilobí d'Onyar,2017,3138,1635,1503,545,2072,521
939,083041,Vilobí del Penedès,2017,1094,575,519,196,683,215
940,172327,Vilopriu,2017,207,110,97,36,121,50
941,252537,"Vilosell, el",2017,180,91,89,8,103,69
942,431763,Vimbodí i Poblet,2017,917,509,408,107,553,257
943,252555,Vinaixa,2017,483,254,229,46,304,133
944,431779,Vinebre,2017,428,214,214,65,259,104
945,431785,Vinyols i els Arcs,2017,1928,1003,925,303,1287,338
946,083089,Viver i Serrateix,2017,173,88,85,29,96,48
947,430521,Xerta,2017,1188,578,610,126,730,332
948,000000,Catalunya,2017,7555830,3710200,3845630,1179741,4976815,1399274
0,250019,Abella de la Conca,2018,179,96,83,19,117,43
1,080018,Abrera,2018,12489,6326,6163,2310,8297,1882
2,250024,Àger,2018,588,320,268,49,363,176
3,250030,Agramunt,2018,5371,2689,2682,838,3466,1067
4,080023,Aguilar de Segarra,2018,288,155,133,54,180,54
5,170010,Agullana,2018,831,411,420,127,523,181
6,080142,Aiguafreda,2018,2504,1208,1296,343,1602,559
7,430017,Aiguamúrcia,2018,901,465,436,130,574,197
8,170025,Aiguaviva,2018,756,383,373,148,490,118
9,250387,Aitona,2018,2591,1358,1233,390,1613,588
10,250045,"Alamús, els",2018,819,412,407,116,532,171
11,250058,Alàs i Cerc,2018,329,171,158,39,189,101
12,250061,"Albagés, l'",2018,369,194,175,32,228,109
13,170031,Albanyà,2018,157,80,77,34,99,24
14,250077,Albatàrrec,2018,2221,1150,1071,372,1583,266
15,250083,Albesa,2018,1556,855,701,211,989,356
16,250096,"Albi, l'",2018,764,389,375,108,428,228
17,430022,Albinyana,2018,2438,1243,1195,353,1599,486
18,430038,"Albiol, l'",2018,485,253,232,90,325,70
19,170046,Albons,2018,776,401,375,112,522,142
20,430043,Alcanar,2018,9418,4748,4670,1316,6109,1993
21,250100,Alcanó,2018,235,119,116,31,138,66
22,250117,Alcarràs,2018,9514,4957,4557,1763,6596,1155
23,250122,Alcoletge,2018,3420,1775,1645,603,2375,442
24,430056,Alcover,2018,5064,2499,2565,854,3305,905
25,439044,"Aldea, l'",2018,4160,2197,1963,612,2644,904
26,430069,Aldover,2018,882,445,437,99,522,261
27,430075,"Aleixar, l'",2018,873,450,423,129,587,157
28,080039,Alella,2018,9801,4762,5039,1559,6229,2013
29,430081,Alfara de Carles,2018,377,199,178,33,231,113
30,250138,Alfarràs,2018,2797,1459,1338,359,1770,668
31,250143,Alfés,2018,312,162,150,40,189,83
32,430094,Alforja,2018,1801,921,880,248,1202,351
33,250156,Algerri,2018,386,206,180,30,212,144
34,250169,Alguaire,2018,2971,1562,1409,419,1926,626
35,250175,Alins,2018,276,144,132,30,161,85
36,430108,Alió,2018,439,208,231,69,272,98
37,250194,Almacelles,2018,6791,3584,3207,964,4494,1333
38,250208,Almatret,2018,307,172,135,7,185,115
39,250215,Almenar,2018,3398,1791,1607,443,2172,783
40,430115,Almoster,2018,1351,680,671,180,976,195
41,250220,Alòs de Balaguer,2018,130,74,56,11,70,49
42,170062,Alp,2018,1580,828,752,190,1160,230
43,080044,Alpens,2018,266,144,122,38,186,42
44,250236,Alpicat,2018,6255,3134,3121,1183,4207,865
45,250241,Alt Àneu,2018,405,231,174,34,279,92
46,430120,Altafulla,2018,5243,2555,2688,925,3393,925
47,170078,Amer,2018,2298,1122,1176,318,1425,555
48,430136,"Ametlla de Mar, l'",2018,6787,3384,3403,946,4170,1671
49,080057,"Ametlla del Vallès, l'",2018,8462,4277,4185,1389,5831,1242
50,439060,"Ampolla, l'",2018,3205,1631,1574,375,1964,866
51,430141,Amposta,2018,20738,10449,10289,3386,13451,3901
52,170084,Anglès,2018,5599,2780,2819,955,3595,1049
53,250273,Anglesola,2018,1363,682,681,222,816,325
54,250292,Arbeca,2018,2144,1100,1044,248,1322,574
55,430167,"Arboç, l'",2018,5517,2852,2665,1026,3597,894
56,430154,Arbolí,2018,137,79,58,11,95,31
57,170097,Arbúcies,2018,6556,3390,3166,1131,4247,1178
58,080060,Arenys de Mar,2018,15776,7683,8093,2262,10114,3400
59,080076,Arenys de Munt,2018,8931,4483,4448,1452,5920,1559
60,170101,Argelaguer,2018,397,205,192,38,271,88
61,080082,Argençola,2018,217,110,107,27,149,41
62,430173,"Argentera, l'",2018,124,70,54,4,81,39
63,080095,Argentona,2018,12452,6132,6320,2057,8193,2202
64,170118,"Armentera, l'",2018,930,461,469,159,581,190
65,430189,Arnes,2018,455,224,231,44,236,175
66,250313,Arres,2018,65,42,23,5,51,9
67,250328,Arsèguel,2018,84,48,36,15,54,15
68,080109,Artés,2018,5698,2868,2830,910,3749,1039
69,250334,Artesa de Lleida,2018,1504,789,715,197,1003,304
70,250349,Artesa de Segre,2018,3432,1766,1666,493,2185,754
71,430192,Ascó,2018,1660,856,804,196,1068,396
72,250365,Aspa,2018,224,113,111,24,127,73
73,250371,"Avellanes i Santa Linya, les",2018,449,259,190,52,247,150
74,080116,Avià,2018,2226,1121,1105,351,1423,452
75,080121,Avinyó,2018,2275,1127,1148,331,1438,506
76,170123,Avinyonet de Puigventós,2018,1610,796,814,303,1124,183
77,080137,Avinyonet del Penedès,2018,1701,903,798,234,1130,337
78,080155,Badalona,2018,220440,108509,111931,34242,144715,41483
79,089045,Badia del Vallès,2018,13380,6567,6813,2059,8561,2760
80,080168,Bagà,2018,2138,1064,1074,237,1327,574
81,250390,Baix Pallars,2018,335,182,153,41,215,79
82,250404,Balaguer,2018,17162,8746,8416,2955,11209,2998
83,080174,Balenyà,2018,3821,1928,1893,615,2569,637
84,080180,Balsareny,2018,3159,1562,1597,382,2049,728
85,430206,Banyeres del Penedès,2018,3170,1612,1558,555,2085,530
86,170157,Banyoles,2018,19826,9873,9953,3549,12915,3362
87,250411,Barbens,2018,878,467,411,104,555,219
88,430213,Barberà de la Conca,2018,473,257,216,74,280,119
89,082520,Barberà del Vallès,2018,33091,16300,16791,5614,21938,5539
90,080193,Barcelona,2018,1636762,775619,861143,204754,1081943,350065
91,250426,"Baronia de Rialb, la",2018,237,121,116,16,140,81
92,170160,Bàscara,2018,1004,520,484,158,627,219
93,250447,Bassella,2018,224,112,112,21,140,63
94,430228,Batea,2018,1890,944,946,253,1067,570
95,250450,Bausen,2018,58,30,28,2,32,24
96,080207,Begues,2018,7098,3528,3570,1318,4844,936
97,170139,Begur,2018,3925,1964,1961,477,2610,838
98,250463,Belianes,2018,525,269,256,53,307,165
99,251706,Bellaguarda,2018,287,152,135,22,173,92
100,170182,Bellcaire d'Empordà,2018,693,336,357,108,428,157
101,250479,Bellcaire d'Urgell,2018,1230,627,603,156,745,329
102,250485,Bell-lloc d'Urgell,2018,2315,1139,1176,335,1489,491
103,250498,Bellmunt d'Urgell,2018,185,89,96,20,116,49
104,430234,Bellmunt del Priorat,2018,280,145,135,29,170,81
105,080214,Bellprat,2018,64,41,23,1,37,26
106,250501,Bellpuig,2018,5133,2705,2428,792,3419,922
107,430249,Bellvei,2018,2203,1132,1071,396,1424,383
108,250518,Bellver de Cerdanya,2018,1937,1009,928,273,1232,432
109,250523,Bellvís,2018,2255,1149,1106,307,1374,574
110,250539,Benavent de Segrià,2018,1499,781,718,234,1034,231
111,430252,Benifallet,2018,739,348,391,57,445,237
112,430265,Benissanet,2018,1161,646,515,137,746,278
113,080229,Berga,2018,16494,8166,8328,2303,10477,3714
114,170195,Besalú,2018,2492,1170,1322,405,1514,573
115,170209,Bescanó,2018,4960,2505,2455,963,3225,772
116,170216,Beuda,2018,190,100,90,37,128,25
117,080235,Bigues i Riells del Fai,2018,9092,4645,4447,1568,6168,1356
118,250557,Biosca,2018,176,94,82,9,106,61
119,170221,"Bisbal d'Empordà, la",2018,10974,5446,5528,2001,7177,1796
120,430271,"Bisbal de Falset, la",2018,216,116,100,28,123,65
121,430287,"Bisbal del Penedès, la",2018,3528,1862,1666,482,2308,738
122,172348,Biure,2018,232,118,114,23,142,67
123,430290,Blancafort,2018,389,198,191,45,240,104
124,170237,Blanes,2018,39028,19356,19672,5592,26020,7416
125,170293,Boadella i les Escaules,2018,252,130,122,30,165,57
126,170242,Bolvir,2018,369,191,178,43,251,75
127,430304,Bonastre,2018,688,357,331,125,455,108
128,250576,"Bòrdes, Es",2018,259,144,115,34,179,46
129,170255,Bordils,2018,1779,887,892,295,1195,289
130,250582,"Borges Blanques, les",2018,6087,3105,2982,921,3862,1304
131,430311,"Borges del Camp, les",2018,2037,1050,987,343,1302,392
132,170268,Borrassà,2018,714,374,340,137,450,127
133,080240,Borredà,2018,445,253,192,38,292,115
134,250595,Bossòst,2018,1109,542,567,151,756,202
135,430326,Bot,2018,573,295,278,49,316,208
136,430332,Botarell,2018,1068,549,519,193,728,147
137,250560,Bovera,2018,247,133,114,17,134,96
138,430347,Bràfim,2018,692,357,335,127,409,156
139,170274,Breda,2018,3740,1836,1904,497,2433,810
140,080253,"Bruc, el",2018,2050,1107,943,379,1393,278
141,080266,"Brull, el",2018,263,145,118,51,173,39
142,170280,Brunyola i Sant Martí Sapresa,2018,383,195,188,47,238,98
143,430350,Cabacés,2018,298,155,143,45,171,82
144,250609,Cabanabona,2018,75,36,39,4,46,25
145,170314,Cabanelles,2018,279,154,125,46,175,58
146,170307,Cabanes,2018,948,500,448,142,596,210
147,080272,"Cabanyes, les",2018,964,488,476,186,644,134
148,250616,Cabó,2018,92,49,43,6,55,31
149,430363,Cabra del Camp,2018,1163,608,555,168,772,223
150,080288,Cabrera d'Anoia,2018,1410,769,641,214,992,204
151,080291,Cabrera de Mar,2018,4680,2348,2332,717,3160,803
152,080305,Cabrils,2018,7439,3682,3757,1233,5129,1077
153,170329,Cadaqués,2018,2712,1322,1390,381,1867,464
154,080312,Calaf,2018,3535,1775,1760,598,2200,737
155,430379,Calafell,2018,26538,13362,13176,3958,17312,5268
156,080348,Calders,2018,970,499,471,143,646,181
157,080327,Caldes d'Estrac,2018,2982,1426,1556,419,1959,604
158,170335,Caldes de Malavella,2018,7641,3828,3813,1300,5071,1270
159,080333,Caldes de Montbui,2018,17554,8745,8809,2771,11591,3192
160,080351,Calella,2018,19069,9339,9730,2718,12474,3877
161,080370,Calldetenes,2018,2489,1259,1230,394,1652,443
162,080386,Callús,2018,2140,1061,1079,396,1377,367
163,080364,Calonge de Segarra,2018,188,92,96,19,114,55
164,170340,Calonge i Sant Antoni,2018,11092,5571,5521,1611,7296,2185
165,250621,Camarasa,2018,817,410,407,89,479,249
166,439039,Camarles,2018,3224,1638,1586,457,2014,753
167,430385,Cambrils,2018,33898,16553,17345,5925,22459,5514
168,170353,Camós,2018,693,341,352,108,409,176
169,170366,Campdevànol,2018,3223,1566,1657,415,1948,860
170,170372,Campelles,2018,139,71,68,14,90,35
171,080399,Campins,2018,529,277,252,71,381,77
172,170388,Campllong,2018,547,272,275,120,363,64
173,170391,Camprodon,2018,2281,1117,1164,286,1373,622
174,250637,Canejan,2018,107,57,50,9,71,27
175,170405,Canet d'Adri,2018,723,371,352,120,457,146
176,080403,Canet de Mar,2018,14526,7068,7458,2186,9288,3052
177,439076,"Canonja, la",2018,5893,2892,3001,1056,3936,901
178,080410,Canovelles,2018,16629,8613,8016,3015,11052,2562
179,080425,Cànoves i Samalús,2018,3117,1581,1536,522,2061,534
180,170412,Cantallops,2018,313,153,160,44,190,79
181,080431,Canyelles,2018,4647,2414,2233,777,3180,690
182,430398,Capafonts,2018,121,62,59,11,78,32
183,430402,Capçanes,2018,398,202,196,40,242,116
184,080446,Capellades,2018,5293,2636,2657,780,3372,1141
185,170427,Capmany,2018,613,307,306,90,386,137
186,080459,Capolat,2018,94,44,50,21,56,17
187,080462,Cardedeu,2018,18357,8957,9400,3371,12094,2892
188,080478,Cardona,2018,4636,2273,2363,590,2776,1270
189,080484,Carme,2018,765,396,369,110,484,171
190,430419,Caseres,2018,259,129,130,19,148,92
191,170448,Cassà de la Selva,2018,10380,5301,5079,1783,6914,1683
192,080497,Casserres,2018,1608,813,795,224,966,418
193,080575,Castell de l'Areny,2018,68,38,30,6,52,10
194,259046,Castell de Mur,2018,183,104,79,16,105,62
195,250642,Castellar de la Ribera,2018,134,67,67,27,74,33
196,080522,Castellar de n'Hug,2018,159,85,74,12,111,36
197,080500,Castellar del Riu,2018,169,94,75,27,102,40
198,080517,Castellar del Vallès,2018,24187,11948,12239,4044,16218,3925
199,080538,Castellbell i el Vilar,2018,3647,1863,1784,543,2403,701
200,080543,Castellbisbal,2018,12390,6238,6152,2266,8468,1656
201,080556,Castellcir,2018,752,392,360,137,513,102
202,250674,Castelldans,2018,960,511,449,116,617,227
203,080569,Castelldefels,2018,67004,33018,33986,10988,46115,9901
204,080581,Castellet i la Gornal,2018,2292,1180,1112,344,1494,454
205,170464,Castellfollit de la Roca,2018,961,493,468,134,581,246
206,080608,Castellfollit de Riubregós,2018,151,86,65,11,93,47
207,080594,Castellfollit del Boix,2018,436,222,214,72,274,90
208,080615,Castellgalí,2018,2062,1062,1000,354,1324,384
209,080620,Castellnou de Bages,2018,1397,732,665,259,954,184
210,250680,Castellnou de Seana,2018,683,361,322,90,398,195
211,170470,Castelló d'Empúries,2018,10906,5508,5398,1718,7217,1971
212,250693,Castelló de Farfanya,2018,536,288,248,62,327,147
213,080636,Castellolí,2018,619,302,317,128,385,106
214,170486,Castell-Platja d'Aro,2018,10860,5357,5503,1617,7173,2070
215,250707,Castellserà,2018,1003,506,497,119,599,285
216,080641,Castellterçol,2018,2463,1236,1227,338,1550,575
217,430424,Castellvell del Camp,2018,2857,1438,1419,483,1969,405
218,080654,Castellví de la Marca,2018,1535,771,764,212,986,337
219,080667,Castellví de Rosanes,2018,1884,931,953,298,1302,284
220,430430,"Catllar, el",2018,4451,2309,2142,750,3048,653
221,250714,Cava,2018,47,29,18,3,27,17
222,171899,"Cellera de Ter, la",2018,1946,965,981,292,1201,453
223,170499,Celrà,2018,5452,2722,2730,1158,3732,562
224,080673,Centelles,2018,7404,3630,3774,1177,4784,1443
225,082687,Cercs,2018,1145,577,568,120,695,330
226,082665,Cerdanyola del Vallès,2018,57403,28038,29365,8156,38278,10969
227,080689,Cervelló,2018,9054,4529,4525,1500,6004,1550
228,250729,Cervera,2018,9180,4670,4510,1569,6102,1509
229,250735,Cervià de les Garrigues,2018,640,336,304,57,388,195
230,170502,Cervià de Ter,2018,968,492,476,173,623,172
231,170519,Cistella,2018,282,138,144,42,175,65
232,250740,Ciutadilla,2018,208,111,97,21,121,66
233,250753,Clariana de Cardener,2018,157,82,75,20,110,27
234,250766,"Cogul, el",2018,158,88,70,10,86,62
235,170545,Colera,2018,448,223,225,34,277,137
236,250772,Coll de Nargó,2018,550,285,265,65,336,149
237,080692,Collbató,2018,4466,2320,2146,839,3016,611
238,430458,Colldejou,2018,176,93,83,19,117,40
239,080706,Collsuspina,2018,342,174,168,62,217,63
240,170558,Colomers,2018,176,87,89,19,110,47
241,251636,"Coma i la Pedra, la",2018,265,157,108,23,189,53
242,251615,Conca de Dalt,2018,418,213,205,47,240,131
243,430461,Conesa,2018,103,54,49,7,62,34
244,430477,Constantí,2018,6540,3398,3142,1233,4351,956
245,080713,Copons,2018,310,152,158,56,185,69
246,430483,Corbera d'Ebre,2018,1016,531,485,121,620,275
247,080728,Corbera de Llobregat,2018,14822,7449,7373,2502,10213,2107
248,250788,Corbins,2018,1444,787,657,232,926,286
249,170577,Corçà,2018,1267,646,621,209,760,298
250,080734,Cornellà de Llobregat,2018,88592,42945,45647,13040,57813,17739
251,170561,Cornellà del Terri,2018,2364,1197,1167,394,1489,481
252,430496,Cornudella de Montsant,2018,941,505,436,104,620,217
253,430509,Creixell,2018,3642,1845,1797,529,2241,872
254,170583,Crespià,2018,246,127,119,38,151,57
255,179011,"Cruïlles, Monells i Sant Sadurní de l'Heura",2018,1279,640,639,182,846,251
256,080749,Cubelles,2018,15329,7687,7642,2563,10199,2567
257,250791,Cubells,2018,343,180,163,29,207,107
258,430516,Cunit,2018,12952,6347,6605,1892,8116,2944
259,170600,Darnius,2018,546,273,273,60,342,144
260,170617,Das,2018,253,131,122,49,162,42
261,439018,Deltebre,2018,11482,5788,5694,1597,7343,2542
262,080752,Dosrius,2018,5481,2780,2701,958,3794,729
263,430537,Duesaigües,2018,245,140,105,24,162,59
264,170622,"Escala, l'",2018,10339,5267,5072,1407,6658,2274
265,080765,Esparreguera,2018,22251,11249,11002,3567,15007,3677
266,170638,Espinelves,2018,215,110,105,28,143,44
267,250812,"Espluga Calba, l'",2018,341,171,170,33,191,117
268,430542,"Espluga de Francolí, l'",2018,3755,1824,1931,516,2400,839
269,080771,Esplugues de Llobregat,2018,46680,22300,24380,6530,29458,10692
270,170643,Espolla,2018,416,203,213,47,245,124
271,170656,Esponellà,2018,438,224,214,77,255,106
272,250827,Espot,2018,364,193,171,42,255,67
273,080787,"Espunyola, l'",2018,254,126,128,26,163,65
274,082541,"Esquirol, l'",2018,2181,1105,1076,282,1387,512
275,250886,Estamariu,2018,118,68,50,16,60,42
276,080790,"Estany, l'",2018,406,205,201,52,236,118
277,250851,Estaràs,2018,162,85,77,18,96,48
278,250864,Esterri d'Àneu,2018,772,364,408,98,554,120
279,250870,Esterri de Cardós,2018,70,37,33,10,48,12
280,430555,Falset,2018,2834,1412,1422,445,1769,620
281,170059,"Far d'Empordà, el",2018,599,305,294,102,389,108
282,250899,Farrera,2018,116,65,51,14,77,25
283,430568,"Fatarella, la",2018,941,458,483,94,520,327
284,430574,"Febró, la",2018,40,25,15,0,27,13
285,081347,Figaró-Montmany,2018,1114,547,567,160,742,212
286,080804,Fígols,2018,42,25,17,3,22,17
287,259084,Fígols i Alinyà,2018,252,145,107,22,150,80
288,430580,"Figuera, la",2018,111,63,48,5,66,40
289,170669,Figueres,2018,46654,23092,23562,8267,31219,7168
290,430593,Figuerola del Camp,2018,320,159,161,46,208,66
291,170675,Flaçà,2018,1093,528,565,172,699,222
292,430607,Flix,2018,3408,1717,1691,340,2112,956
293,250925,"Floresta, la",2018,147,79,68,11,93,43
294,080826,Fogars de la Selva,2018,1451,748,703,191,984,276
295,080811,Fogars de Montclús,2018,470,245,225,91,295,84
296,170681,Foixà,2018,297,150,147,29,180,88
297,080832,Folgueroles,2018,2267,1159,1108,449,1464,354
298,250931,Fondarella,2018,784,387,397,111,523,150
299,080847,Fonollosa,2018,1453,750,703,210,958,285
300,170694,Fontanals de Cerdanya,2018,444,220,224,45,301,98
301,170708,Fontanilles,2018,139,80,59,12,85,42
302,170715,Fontcoberta,2018,1468,738,730,250,973,245
303,080850,Font-rubí,2018,1327,688,639,190,830,307
304,250946,Foradada,2018,186,108,78,24,109,53
305,179026,Forallac,2018,1687,828,859,242,1077,368
306,430614,Forès,2018,43,25,18,2,20,21
307,170736,Fornells de la Selva,2018,2650,1322,1328,528,1762,360
308,170741,Fortià,2018,763,389,374,117,502,144
309,080863,"Franqueses del Vallès, les",2018,20092,10210,9882,3797,13600,2695
310,430629,Freginals,2018,346,175,171,29,217,100
311,250962,"Fuliola, la",2018,1248,619,629,204,755,289
312,250978,Fulleda,2018,85,44,41,1,53,31
313,080902,Gaià,2018,175,97,78,28,117,30
314,430635,"Galera, la",2018,731,375,356,88,440,203
315,080879,Gallifa,2018,172,95,77,15,117,40
316,430640,Gandesa,2018,3064,1563,1501,455,1918,691
317,430653,Garcia,2018,527,264,263,66,309,152
318,430666,"Garidells, els",2018,187,94,93,22,130,35
319,080885,"Garriga, la",2018,16514,7987,8527,2764,11007,2743
320,170754,Garrigàs,2018,437,231,206,66,289,82
321,170767,Garrigoles,2018,162,84,78,21,103,38
322,170773,Garriguella,2018,855,421,434,138,532,185
323,080898,Gavà,2018,46771,22876,23895,7599,31014,8158
324,250984,Gavet de la Conca,2018,261,129,132,20,146,95
325,080919,Gelida,2018,7533,3778,3755,1331,5024,1178
326,170789,Ger,2018,448,222,226,75,284,89
327,259123,Gimenells i el Pla de la Font,2018,1111,595,516,146,706,259
328,430672,Ginestar,2018,753,403,350,61,467,225
329,170792,Girona,2018,101852,48931,52921,16910,69014,15928
330,080924,Gironella,2018,4826,2384,2442,696,2884,1246
331,080930,Gisclareny,2018,25,15,10,1,19,5
332,430688,Godall,2018,575,289,286,55,321,199
333,250997,Golmés,2018,1840,917,923,318,1184,338
334,170806,Gombrèn,2018,188,96,92,35,108,45
335,251001,Gósol,2018,206,118,88,14,130,62
336,080945,"Granada, la",2018,2157,1092,1065,377,1455,325
337,251018,"Granadella, la",2018,712,387,325,80,419,213
338,080958,Granera,2018,69,53,16,3,49,17
339,251023,"Granja d'Escarp, la",2018,936,514,422,102,606,228
340,080961,Granollers,2018,61275,30199,31076,9287,40989,10999
341,251039,Granyanella,2018,148,82,66,11,93,44
342,251057,Granyena de les Garrigues,2018,132,78,54,14,77,41
343,251044,Granyena de Segarra,2018,142,76,66,16,77,49
344,430691,Gratallops,2018,229,125,104,16,148,65
345,080977,Gualba,2018,1500,769,731,309,972,219
346,170813,Gualta,2018,397,229,168,64,262,71
347,080996,Guardiola de Berguedà,2018,908,464,444,103,571,234
348,430705,"Guiamets, els",2018,270,128,142,20,162,88
349,170828,Guils de Cerdanya,2018,537,288,249,64,372,101
350,251095,Guimerà,2018,265,140,125,28,138,99
351,259031,"Guingueta d'Àneu, la",2018,297,159,138,30,188,79
352,251109,Guissona,2018,7136,3810,3326,1393,5062,681
353,251116,Guixers,2018,134,84,50,12,79,43
354,081000,Gurb,2018,2681,1386,1295,448,1795,438
355,430712,Horta de Sant Joan,2018,1149,602,547,131,675,343
356,081017,"Hospitalet de Llobregat, l'",2018,264923,127981,136942,37104,174555,53264
357,081629,"Hostalets de Pierola, els",2018,2973,1518,1455,528,2030,415
358,170834,Hostalric,2018,4221,2130,2091,712,2781,728
359,081022,Igualada,2018,39967,19636,20331,6605,25393,7969
360,251155,Isona i Conca Dellà,2018,1019,548,471,112,592,315
361,170849,Isòvol,2018,281,161,120,41,180,60
362,251137,Ivars d'Urgell,2018,1531,801,730,198,889,444
363,251121,Ivars de Noguera,2018,334,171,163,36,216,82
364,251142,Ivorra,2018,104,57,47,4,63,37
365,170852,Jafre,2018,380,206,174,48,229,103
366,170865,"Jonquera, la",2018,3290,1637,1653,585,2223,482
367,081038,Jorba,2018,835,424,411,139,585,111
368,259101,Josa i Tuixén,2018,106,58,48,7,65,34
369,170871,Juià,2018,323,174,149,53,210,60
370,251180,Juncosa,2018,386,204,182,33,237,116
371,251193,Juneda,2018,3475,1854,1621,519,2220,736
372,251214,Les,2018,946,463,483,150,672,124
373,251229,Linyola,2018,2700,1365,1335,397,1735,568
374,081043,"Llacuna, la",2018,870,475,395,98,548,224
375,170887,Lladó,2018,818,398,420,170,519,129
376,251235,Lladorre,2018,230,116,114,28,143,59
377,251240,Lladurs,2018,176,91,85,16,105,55
378,081056,"Llagosta, la",2018,13480,6675,6805,2200,8739,2541
379,170890,Llagostera,2018,8453,4303,4150,1459,5552,1442
380,170904,Llambilles,2018,696,359,337,113,463,120
381,170911,Llanars,2018,505,259,246,64,308,133
382,170926,Llançà,2018,4836,2394,2442,650,3078,1108
383,251253,Llardecans,2018,451,236,215,38,260,153
384,251266,Llavorsí,2018,352,180,172,43,240,69
385,251207,Lleida,2018,138956,68657,70299,21489,92712,24755
386,170932,Llers,2018,1239,617,622,171,810,258
387,251272,Lles de Cerdanya,2018,253,148,105,30,156,67
388,081075,Lliçà d'Amunt,2018,15256,7819,7437,2431,10298,2527
389,081081,Lliçà de Vall,2018,6542,3335,3207,1005,4315,1222
390,251288,Llimiana,2018,145,88,57,11,87,47
391,081069,Llinars del Vallès,2018,9938,4946,4992,1499,6668,1771
392,170947,Llívia,2018,1417,748,669,183,981,253
393,430727,"Lloar, el",2018,107,58,49,15,62,30
394,251291,Llobera,2018,188,104,84,24,108,56
395,430733,Llorac,2018,100,52,48,7,67,26
396,430748,Llorenç del Penedès,2018,2393,1172,1221,397,1523,473
397,170950,Lloret de Mar,2018,38373,19528,18845,5967,26882,5524
398,170963,"Llosses, les",2018,218,121,97,38,144,36
399,081094,Lluçà,2018,273,134,139,51,181,41
400,171024,Maçanet de Cabrenys,2018,688,340,348,70,418,200
401,171030,Maçanet de la Selva,2018,7006,3598,3408,1073,4650,1283
402,170979,Madremanya,2018,283,138,145,53,173,57
403,170985,Maià de Montcal,2018,449,251,198,62,290,97
404,251333,Maials,2018,920,517,403,91,561,268
405,251305,Maldà,2018,220,109,111,23,133,64
406,081108,Malgrat de Mar,2018,18579,9280,9299,2666,12102,3811
407,081115,Malla,2018,273,139,134,43,175,55
408,081120,Manlleu,2018,20573,10314,10259,3521,13437,3615
409,081136,Manresa,2018,77714,38066,39648,12402,49894,15418
410,430764,Marçà,2018,594,314,280,76,387,131
411,430751,Margalef,2018,97,59,38,6,57,34
412,082423,Marganell,2018,266,131,135,23,175,68
413,081141,Martorell,2018,28189,14329,13860,4922,18618,4649
414,081154,Martorelles,2018,4801,2422,2379,682,3162,957
415,430770,Mas de Barberans,2018,578,288,290,50,343,185
416,171002,Masarac,2018,288,150,138,32,197,59
417,430786,Masdenverge,2018,1070,546,524,135,672,263
418,081167,"Masies de Roda, les",2018,700,355,345,101,444,155
419,081173,"Masies de Voltregà, les",2018,3141,1551,1590,448,2113,580
420,430799,Masllorenç,2018,504,283,221,76,330,98
421,081189,"Masnou, el",2018,23515,11357,12158,3446,15510,4559
422,430803,"Masó, la",2018,276,146,130,38,159,79
423,430810,Maspujols,2018,827,426,401,153,553,121
424,081192,Masquefa,2018,9211,4641,4570,1650,6273,1288
425,430825,"Masroig, el",2018,497,270,227,57,294,146
426,251312,Massalcoreig,2018,598,338,260,48,414,136
427,171019,Massanes,2018,761,405,356,144,462,155
428,251327,Massoteres,2018,218,119,99,40,139,39
429,081206,Matadepera,2018,9326,4657,4669,1709,6043,1574
430,081213,Mataró,2018,128265,63637,64628,20988,84897,22380
431,081228,Mediona,2018,2322,1159,1163,401,1429,492
432,251348,Menàrguens,2018,806,440,366,71,525,210
433,170998,Meranges,2018,104,58,46,18,64,22
434,171058,Mieres,2018,318,160,158,40,195,83
435,430831,"Milà, el",2018,178,85,93,28,106,44
436,251351,Miralcamp,2018,1351,677,674,221,840,290
437,430846,Miravet,2018,691,369,322,83,414,194
438,081385,Moià,2018,6267,3190,3077,994,4181,1092
439,430859,"Molar, el",2018,297,158,139,22,182,93
440,081234,Molins de Rei,2018,25868,12612,13256,4502,16976,4390
441,251370,Mollerussa,2018,14683,7543,7140,2690,9900,2093
442,171061,Mollet de Peralada,2018,189,96,93,29,102,58
443,081249,Mollet del Vallès,2018,51318,25222,26096,8088,34501,8729
444,171077,Molló,2018,337,162,175,44,200,93
445,251364,"Molsosa, la",2018,107,53,54,6,68,33
446,081287,Monistrol de Calders,2018,682,357,325,69,464,149
447,081271,Monistrol de Montserrat,2018,3034,1551,1483,459,1983,592
448,171096,Montagut i Oix,2018,916,475,441,124,623,169
449,430862,Montblanc,2018,7364,3737,3627,1154,4825,1385
450,430884,Montbrió del Camp,2018,2890,1485,1405,569,1894,427
451,081252,Montcada i Reixac,2018,36239,17901,18338,6114,24649,5476
452,081304,Montclar,2018,136,71,65,23,81,32
453,251399,Montellà i Martinet,2018,579,324,255,57,380,142
454,081311,Montesquiu,2018,998,501,497,163,622,213
455,251403,Montferrer i Castellbò,2018,1041,566,475,179,650,212
456,430897,Montferri,2018,387,202,185,72,244,71
457,251386,Montgai,2018,625,329,296,49,370,206
458,081265,Montgat,2018,12041,5938,6103,2083,8104,1854
459,081326,Montmajor,2018,464,231,233,74,262,128
460,081332,Montmaneu,2018,150,83,67,11,93,46
461,430901,"Montmell, el",2018,1512,808,704,227,1006,279
462,081350,Montmeló,2018,8755,4275,4480,1273,5797,1685
463,251425,Montoliu de Lleida,2018,489,251,238,52,312,125
464,251410,Montoliu de Segarra,2018,179,100,79,19,106,54
465,251431,Montornès de Segarra,2018,100,47,53,10,51,39
466,081363,Montornès del Vallès,2018,16393,8251,8142,2992,10892,2509
467,430918,Mont-ral,2018,162,94,68,20,112,30
468,171100,Mont-ras,2018,1679,846,833,200,1123,356
469,430923,Mont-roig del Camp,2018,12136,6260,5876,1910,8019,2207
470,081379,Montseny,2018,342,179,163,50,213,79
471,430939,Móra d'Ebre,2018,5690,2845,2845,888,3719,1083
472,430944,Móra la Nova,2018,3087,1541,1546,416,2047,624
473,430957,"Morell, el",2018,3704,1881,1823,674,2561,469
474,430960,"Morera de Montsant, la",2018,152,85,67,18,101,33
475,081290,Muntanyola,2018,634,321,313,116,432,86
476,081398,Mura,2018,224,122,102,40,134,50
477,251459,Nalec,2018,87,45,42,5,47,35
478,250254,Naut Aran,2018,1803,935,868,252,1295,256
479,081402,Navarcles,2018,5977,2914,3063,827,3861,1289
480,081419,Navàs,2018,6020,2998,3022,910,3864,1246
481,171117,Navata,2018,1381,671,710,238,894,249
482,251462,Navès,2018,280,147,133,39,184,57
483,081424,"Nou de Berguedà, la",2018,161,83,78,17,94,50
484,430976,"Nou de Gaià, la",2018,603,300,303,135,364,104
485,430982,Nulles,2018,492,267,225,94,296,102
486,251484,Odèn,2018,249,149,100,14,157,78
487,081430,Òdena,2018,3643,1848,1795,668,2368,607
488,171122,Ogassa,2018,234,130,104,32,152,50
489,081458,Olèrdola,2018,3692,1900,1792,617,2471,604
490,081461,Olesa de Bonesvalls,2018,1810,949,861,306,1222,282
491,081477,Olesa de Montserrat,2018,23904,11913,11991,4304,15770,3830
492,251497,Oliana,2018,1810,906,904,199,1100,511
493,251500,Oliola,2018,197,106,91,14,130,53
494,251517,Olius,2018,986,527,459,199,616,171
495,081483,Olivella,2018,3799,1985,1814,746,2566,487
496,081496,Olost,2018,1198,588,610,140,760,298
497,171143,Olot,2018,35228,17569,17659,5255,23126,6847
498,251522,"Oluges, les",2018,167,88,79,15,93,59
499,081445,Olvan,2018,854,416,438,97,551,206
500,251538,"Omellons, els",2018,211,111,100,14,119,78
501,251543,"Omells de na Gaia, els",2018,131,72,59,8,84,39
502,171156,Ordis,2018,371,199,172,58,231,82
503,251556,Organyà,2018,784,388,396,95,458,231
504,081509,Orís,2018,315,159,156,45,220,50
505,081516,Oristà,2018,541,274,267,67,317,157
506,081521,Orpí,2018,147,80,67,25,98,24
507,081537,Òrrius,2018,739,381,358,133,496,110
508,251569,Os de Balaguer,2018,994,507,487,150,623,221
509,171169,Osor,2018,428,227,201,48,286,94
510,251575,Ossó de Sió,2018,204,98,106,30,121,53
511,081542,Pacs del Penedès,2018,922,469,453,150,610,162
512,081555,Palafolls,2018,9405,4690,4715,1701,6420,1284
513,171175,Palafrugell,2018,22974,11377,11597,3865,14962,4147
514,171181,Palamós,2018,17910,8766,9144,2452,11864,3594
515,251581,"Palau d'Anglesola, el",2018,2166,1061,1105,357,1395,414
516,171194,Palau de Santa Eulàlia,2018,91,52,39,12,55,24
517,171215,Palau-sator,2018,310,166,144,46,192,72
518,171208,Palau-saverdera,2018,1476,741,735,263,891,322
519,081568,Palau-solità i Plegamans,2018,14771,7246,7525,2385,9975,2411
520,431009,"Pallaresos, els",2018,4777,2404,2373,982,3262,533
521,081574,Pallejà,2018,11508,5728,5780,2028,7692,1788
522,430995,"Palma d'Ebre, la",2018,340,166,174,24,185,131
523,089058,"Palma de Cervelló, la",2018,2954,1460,1494,439,2040,475
524,171236,Palol de Revardit,2018,455,228,227,76,280,99
525,171241,Pals,2018,2411,1222,1189,327,1516,568
526,081580,"Papiol, el",2018,4145,2052,2093,711,2766,668
527,171254,Pardines,2018,162,89,73,22,98,42
528,081593,Parets del Vallès,2018,19082,9541,9541,3274,12875,2933
529,171267,Parlavà,2018,394,199,195,55,241,98
530,431016,Passanant i Belltall,2018,163,95,68,7,99,57
531,171289,Pau,2018,560,285,275,71,341,148
532,431021,Paüls,2018,556,277,279,65,300,191
533,171292,Pedret i Marzà,2018,198,101,97,37,126,35
534,251641,Penelles,2018,452,262,190,54,274,124
535,171306,"Pera, la",2018,446,221,225,69,278,99
536,081607,Perafita,2018,395,202,193,47,240,108
537,431037,Perafort,2018,1261,654,607,257,850,154
538,171328,Peralada,2018,1850,906,944,261,1219,370
539,251654,Peramola,2018,347,177,170,30,216,101
540,431042,"Perelló, el",2018,2770,1421,1349,394,1629,747
541,081614,Piera,2018,15603,7976,7627,2556,10395,2652
542,431055,"Piles, les",2018,212,120,92,42,127,43
543,081635,Pineda de Mar,2018,27272,13588,13684,3923,17674,5675
544,431068,"Pinell de Brai, el",2018,1017,516,501,106,601,310
545,251667,Pinell de Solsonès,2018,200,118,82,18,124,58
546,251673,Pinós,2018,287,151,136,42,178,67
547,431074,Pira,2018,493,261,232,73,319,101
548,431080,"Pla de Santa Maria, el",2018,2327,1215,1112,336,1540,451
549,081640,"Pla del Penedès, el",2018,1256,636,620,225,816,215
550,171334,"Planes d'Hostoles, les",2018,1683,851,832,228,990,465
551,171349,Planoles,2018,288,157,131,33,182,73
552,259118,"Plans de Sió, els",2018,506,272,234,51,312,143
553,251689,"Poal, el",2018,648,340,308,79,409,160
554,251692,"Pobla de Cérvoles, la",2018,191,107,84,12,119,60
555,081653,"Pobla de Claramunt, la",2018,2193,1104,1089,394,1372,427
556,081666,"Pobla de Lillet, la",2018,1095,528,567,82,627,386
557,431093,"Pobla de Mafumet, la",2018,3904,1982,1922,818,2774,312
558,431107,"Pobla de Massaluca, la",2018,318,181,137,29,177,112
559,431114,"Pobla de Montornès, la",2018,2839,1486,1353,461,1805,573
560,251713,"Pobla de Segur, la",2018,2984,1469,1515,403,1795,786
561,431129,Poboleda,2018,313,166,147,36,188,89
562,081672,Polinyà,2018,8479,4295,4184,1769,5814,896
563,431135,"Pont d'Armentera, el",2018,505,258,247,51,303,151
564,250306,"Pont de Bar, el",2018,157,87,70,17,96,44
565,171352,Pont de Molins,2018,529,267,262,73,347,109
566,251734,"Pont de Suert, el",2018,2220,1107,1113,314,1446,460
567,081825,"Pont de Vilomara i Rocafort, el",2018,3830,1969,1861,642,2506,682
568,431418,Pontils,2018,117,66,51,7,71,39
569,081688,Pontons,2018,532,289,243,65,360,107
570,171365,Pontós,2018,266,141,125,43,168,55
571,251728,Ponts,2018,2601,1305,1296,363,1657,581
572,171371,Porqueres,2018,4621,2288,2333,780,3012,829
573,431140,Porrera,2018,439,229,210,40,294,105
574,171404,"Port de la Selva, el",2018,970,501,469,112,589,269
575,171387,Portbou,2018,1075,528,547,84,614,377
576,251749,"Portella, la",2018,728,412,316,81,509,138
577,431153,Pradell de la Teixeta,2018,152,70,82,15,96,41
578,431166,Prades,2018,589,309,280,71,366,152
579,431172,Prat de Comte,2018,183,98,85,19,109,55
580,081691,"Prat de Llobregat, el",2018,64599,31621,32978,10037,42261,12301
581,431188,Pratdip,2018,738,395,343,77,415,246
582,081712,Prats de Lluçanès,2018,2569,1280,1289,317,1675,577
583,081705,"Prats de Rei, els",2018,532,283,249,72,337,123
584,251752,Prats i Sansor,2018,219,114,105,23,149,47
585,251765,Preixana,2018,385,199,186,51,209,125
586,251771,Preixens,2018,432,218,214,53,232,147
587,082303,Premià de Dalt,2018,10448,5207,5241,1724,6840,1884
588,081727,Premià de Mar,2018,28119,13704,14415,4220,18320,5579
589,171390,"Preses, les",2018,1788,890,898,305,1150,333
590,251790,Prullans,2018,231,109,122,35,143,53
591,171411,Puigcerdà,2018,9258,4585,4673,1403,6418,1437
592,081748,Puigdàlber,2018,526,256,270,101,336,89
593,251804,Puiggròs,2018,276,138,138,32,173,71
594,431191,Puigpelat,2018,1149,590,559,213,814,122
595,081751,Puig-reig,2018,4178,2086,2092,495,2588,1095
596,251811,Puigverd d'Agramunt,2018,255,146,109,29,165,61
597,251826,Puigverd de Lleida,2018,1355,701,654,199,881,275
598,081764,Pujalt,2018,210,119,91,36,125,49
599,081770,"Quar, la",2018,53,29,24,9,25,19
600,171426,Quart,2018,3724,1855,1869,824,2391,509
601,170433,Queralbs,2018,191,104,87,14,127,50
602,431205,Querol,2018,507,285,222,51,330,126
603,171432,Rabós,2018,178,89,89,18,105,55
604,081786,Rajadell,2018,548,275,273,74,357,117
605,431212,Rasquera,2018,781,384,397,86,446,249
606,171447,Regencós,2018,269,141,128,31,171,67
607,081799,Rellinars,2018,780,403,377,125,529,126
608,431227,Renau,2018,157,82,75,35,109,13
609,431233,Reus,2018,104373,50415,53958,17739,68009,18625
610,251832,Rialp,2018,661,330,331,74,473,114
611,431248,"Riba, la",2018,585,321,264,64,355,166
612,431251,Riba-roja d'Ebre,2018,1126,593,533,114,678,334
613,259059,Ribera d'Ondara,2018,426,213,213,44,258,124
614,251850,Ribera d'Urgellet,2018,935,488,447,147,605,183
615,171450,Ribes de Freser,2018,1754,882,872,171,1074,509
616,171463,Riells i Viabrea,2018,4124,2113,2011,621,2898,605
617,431264,"Riera de Gaià, la",2018,1744,867,877,363,1119,262
618,251863,Riner,2018,263,132,131,41,153,69
619,171479,Ripoll,2018,10686,5273,5413,1474,6722,2490
620,081803,Ripollet,2018,38665,19080,19585,6903,25919,5843
621,259139,Riu de Cerdanya,2018,93,55,38,5,68,20
622,171485,Riudarenes,2018,2182,1125,1057,359,1421,402
623,171498,Riudaura,2018,478,232,246,87,304,87
624,431270,Riudecanyes,2018,1124,590,534,179,734,211
625,431286,Riudecols,2018,1180,611,569,152,797,231
626,171501,Riudellots de la Selva,2018,2076,1053,1023,341,1400,335
627,431299,Riudoms,2018,6594,3380,3214,1128,4197,1269
628,171518,Riumors,2018,258,126,132,36,162,60
629,081810,"Roca del Vallès, la",2018,10650,5319,5331,1866,7162,1622
630,431303,Rocafort de Queralt,2018,225,122,103,27,122,76
631,431310,Roda de Berà,2018,6567,3341,3226,999,4158,1410
632,081831,Roda de Ter,2018,6301,3118,3183,1033,4147,1121
633,431325,Rodonyà,2018,490,262,228,61,332,97
634,431331,Roquetes,2018,7973,4126,3847,1259,5294,1420
635,171523,Roses,2018,19550,9862,9688,3150,12854,3546
636,251898,Rosselló,2018,3145,1602,1543,531,2131,483
637,431346,"Rourell, el",2018,366,191,175,52,250,64
638,081846,Rubí,2018,77464,38358,39106,13107,52348,12009
639,081859,Rubió,2018,239,133,106,30,151,58
640,171539,Rupià,2018,272,138,134,45,157,70
641,089019,Rupit i Pruit,2018,279,139,140,29,162,88
642,081878,Sabadell,2018,213644,103847,109797,34227,139504,39913
643,081884,Sagàs,2018,148,80,68,28,94,26
644,251902,Salàs de Pallars,2018,320,174,146,35,191,94
645,081901,Saldes,2018,274,159,115,11,175,88
646,171544,Sales de Llierca,2018,154,77,77,26,109,19
647,081918,Sallent,2018,6658,3211,3447,907,4053,1698
648,431359,Salomó,2018,557,295,262,95,347,115
649,439057,Salou,2018,27476,14141,13335,4300,19630,3546
650,171557,Salt,2018,31362,16454,14908,6477,21002,3883
651,251919,Sanaüja,2018,380,202,178,35,221,124
652,081944,Sant Adrià de Besòs,2018,37097,18251,18846,6079,24613,6405
653,081957,Sant Agustí de Lluçanès,2018,85,42,43,9,54,22
654,081960,Sant Andreu de la Barca,2018,27558,13679,13879,5101,18362,4095
655,081976,Sant Andreu de Llavaneres,2018,10968,5424,5544,1729,7352,1887
656,171576,Sant Andreu Salou,2018,155,79,76,24,96,35
657,171833,Sant Aniol de Finestres,2018,341,177,164,51,215,75
658,081982,Sant Antoni de Vilamajor,2018,6135,3031,3104,1032,4156,947
659,081995,Sant Bartomeu del Grau,2018,858,460,398,129,552,177
660,082009,Sant Boi de Llobregat,2018,83605,40877,42728,12893,54739,15973
661,082016,Sant Boi de Lluçanès,2018,541,269,272,53,302,186
662,431362,Sant Carles de la Ràpita,2018,14789,7238,7551,1987,9515,3287
663,082037,Sant Cebrià de Vallalta,2018,3385,1764,1621,614,2262,509
664,082021,Sant Celoni,2018,17904,8939,8965,3031,11762,3111
665,082042,Sant Climent de Llobregat,2018,4129,2075,2054,807,2774,548
666,171582,Sant Climent Sescebes,2018,626,364,262,84,422,120
667,082055,Sant Cugat del Vallès,2018,91006,44197,46809,17503,60781,12722
668,082068,Sant Cugat Sesgarrigues,2018,1007,488,519,181,638,188
669,251961,Sant Esteve de la Sarga,2018,124,72,52,7,73,44
670,082074,Sant Esteve de Palautordera,2018,2820,1391,1429,528,1912,380
671,082080,Sant Esteve Sesrovires,2018,7612,3835,3777,1239,5162,1211
672,171595,Sant Feliu de Buixalleu,2018,783,410,373,105,512,166
673,082107,Sant Feliu de Codines,2018,6259,3168,3091,991,4264,1004
674,171609,Sant Feliu de Guíxols,2018,21925,10802,11123,3389,14129,4407
675,082114,Sant Feliu de Llobregat,2018,44860,21767,23093,7062,29281,8517
676,171616,Sant Feliu de Pallerols,2018,1371,667,704,213,856,302
677,082129,Sant Feliu Sasserra,2018,602,312,290,83,363,156
678,171621,Sant Ferriol,2018,243,124,119,50,147,46
679,082093,Sant Fost de Campsentelles,2018,8737,4352,4385,1271,5669,1797
680,082135,Sant Fruitós de Bages,2018,8703,4295,4408,1496,5820,1387
681,171637,Sant Gregori,2018,3817,1959,1858,738,2469,610
682,251924,Sant Guim de Freixenet,2018,1025,538,487,153,625,247
683,251977,Sant Guim de la Plana,2018,185,106,79,18,112,55
684,171642,Sant Hilari Sacalm,2018,5627,2843,2784,848,3580,1199
685,082153,Sant Hipòlit de Voltregà,2018,3484,1729,1755,534,2285,665
686,081939,Sant Iscle de Vallalta,2018,1332,687,645,246,888,198
687,439023,Sant Jaume d'Enveja,2018,3503,1765,1738,471,2191,841
688,082166,Sant Jaume de Frontanyà,2018,30,18,12,3,16,11
689,171655,Sant Jaume de Llierca,2018,865,416,449,129,531,205
690,431378,Sant Jaume dels Domenys,2018,2622,1342,1280,503,1685,434
691,171674,Sant Joan de les Abadesses,2018,3232,1604,1628,393,1911,928
692,171680,Sant Joan de Mollet,2018,507,248,259,83,322,102
693,082188,Sant Joan de Vilatorrada,2018,10936,5490,5446,1780,7051,2105
694,082172,Sant Joan Despí,2018,34123,16585,17538,5616,22626,5881
695,171851,Sant Joan les Fonts,2018,3006,1541,1465,424,1871,711
696,171668,Sant Jordi Desvalls,2018,761,380,381,126,474,161
697,089030,Sant Julià de Cerdanyola,2018,228,125,103,25,149,54
698,171693,Sant Julià de Ramis,2018,3515,1780,1735,668,2381,466
699,082205,Sant Julià de Vilatorta,2018,3114,1539,1575,511,2067,536
700,179032,Sant Julià del Llor i Bonmatí,2018,1286,651,635,230,861,195
701,082212,Sant Just Desvern,2018,17805,8544,9261,3081,11306,3418
702,082227,Sant Llorenç d'Hortons,2018,2413,1226,1187,395,1632,386
703,171714,Sant Llorenç de la Muga,2018,264,135,129,34,171,59
704,251930,Sant Llorenç de Morunys,2018,949,457,492,115,562,272
705,082233,Sant Llorenç Savall,2018,2373,1197,1176,335,1507,531
706,082251,Sant Martí d'Albars,2018,112,56,56,17,63,32
707,082248,Sant Martí de Centelles,2018,1167,600,567,165,821,181
708,171729,Sant Martí de Llémena,2018,633,330,303,103,445,85
709,259025,Sant Martí de Riucorb,2018,646,334,312,72,354,220
710,082264,Sant Martí de Tous,2018,1235,637,598,243,762,230
711,082270,Sant Martí Sarroca,2018,3264,1608,1656,541,2120,603
712,082286,Sant Martí Sesgueioles,2018,343,176,167,38,236,69
713,171735,Sant Martí Vell,2018,252,131,121,31,169,52
714,082299,Sant Mateu de Bages,2018,603,302,301,59,349,195
715,171740,Sant Miquel de Campmajor,2018,231,127,104,44,144,43
716,171753,Sant Miquel de Fluvià,2018,764,397,367,112,504,148
717,171766,Sant Mori,2018,177,90,87,23,116,38
718,171772,Sant Pau de Segúries,2018,697,347,350,90,421,186
719,082310,Sant Pere de Ribes,2018,30719,15268,15451,5138,20967,4614
720,082325,Sant Pere de Riudebitlles,2018,2368,1181,1187,418,1434,516
721,082331,Sant Pere de Torelló,2018,2419,1242,1177,360,1541,518
722,082346,Sant Pere de Vilamajor,2018,4472,2239,2233,760,3044,668
723,171788,Sant Pere Pescador,2018,2042,1084,958,342,1362,338
724,081897,Sant Pere Sallavinera,2018,152,82,70,25,83,44
725,082359,Sant Pol de Mar,2018,5299,2604,2695,820,3354,1125
726,082362,Sant Quintí de Mediona,2018,2254,1154,1100,374,1466,414
727,082378,Sant Quirze de Besora,2018,2167,1054,1113,292,1318,557
728,082384,Sant Quirze del Vallès,2018,20141,9865,10276,3761,13557,2823
729,082397,Sant Quirze Safaja,2018,627,336,291,114,435,78
730,251945,Sant Ramon,2018,491,254,237,54,278,159
731,082401,Sant Sadurní d'Anoia,2018,12887,6348,6539,2225,8496,2166
732,082418,Sant Sadurní d'Osormort,2018,78,47,31,5,56,17
733,080983,Sant Salvador de Guardiola,2018,3179,1630,1549,518,2087,574
734,082628,Sant Vicenç de Castellet,2018,9523,4760,4763,1529,6183,1811
735,082649,Sant Vicenç de Montalt,2018,6407,3199,3208,1065,4219,1123
736,082652,Sant Vicenç de Torelló,2018,2058,1019,1039,327,1364,367
737,082634,Sant Vicenç dels Horts,2018,28117,13959,14158,4456,19033,4628
738,431384,Santa Bàrbara,2018,3707,1881,1826,553,2350,804
739,082439,Santa Cecília de Voltregà,2018,187,99,88,23,128,36
740,082444,Santa Coloma de Cervelló,2018,8218,4026,4192,1618,5501,1099
741,171805,Santa Coloma de Farners,2018,13143,6621,6522,2262,8693,2188
742,082457,Santa Coloma de Gramenet,2018,119215,58895,60320,18332,77486,23397
743,431397,Santa Coloma de Queralt,2018,2673,1328,1345,384,1651,638
744,171812,Santa Cristina d'Aro,2018,5223,2624,2599,846,3449,928
745,082460,Santa Eugènia de Berga,2018,2248,1142,1106,327,1518,403
746,082476,Santa Eulàlia de Riuprimer,2018,1345,686,659,275,859,211
747,082482,Santa Eulàlia de Ronçana,2018,7288,3639,3649,1221,4808,1259
748,082495,Santa Fe del Penedès,2018,374,185,189,61,253,60
749,171827,Santa Llogaia d'Àlguema,2018,370,189,181,78,234,58
750,082508,Santa Margarida de Montbui,2018,9980,4993,4987,1762,6479,1739
751,082515,Santa Margarida i els Monjos,2018,7611,3856,3755,1504,5018,1089
752,082589,Santa Maria d'Oló,2018,1025,521,504,150,623,252
753,082536,Santa Maria de Besora,2018,150,78,72,19,91,40
754,082567,Santa Maria de Martorelles,2018,893,449,444,156,598,139
755,082554,Santa Maria de Merlès,2018,184,89,95,40,116,28
756,082573,Santa Maria de Miralles,2018,126,68,58,15,79,32
757,082592,Santa Maria de Palautordera,2018,9423,4760,4663,1505,6355,1563
758,431401,Santa Oliva,2018,3320,1685,1635,577,2130,613
759,171848,Santa Pau,2018,1565,792,773,220,991,354
760,082606,Santa Perpètua de Mogoda,2018,25799,12958,12841,4563,17346,3890
761,082613,Santa Susanna,2018,3446,1721,1725,597,2274,575
762,081923,Santpedor,2018,7554,3755,3799,1402,4814,1338
763,431423,Sarral,2018,1548,789,759,248,988,312
764,171864,Sarrià de Ter,2018,5170,2530,2640,885,3416,869
765,252017,Sarroca de Bellera,2018,121,68,53,6,72,43
766,252000,Sarroca de Lleida,2018,363,200,163,32,202,129
767,171870,"Saus, Camallera i Llampaies",2018,837,424,413,126,519,192
768,431439,Savallà del Comtat,2018,58,31,27,1,39,18
769,431444,"Secuita, la",2018,1687,851,836,293,1122,272
770,171886,"Selva de Mar, la",2018,196,108,88,13,124,59
771,431457,"Selva del Camp, la",2018,5652,2836,2816,950,3793,909
772,431460,Senan,2018,48,33,15,6,27,15
773,430445,"Sénia, la",2018,5681,2844,2837,806,3707,1168
774,252022,Senterada,2018,137,80,57,10,105,22
775,250352,"Sentiu de Sió, la",2018,406,216,190,36,253,117
776,082671,Sentmenat,2018,9078,4611,4467,1608,6169,1301
777,171903,Serinyà,2018,1136,576,560,201,735,200
778,252043,Seròs,2018,1922,1029,893,280,1229,413
779,171910,Serra de Daró,2018,221,122,99,33,138,50
780,171925,Setcases,2018,177,98,79,15,117,45
781,252038,"Seu d'Urgell, la",2018,12089,5842,6247,1745,8036,2308
782,082690,Seva,2018,3519,1784,1735,559,2331,629
783,252056,Sidamon,2018,734,383,351,117,489,128
784,171931,Sils,2018,6093,3108,2985,1035,4056,1002
785,082704,Sitges,2018,29307,14708,14599,4162,19738,5407
786,170524,Siurana,2018,168,84,84,21,108,39
787,082711,Sobremunt,2018,79,36,43,7,56,16
788,252069,"Soleràs, el",2018,332,173,159,35,190,107
789,431476,Solivella,2018,633,333,300,74,385,174
790,252075,Solsona,2018,9094,4488,4606,1466,5911,1717
791,082726,Sora,2018,209,117,92,35,131,43
792,252081,Soriguera,2018,410,220,190,59,287,64
793,252094,Sort,2018,2149,1077,1072,325,1422,402
794,252108,Soses,2018,1763,923,840,309,1110,344
795,082732,Subirats,2018,3044,1577,1467,475,1972,597
796,252115,Sudanell,2018,853,465,388,87,561,205
797,252120,Sunyer,2018,352,205,147,30,251,71
798,082747,Súria,2018,5942,2897,3045,770,3788,1384
799,171946,Susqueda,2018,101,60,41,8,74,19
800,082763,Tagamanent,2018,323,169,154,50,225,48
801,082779,Talamanca,2018,206,115,91,31,132,43
802,252154,Talarn,2018,585,387,198,51,447,87
803,252167,Talavera,2018,283,158,125,27,166,90
804,171959,"Tallada d'Empordà, la",2018,463,241,222,67,293,103
805,082785,Taradell,2018,6489,3238,3251,1048,4192,1249
806,431482,Tarragona,2018,134515,65505,69010,21113,89022,24380
807,252173,Tàrrega,2018,17098,8489,8609,3011,11343,2744
808,252189,Tarrés,2018,106,56,50,16,61,29
809,252192,Tarroja de Segarra,2018,187,104,83,27,112,48
810,082750,Tavèrnoles,2018,316,159,157,52,203,61
811,082802,Tavertet,2018,111,57,54,8,68,35
812,082819,Teià,2018,6397,3134,3263,960,4110,1327
813,252206,Térmens,2018,1333,678,655,172,826,335
814,171962,Terrades,2018,329,162,167,48,216,65
815,082798,Terrassa,2018,220556,108469,112087,37692,145942,36922
816,082824,Tiana,2018,8840,4233,4607,1510,5892,1438
817,252213,Tírvia,2018,131,63,68,9,87,35
818,252228,Tiurana,2018,73,33,40,6,47,20
819,431495,Tivenys,2018,899,458,441,83,547,269
820,431508,Tivissa,2018,1602,799,803,188,989,425
821,082830,Tona,2018,8241,4099,4142,1352,5451,1438
822,252234,Torà,2018,1255,639,616,157,818,280
823,082845,Tordera,2018,17216,8722,8494,2968,11323,2925
824,082858,Torelló,2018,14347,7137,7210,2297,9278,2772
825,252249,"Torms, els",2018,144,77,67,10,83,51
826,252252,Tornabous,2018,858,461,397,115,521,222
827,252271,"Torre de Cabdella, la",2018,760,383,377,60,469,231
828,082861,"Torre de Claramunt, la",2018,3714,1923,1791,589,2529,596
829,431515,"Torre de Fontaubella, la",2018,138,68,70,20,73,45
830,431520,"Torre de l'Espanyol, la",2018,611,311,300,77,374,160
831,252265,Torrebesses,2018,282,150,132,33,164,85
832,431536,Torredembarra,2018,16184,7925,8259,2486,10631,3067
833,252287,Torrefarrera,2018,4605,2328,2277,928,3113,564
834,259078,Torrefeta i Florejacs,2018,602,322,280,65,383,154
835,252304,Torregrossa,2018,2202,1140,1062,296,1378,528
836,252311,Torrelameu,2018,743,433,310,92,493,158
837,082877,Torrelavit,2018,1419,723,696,245,909,265
838,082883,Torrelles de Foix,2018,2348,1267,1081,342,1582,424
839,082896,Torrelles de Llobregat,2018,6041,3003,3038,1115,4141,785
840,171978,Torrent,2018,175,92,83,21,114,40
841,252326,Torres de Segre,2018,2277,1179,1098,272,1578,427
842,252332,Torre-serona,2018,397,208,189,43,267,87
843,171984,Torroella de Fluvià,2018,694,354,340,104,478,112
844,171997,Torroella de Montgrí,2018,11645,5900,5745,1841,7688,2116
845,431541,Torroja del Priorat,2018,149,81,68,12,88,49
846,172001,Tortellà,2018,809,393,416,124,510,175
847,431554,Tortosa,2018,33372,16496,16876,5118,21389,6865
848,172018,Toses,2018,171,102,69,20,115,36
849,172023,Tossa de Mar,2018,5683,2861,2822,733,3840,1110
850,252347,Tremp,2018,5844,2884,2960,803,3714,1327
851,172044,Ullà,2018,1153,632,521,218,771,164
852,082900,Ullastrell,2018,2093,1052,1041,429,1378,286
853,172057,Ullastret,2018,290,140,150,47,181,62
854,431567,Ulldecona,2018,6300,3286,3014,931,4091,1278
855,431573,Ulldemolins,2018,396,229,167,29,231,136
856,172039,Ultramort,2018,223,118,105,41,123,59
857,172060,Urús,2018,189,93,96,15,136,38
858,082917,Vacarisses,2018,6688,3436,3252,1289,4554,845
859,170144,"Vajol, la",2018,89,48,41,9,59,21
860,172076,"Vall d'en Bas, la",2018,3072,1553,1519,494,1949,629
861,172082,"Vall de Bianya, la",2018,1264,639,625,197,837,230
862,250432,"Vall de Boí, la",2018,1021,546,475,133,712,176
863,259010,Vall de Cardós,2018,364,195,169,47,236,81
864,082922,Vallbona d'Anoia,2018,1373,719,654,204,894,275
865,252385,Vallbona de les Monges,2018,233,120,113,19,131,83
866,082938,Vallcebre,2018,250,142,108,13,161,76
867,431589,Vallclara,2018,98,57,41,13,63,22
868,252402,Vallfogona de Balaguer,2018,1876,937,939,325,1202,349
869,171707,Vallfogona de Ripollès,2018,206,109,97,20,119,67
870,431592,Vallfogona de Riucorb,2018,91,55,36,1,53,37
871,082943,Vallgorguina,2018,2891,1451,1440,595,1946,350
872,082956,Vallirana,2018,15006,7523,7483,2561,9891,2554
873,172095,Vall-llobrega,2018,899,446,453,171,624,104
874,431606,Vallmoll,2018,1756,890,866,277,1180,299
875,082969,Vallromanes,2018,2579,1328,1251,494,1773,312
876,431613,Valls,2018,24359,12210,12149,3874,16013,4472
877,259062,"Valls d'Aguilar, les",2018,260,145,115,18,164,78
878,252398,"Valls de Valira, les",2018,791,412,379,95,538,158
879,431628,Vandellòs i l'Hospitalet de l'Infant,2018,6482,3246,3236,1098,4293,1091
880,259097,"Vansa i Fórnols, la",2018,161,84,77,5,108,48
881,082975,Veciana,2018,182,99,83,35,96,51
882,431634,"Vendrell, el",2018,37606,18631,18975,6190,24420,6996
883,172109,Ventalló,2018,859,438,421,134,547,178
884,252424,Verdú,2018,919,441,478,112,557,250
885,172116,Verges,2018,1171,572,599,197,689,285
886,431649,Vespella de Gaià,2018,410,232,178,63,254,93
887,082981,Vic,2018,46214,23306,22908,8025,31046,7143
888,172121,Vidrà,2018,167,83,84,22,114,31
889,172137,Vidreres,2018,7797,4048,3749,1213,5204,1380
890,252430,Vielha e Mijaran,2018,5559,2837,2722,775,4065,719
891,431652,Vilabella,2018,736,378,358,87,463,186
892,172142,Vilabertran,2018,979,489,490,184,591,204
893,172155,Vilablareix,2018,2897,1438,1459,538,1919,440
894,082994,Vilada,2018,416,217,199,27,251,138
895,172174,Viladamat,2018,468,241,227,68,294,106
896,172168,Viladasens,2018,200,107,93,28,132,40
897,083015,Viladecans,2018,66611,32930,33681,11408,44307,10896
898,083008,Viladecavalls,2018,7512,3724,3788,1210,5226,1076
899,172180,Vilademuls,2018,815,424,391,141,518,156
900,172207,Viladrau,2018,1040,509,531,157,682,201
901,172214,Vilafant,2018,5394,2636,2758,865,3556,973
902,083054,Vilafranca del Penedès,2018,39746,19341,20405,6895,25810,7041
903,252445,Vilagrassa,2018,541,278,263,90,356,95
904,172235,Vilajuïga,2018,1104,549,555,156,760,188
905,431750,Vilalba dels Arcs,2018,625,318,307,67,354,204
906,083067,Vilalba Sasserra,2018,716,357,359,121,479,116
907,252458,Vilaller,2018,561,294,267,68,359,134
908,172240,Vilallonga de Ter,2018,398,212,186,42,257,99
909,431665,Vilallonga del Camp,2018,2389,1206,1183,498,1567,324
910,172253,Vilamacolum,2018,348,193,155,54,220,74
911,172266,Vilamalla,2018,1181,586,595,206,761,214
912,172272,Vilamaniscle,2018,200,116,84,28,129,43
913,252477,Vilamòs,2018,187,100,87,20,143,24
914,172288,Vilanant,2018,392,197,195,64,257,71
915,431671,Vilanova d'Escornalbou,2018,545,288,257,87,342,116
916,252483,Vilanova de Bellpuig,2018,1181,599,582,175,646,360
917,252496,Vilanova de l'Aguda,2018,197,97,100,13,120,64
918,252542,Vilanova de la Barca,2018,1036,535,501,128,669,239
919,252509,Vilanova de Meià,2018,389,223,166,41,217,131
920,431687,Vilanova de Prades,2018,112,60,52,15,72,25
921,083036,Vilanova de Sau,2018,299,142,157,34,180,85
922,252516,Vilanova de Segrià,2018,977,518,459,141,642,194
923,083020,Vilanova del Camí,2018,12458,6227,6231,2166,8234,2058
924,089024,Vilanova del Vallès,2018,5432,2760,2672,1110,3663,659
925,083073,Vilanova i la Geltrú,2018,67086,32456,34630,9945,44356,12785
926,431690,Vilaplana,2018,574,302,272,61,390,123
927,431704,Vila-rodona,2018,1255,660,595,200,813,242
928,172305,Vila-sacra,2018,760,372,388,151,482,127
929,252521,Vila-sana,2018,742,376,366,122,486,134
930,431711,Vila-seca,2018,22187,11113,11074,4221,14986,2980
931,082140,Vilassar de Dalt,2018,9043,4462,4581,1398,5957,1688
932,082191,Vilassar de Mar,2018,20837,10068,10769,3383,13475,3979
933,172229,Vilaür,2018,157,81,76,36,93,28
934,431726,Vilaverd,2018,452,240,212,63,306,83
935,431732,"Vilella Alta, la",2018,135,73,62,19,80,36
936,431747,"Vilella Baixa, la",2018,202,113,89,27,123,52
937,172333,Vilobí d'Onyar,2018,3291,1711,1580,581,2167,543
938,083041,Vilobí del Penedès,2018,1107,569,538,191,690,226
939,172327,Vilopriu,2018,202,107,95,33,113,56
940,252537,"Vilosell, el",2018,169,88,81,8,98,63
941,431763,Vimbodí i Poblet,2018,892,488,404,91,538,263
942,252555,Vinaixa,2018,470,249,221,46,281,143
943,431779,Vinebre,2018,428,221,207,66,262,100
944,431785,Vinyols i els Arcs,2018,2056,1070,986,346,1376,334
945,083089,Viver i Serrateix,2018,168,87,81,23,96,49
946,430521,Xerta,2018,1170,571,599,124,714,332
947,000000,Catalunya,2018,7675217,3770123,3905094,1172116,5060347,1442754
0,250019,Abella de la Conca,2019,179,96,83,19,117,43
1,080018,Abrera,2019,12489,6326,6163,2310,8297,1882
2,250024,Àger,2019,588,320,268,49,363,176
3,250030,Agramunt,2019,5371,2689,2682,838,3466,1067
4,080023,Aguilar de Segarra,2019,288,155,133,54,180,54
5,170010,Agullana,2019,831,411,420,127,523,181
6,080142,Aiguafreda,2019,2504,1208,1296,343,1602,559
7,430017,Aiguamúrcia,2019,901,465,436,130,574,197
8,170025,Aiguaviva,2019,756,383,373,148,490,118
9,250387,Aitona,2019,2591,1358,1233,390,1613,588
10,250045,"Alamús, els",2019,819,412,407,116,532,171
11,250058,Alàs i Cerc,2019,329,171,158,39,189,101
12,250061,"Albagés, l'",2019,369,194,175,32,228,109
13,170031,Albanyà,2019,157,80,77,34,99,24
14,250077,Albatàrrec,2019,2221,1150,1071,372,1583,266
15,250083,Albesa,2019,1556,855,701,211,989,356
16,250096,"Albi, l'",2019,764,389,375,108,428,228
17,430022,Albinyana,2019,2438,1243,1195,353,1599,486
18,430038,"Albiol, l'",2019,485,253,232,90,325,70
19,170046,Albons,2019,776,401,375,112,522,142
20,430043,Alcanar,2019,9418,4748,4670,1316,6109,1993
21,250100,Alcanó,2019,235,119,116,31,138,66
22,250117,Alcarràs,2019,9514,4957,4557,1763,6596,1155
23,250122,Alcoletge,2019,3420,1775,1645,603,2375,442
24,430056,Alcover,2019,5064,2499,2565,854,3305,905
25,439044,"Aldea, l'",2019,4160,2197,1963,612,2644,904
26,430069,Aldover,2019,882,445,437,99,522,261
27,430075,"Aleixar, l'",2019,873,450,423,129,587,157
28,080039,Alella,2019,9801,4762,5039,1559,6229,2013
29,430081,Alfara de Carles,2019,377,199,178,33,231,113
30,250138,Alfarràs,2019,2797,1459,1338,359,1770,668
31,250143,Alfés,2019,312,162,150,40,189,83
32,430094,Alforja,2019,1801,921,880,248,1202,351
33,250156,Algerri,2019,386,206,180,30,212,144
34,250169,Alguaire,2019,2971,1562,1409,419,1926,626
35,250175,Alins,2019,276,144,132,30,161,85
36,430108,Alió,2019,439,208,231,69,272,98
37,250194,Almacelles,2019,6791,3584,3207,964,4494,1333
38,250208,Almatret,2019,307,172,135,7,185,115
39,250215,Almenar,2019,3398,1791,1607,443,2172,783
40,430115,Almoster,2019,1351,680,671,180,976,195
41,250220,Alòs de Balaguer,2019,130,74,56,11,70,49
42,170062,Alp,2019,1580,828,752,190,1160,230
43,080044,Alpens,2019,266,144,122,38,186,42
44,250236,Alpicat,2019,6255,3134,3121,1183,4207,865
45,250241,Alt Àneu,2019,405,231,174,34,279,92
46,430120,Altafulla,2019,5243,2555,2688,925,3393,925
47,170078,Amer,2019,2298,1122,1176,318,1425,555
48,430136,"Ametlla de Mar, l'",2019,6787,3384,3403,946,4170,1671
49,080057,"Ametlla del Vallès, l'",2019,8462,4277,4185,1389,5831,1242
50,439060,"Ampolla, l'",2019,3205,1631,1574,375,1964,866
51,430141,Amposta,2019,20738,10449,10289,3386,13451,3901
52,170084,Anglès,2019,5599,2780,2819,955,3595,1049
53,250273,Anglesola,2019,1363,682,681,222,816,325
54,250292,Arbeca,2019,2144,1100,1044,248,1322,574
55,430167,"Arboç, l'",2019,5517,2852,2665,1026,3597,894
56,430154,Arbolí,2019,137,79,58,11,95,31
57,170097,Arbúcies,2019,6556,3390,3166,1131,4247,1178
58,080060,Arenys de Mar,2019,15776,7683,8093,2262,10114,3400
59,080076,Arenys de Munt,2019,8931,4483,4448,1452,5920,1559
60,170101,Argelaguer,2019,397,205,192,38,271,88
61,080082,Argençola,2019,217,110,107,27,149,41
62,430173,"Argentera, l'",2019,124,70,54,4,81,39
63,080095,Argentona,2019,12452,6132,6320,2057,8193,2202
64,170118,"Armentera, l'",2019,930,461,469,159,581,190
65,430189,Arnes,2019,455,224,231,44,236,175
66,250313,Arres,2019,65,42,23,5,51,9
67,250328,Arsèguel,2019,84,48,36,15,54,15
68,080109,Artés,2019,5698,2868,2830,910,3749,1039
69,250334,Artesa de Lleida,2019,1504,789,715,197,1003,304
70,250349,Artesa de Segre,2019,3432,1766,1666,493,2185,754
71,430192,Ascó,2019,1660,856,804,196,1068,396
72,250365,Aspa,2019,224,113,111,24,127,73
73,250371,"Avellanes i Santa Linya, les",2019,449,259,190,52,247,150
74,080116,Avià,2019,2226,1121,1105,351,1423,452
75,080121,Avinyó,2019,2275,1127,1148,331,1438,506
76,170123,Avinyonet de Puigventós,2019,1610,796,814,303,1124,183
77,080137,Avinyonet del Penedès,2019,1701,903,798,234,1130,337
78,080155,Badalona,2019,220440,108509,111931,34242,144715,41483
79,089045,Badia del Vallès,2019,13380,6567,6813,2059,8561,2760
80,080168,Bagà,2019,2138,1064,1074,237,1327,574
81,250390,Baix Pallars,2019,335,182,153,41,215,79
82,250404,Balaguer,2019,17162,8746,8416,2955,11209,2998
83,080174,Balenyà,2019,3821,1928,1893,615,2569,637
84,080180,Balsareny,2019,3159,1562,1597,382,2049,728
85,430206,Banyeres del Penedès,2019,3170,1612,1558,555,2085,530
86,170157,Banyoles,2019,19826,9873,9953,3549,12915,3362
87,250411,Barbens,2019,878,467,411,104,555,219
88,430213,Barberà de la Conca,2019,473,257,216,74,280,119
89,082520,Barberà del Vallès,2019,33091,16300,16791,5614,21938,5539
90,080193,Barcelona,2019,1636762,775619,861143,204754,1081943,350065
91,250426,"Baronia de Rialb, la",2019,237,121,116,16,140,81
92,170160,Bàscara,2019,1004,520,484,158,627,219
93,250447,Bassella,2019,224,112,112,21,140,63
94,430228,Batea,2019,1890,944,946,253,1067,570
95,250450,Bausen,2019,58,30,28,2,32,24
96,080207,Begues,2019,7098,3528,3570,1318,4844,936
97,170139,Begur,2019,3925,1964,1961,477,2610,838
98,250463,Belianes,2019,525,269,256,53,307,165
99,251706,Bellaguarda,2019,287,152,135,22,173,92
100,170182,Bellcaire d'Empordà,2019,693,336,357,108,428,157
101,250479,Bellcaire d'Urgell,2019,1230,627,603,156,745,329
102,250485,Bell-lloc d'Urgell,2019,2315,1139,1176,335,1489,491
103,250498,Bellmunt d'Urgell,2019,185,89,96,20,116,49
104,430234,Bellmunt del Priorat,2019,280,145,135,29,170,81
105,080214,Bellprat,2019,64,41,23,1,37,26
106,250501,Bellpuig,2019,5133,2705,2428,792,3419,922
107,430249,Bellvei,2019,2203,1132,1071,396,1424,383
108,250518,Bellver de Cerdanya,2019,1937,1009,928,273,1232,432
109,250523,Bellvís,2019,2255,1149,1106,307,1374,574
110,250539,Benavent de Segrià,2019,1499,781,718,234,1034,231
111,430252,Benifallet,2019,739,348,391,57,445,237
112,430265,Benissanet,2019,1161,646,515,137,746,278
113,080229,Berga,2019,16494,8166,8328,2303,10477,3714
114,170195,Besalú,2019,2492,1170,1322,405,1514,573
115,170209,Bescanó,2019,4960,2505,2455,963,3225,772
116,170216,Beuda,2019,190,100,90,37,128,25
117,080235,Bigues i Riells del Fai,2019,9092,4645,4447,1568,6168,1356
118,250557,Biosca,2019,176,94,82,9,106,61
119,170221,"Bisbal d'Empordà, la",2019,10974,5446,5528,2001,7177,1796
120,430271,"Bisbal de Falset, la",2019,216,116,100,28,123,65
121,430287,"Bisbal del Penedès, la",2019,3528,1862,1666,482,2308,738
122,172348,Biure,2019,232,118,114,23,142,67
123,430290,Blancafort,2019,389,198,191,45,240,104
124,170237,Blanes,2019,39028,19356,19672,5592,26020,7416
125,170293,Boadella i les Escaules,2019,252,130,122,30,165,57
126,170242,Bolvir,2019,369,191,178,43,251,75
127,430304,Bonastre,2019,688,357,331,125,455,108
128,250576,"Bòrdes, Es",2019,259,144,115,34,179,46
129,170255,Bordils,2019,1779,887,892,295,1195,289
130,250582,"Borges Blanques, les",2019,6087,3105,2982,921,3862,1304
131,430311,"Borges del Camp, les",2019,2037,1050,987,343,1302,392
132,170268,Borrassà,2019,714,374,340,137,450,127
133,080240,Borredà,2019,445,253,192,38,292,115
134,250595,Bossòst,2019,1109,542,567,151,756,202
135,430326,Bot,2019,573,295,278,49,316,208
136,430332,Botarell,2019,1068,549,519,193,728,147
137,250560,Bovera,2019,247,133,114,17,134,96
138,430347,Bràfim,2019,692,357,335,127,409,156
139,170274,Breda,2019,3740,1836,1904,497,2433,810
140,080253,"Bruc, el",2019,2050,1107,943,379,1393,278
141,080266,"Brull, el",2019,263,145,118,51,173,39
142,170280,Brunyola i Sant Martí Sapresa,2019,383,195,188,47,238,98
143,430350,Cabacés,2019,298,155,143,45,171,82
144,250609,Cabanabona,2019,75,36,39,4,46,25
145,170314,Cabanelles,2019,279,154,125,46,175,58
146,170307,Cabanes,2019,948,500,448,142,596,210
147,080272,"Cabanyes, les",2019,964,488,476,186,644,134
148,250616,Cabó,2019,92,49,43,6,55,31
149,430363,Cabra del Camp,2019,1163,608,555,168,772,223
150,080288,Cabrera d'Anoia,2019,1410,769,641,214,992,204
151,080291,Cabrera de Mar,2019,4680,2348,2332,717,3160,803
152,080305,Cabrils,2019,7439,3682,3757,1233,5129,1077
153,170329,Cadaqués,2019,2712,1322,1390,381,1867,464
154,080312,Calaf,2019,3535,1775,1760,598,2200,737
155,430379,Calafell,2019,26538,13362,13176,3958,17312,5268
156,080348,Calders,2019,970,499,471,143,646,181
157,080327,Caldes d'Estrac,2019,2982,1426,1556,419,1959,604
158,170335,Caldes de Malavella,2019,7641,3828,3813,1300,5071,1270
159,080333,Caldes de Montbui,2019,17554,8745,8809,2771,11591,3192
160,080351,Calella,2019,19069,9339,9730,2718,12474,3877
161,080370,Calldetenes,2019,2489,1259,1230,394,1652,443
162,080386,Callús,2019,2140,1061,1079,396,1377,367
163,080364,Calonge de Segarra,2019,188,92,96,19,114,55
164,170340,Calonge i Sant Antoni,2019,11092,5571,5521,1611,7296,2185
165,250621,Camarasa,2019,817,410,407,89,479,249
166,439039,Camarles,2019,3224,1638,1586,457,2014,753
167,430385,Cambrils,2019,33898,16553,17345,5925,22459,5514
168,170353,Camós,2019,693,341,352,108,409,176
169,170366,Campdevànol,2019,3223,1566,1657,415,1948,860
170,170372,Campelles,2019,139,71,68,14,90,35
171,080399,Campins,2019,529,277,252,71,381,77
172,170388,Campllong,2019,547,272,275,120,363,64
173,170391,Camprodon,2019,2281,1117,1164,286,1373,622
174,250637,Canejan,2019,107,57,50,9,71,27
175,170405,Canet d'Adri,2019,723,371,352,120,457,146
176,080403,Canet de Mar,2019,14526,7068,7458,2186,9288,3052
177,439076,"Canonja, la",2019,5893,2892,3001,1056,3936,901
178,080410,Canovelles,2019,16629,8613,8016,3015,11052,2562
179,080425,Cànoves i Samalús,2019,3117,1581,1536,522,2061,534
180,170412,Cantallops,2019,313,153,160,44,190,79
181,080431,Canyelles,2019,4647,2414,2233,777,3180,690
182,430398,Capafonts,2019,121,62,59,11,78,32
183,430402,Capçanes,2019,398,202,196,40,242,116
184,080446,Capellades,2019,5293,2636,2657,780,3372,1141
185,170427,Capmany,2019,613,307,306,90,386,137
186,080459,Capolat,2019,94,44,50,21,56,17
187,080462,Cardedeu,2019,18357,8957,9400,3371,12094,2892
188,080478,Cardona,2019,4636,2273,2363,590,2776,1270
189,080484,Carme,2019,765,396,369,110,484,171
190,430419,Caseres,2019,259,129,130,19,148,92
191,170448,Cassà de la Selva,2019,10380,5301,5079,1783,6914,1683
192,080497,Casserres,2019,1608,813,795,224,966,418
193,080575,Castell de l'Areny,2019,68,38,30,6,52,10
194,259046,Castell de Mur,2019,183,104,79,16,105,62
195,250642,Castellar de la Ribera,2019,134,67,67,27,74,33
196,080522,Castellar de n'Hug,2019,159,85,74,12,111,36
197,080500,Castellar del Riu,2019,169,94,75,27,102,40
198,080517,Castellar del Vallès,2019,24187,11948,12239,4044,16218,3925
199,080538,Castellbell i el Vilar,2019,3647,1863,1784,543,2403,701
200,080543,Castellbisbal,2019,12390,6238,6152,2266,8468,1656
201,080556,Castellcir,2019,752,392,360,137,513,102
202,250674,Castelldans,2019,960,511,449,116,617,227
203,080569,Castelldefels,2019,67004,33018,33986,10988,46115,9901
204,080581,Castellet i la Gornal,2019,2292,1180,1112,344,1494,454
205,170464,Castellfollit de la Roca,2019,961,493,468,134,581,246
206,080608,Castellfollit de Riubregós,2019,151,86,65,11,93,47
207,080594,Castellfollit del Boix,2019,436,222,214,72,274,90
208,080615,Castellgalí,2019,2062,1062,1000,354,1324,384
209,080620,Castellnou de Bages,2019,1397,732,665,259,954,184
210,250680,Castellnou de Seana,2019,683,361,322,90,398,195
211,170470,Castelló d'Empúries,2019,10906,5508,5398,1718,7217,1971
212,250693,Castelló de Farfanya,2019,536,288,248,62,327,147
213,080636,Castellolí,2019,619,302,317,128,385,106
214,170486,Castell-Platja d'Aro,2019,10860,5357,5503,1617,7173,2070
215,250707,Castellserà,2019,1003,506,497,119,599,285
216,080641,Castellterçol,2019,2463,1236,1227,338,1550,575
217,430424,Castellvell del Camp,2019,2857,1438,1419,483,1969,405
218,080654,Castellví de la Marca,2019,1535,771,764,212,986,337
219,080667,Castellví de Rosanes,2019,1884,931,953,298,1302,284
220,430430,"Catllar, el",2019,4451,2309,2142,750,3048,653
221,250714,Cava,2019,47,29,18,3,27,17
222,171899,"Cellera de Ter, la",2019,1946,965,981,292,1201,453
223,170499,Celrà,2019,5452,2722,2730,1158,3732,562
224,080673,Centelles,2019,7404,3630,3774,1177,4784,1443
225,082687,Cercs,2019,1145,577,568,120,695,330
226,082665,Cerdanyola del Vallès,2019,57403,28038,29365,8156,38278,10969
227,080689,Cervelló,2019,9054,4529,4525,1500,6004,1550
228,250729,Cervera,2019,9180,4670,4510,1569,6102,1509
229,250735,Cervià de les Garrigues,2019,640,336,304,57,388,195
230,170502,Cervià de Ter,2019,968,492,476,173,623,172
231,170519,Cistella,2019,282,138,144,42,175,65
232,250740,Ciutadilla,2019,208,111,97,21,121,66
233,250753,Clariana de Cardener,2019,157,82,75,20,110,27
234,250766,"Cogul, el",2019,158,88,70,10,86,62
235,170545,Colera,2019,448,223,225,34,277,137
236,250772,Coll de Nargó,2019,550,285,265,65,336,149
237,080692,Collbató,2019,4466,2320,2146,839,3016,611
238,430458,Colldejou,2019,176,93,83,19,117,40
239,080706,Collsuspina,2019,342,174,168,62,217,63
240,170558,Colomers,2019,176,87,89,19,110,47
241,251636,"Coma i la Pedra, la",2019,265,157,108,23,189,53
242,251615,Conca de Dalt,2019,418,213,205,47,240,131
243,430461,Conesa,2019,103,54,49,7,62,34
244,430477,Constantí,2019,6540,3398,3142,1233,4351,956
245,080713,Copons,2019,310,152,158,56,185,69
246,430483,Corbera d'Ebre,2019,1016,531,485,121,620,275
247,080728,Corbera de Llobregat,2019,14822,7449,7373,2502,10213,2107
248,250788,Corbins,2019,1444,787,657,232,926,286
249,170577,Corçà,2019,1267,646,621,209,760,298
250,080734,Cornellà de Llobregat,2019,88592,42945,45647,13040,57813,17739
251,170561,Cornellà del Terri,2019,2364,1197,1167,394,1489,481
252,430496,Cornudella de Montsant,2019,941,505,436,104,620,217
253,430509,Creixell,2019,3642,1845,1797,529,2241,872
254,170583,Crespià,2019,246,127,119,38,151,57
255,179011,"Cruïlles, Monells i Sant Sadurní de l'Heura",2019,1279,640,639,182,846,251
256,080749,Cubelles,2019,15329,7687,7642,2563,10199,2567
257,250791,Cubells,2019,343,180,163,29,207,107
258,430516,Cunit,2019,12952,6347,6605,1892,8116,2944
259,170600,Darnius,2019,546,273,273,60,342,144
260,170617,Das,2019,253,131,122,49,162,42
261,439018,Deltebre,2019,11482,5788,5694,1597,7343,2542
262,080752,Dosrius,2019,5481,2780,2701,958,3794,729
263,430537,Duesaigües,2019,245,140,105,24,162,59
264,170622,"Escala, l'",2019,10339,5267,5072,1407,6658,2274
265,080765,Esparreguera,2019,22251,11249,11002,3567,15007,3677
266,170638,Espinelves,2019,215,110,105,28,143,44
267,250812,"Espluga Calba, l'",2019,341,171,170,33,191,117
268,430542,"Espluga de Francolí, l'",2019,3755,1824,1931,516,2400,839
269,080771,Esplugues de Llobregat,2019,46680,22300,24380,6530,29458,10692
270,170643,Espolla,2019,416,203,213,47,245,124
271,170656,Esponellà,2019,438,224,214,77,255,106
272,250827,Espot,2019,364,193,171,42,255,67
273,080787,"Espunyola, l'",2019,254,126,128,26,163,65
274,082541,"Esquirol, l'",2019,2181,1105,1076,282,1387,512
275,250886,Estamariu,2019,118,68,50,16,60,42
276,080790,"Estany, l'",2019,406,205,201,52,236,118
277,250851,Estaràs,2019,162,85,77,18,96,48
278,250864,Esterri d'Àneu,2019,772,364,408,98,554,120
279,250870,Esterri de Cardós,2019,70,37,33,10,48,12
280,430555,Falset,2019,2834,1412,1422,445,1769,620
281,170059,"Far d'Empordà, el",2019,599,305,294,102,389,108
282,250899,Farrera,2019,116,65,51,14,77,25
283,430568,"Fatarella, la",2019,941,458,483,94,520,327
284,430574,"Febró, la",2019,40,25,15,0,27,13
285,081347,Figaró-Montmany,2019,1114,547,567,160,742,212
286,080804,Fígols,2019,42,25,17,3,22,17
287,259084,Fígols i Alinyà,2019,252,145,107,22,150,80
288,430580,"Figuera, la",2019,111,63,48,5,66,40
289,170669,Figueres,2019,46654,23092,23562,8267,31219,7168
290,430593,Figuerola del Camp,2019,320,159,161,46,208,66
291,170675,Flaçà,2019,1093,528,565,172,699,222
292,430607,Flix,2019,3408,1717,1691,340,2112,956
293,250925,"Floresta, la",2019,147,79,68,11,93,43
294,080826,Fogars de la Selva,2019,1451,748,703,191,984,276
295,080811,Fogars de Montclús,2019,470,245,225,91,295,84
296,170681,Foixà,2019,297,150,147,29,180,88
297,080832,Folgueroles,2019,2267,1159,1108,449,1464,354
298,250931,Fondarella,2019,784,387,397,111,523,150
299,080847,Fonollosa,2019,1453,750,703,210,958,285
300,170694,Fontanals de Cerdanya,2019,444,220,224,45,301,98
301,170708,Fontanilles,2019,139,80,59,12,85,42
302,170715,Fontcoberta,2019,1468,738,730,250,973,245
303,080850,Font-rubí,2019,1327,688,639,190,830,307
304,250946,Foradada,2019,186,108,78,24,109,53
305,179026,Forallac,2019,1687,828,859,242,1077,368
306,430614,Forès,2019,43,25,18,2,20,21
307,170736,Fornells de la Selva,2019,2650,1322,1328,528,1762,360
308,170741,Fortià,2019,763,389,374,117,502,144
309,080863,"Franqueses del Vallès, les",2019,20092,10210,9882,3797,13600,2695
310,430629,Freginals,2019,346,175,171,29,217,100
311,250962,"Fuliola, la",2019,1248,619,629,204,755,289
312,250978,Fulleda,2019,85,44,41,1,53,31
313,080902,Gaià,2019,175,97,78,28,117,30
314,430635,"Galera, la",2019,731,375,356,88,440,203
315,080879,Gallifa,2019,172,95,77,15,117,40
316,430640,Gandesa,2019,3064,1563,1501,455,1918,691
317,430653,Garcia,2019,527,264,263,66,309,152
318,430666,"Garidells, els",2019,187,94,93,22,130,35
319,080885,"Garriga, la",2019,16514,7987,8527,2764,11007,2743
320,170754,Garrigàs,2019,437,231,206,66,289,82
321,170767,Garrigoles,2019,162,84,78,21,103,38
322,170773,Garriguella,2019,855,421,434,138,532,185
323,080898,Gavà,2019,46771,22876,23895,7599,31014,8158
324,250984,Gavet de la Conca,2019,261,129,132,20,146,95
325,080919,Gelida,2019,7533,3778,3755,1331,5024,1178
326,170789,Ger,2019,448,222,226,75,284,89
327,259123,Gimenells i el Pla de la Font,2019,1111,595,516,146,706,259
328,430672,Ginestar,2019,753,403,350,61,467,225
329,170792,Girona,2019,101852,48931,52921,16910,69014,15928
330,080924,Gironella,2019,4826,2384,2442,696,2884,1246
331,080930,Gisclareny,2019,25,15,10,1,19,5
332,430688,Godall,2019,575,289,286,55,321,199
333,250997,Golmés,2019,1840,917,923,318,1184,338
334,170806,Gombrèn,2019,188,96,92,35,108,45
335,251001,Gósol,2019,206,118,88,14,130,62
336,080945,"Granada, la",2019,2157,1092,1065,377,1455,325
337,251018,"Granadella, la",2019,712,387,325,80,419,213
338,080958,Granera,2019,69,53,16,3,49,17
339,251023,"Granja d'Escarp, la",2019,936,514,422,102,606,228
340,080961,Granollers,2019,61275,30199,31076,9287,40989,10999
341,251039,Granyanella,2019,148,82,66,11,93,44
342,251057,Granyena de les Garrigues,2019,132,78,54,14,77,41
343,251044,Granyena de Segarra,2019,142,76,66,16,77,49
344,430691,Gratallops,2019,229,125,104,16,148,65
345,080977,Gualba,2019,1500,769,731,309,972,219
346,170813,Gualta,2019,397,229,168,64,262,71
347,080996,Guardiola de Berguedà,2019,908,464,444,103,571,234
348,430705,"Guiamets, els",2019,270,128,142,20,162,88
349,170828,Guils de Cerdanya,2019,537,288,249,64,372,101
350,251095,Guimerà,2019,265,140,125,28,138,99
351,259031,"Guingueta d'Àneu, la",2019,297,159,138,30,188,79
352,251109,Guissona,2019,7136,3810,3326,1393,5062,681
353,251116,Guixers,2019,134,84,50,12,79,43
354,081000,Gurb,2019,2681,1386,1295,448,1795,438
355,430712,Horta de Sant Joan,2019,1149,602,547,131,675,343
356,081017,"Hospitalet de Llobregat, l'",2019,264923,127981,136942,37104,174555,53264
357,081629,"Hostalets de Pierola, els",2019,2973,1518,1455,528,2030,415
358,170834,Hostalric,2019,4221,2130,2091,712,2781,728
359,081022,Igualada,2019,39967,19636,20331,6605,25393,7969
360,251155,Isona i Conca Dellà,2019,1019,548,471,112,592,315
361,170849,Isòvol,2019,281,161,120,41,180,60
362,251137,Ivars d'Urgell,2019,1531,801,730,198,889,444
363,251121,Ivars de Noguera,2019,334,171,163,36,216,82
364,251142,Ivorra,2019,104,57,47,4,63,37
365,170852,Jafre,2019,380,206,174,48,229,103
366,170865,"Jonquera, la",2019,3290,1637,1653,585,2223,482
367,081038,Jorba,2019,835,424,411,139,585,111
368,259101,Josa i Tuixén,2019,106,58,48,7,65,34
369,170871,Juià,2019,323,174,149,53,210,60
370,251180,Juncosa,2019,386,204,182,33,237,116
371,251193,Juneda,2019,3475,1854,1621,519,2220,736
372,251214,Les,2019,946,463,483,150,672,124
373,251229,Linyola,2019,2700,1365,1335,397,1735,568
374,081043,"Llacuna, la",2019,870,475,395,98,548,224
375,170887,Lladó,2019,818,398,420,170,519,129
376,251235,Lladorre,2019,230,116,114,28,143,59
377,251240,Lladurs,2019,176,91,85,16,105,55
378,081056,"Llagosta, la",2019,13480,6675,6805,2200,8739,2541
379,170890,Llagostera,2019,8453,4303,4150,1459,5552,1442
380,170904,Llambilles,2019,696,359,337,113,463,120
381,170911,Llanars,2019,505,259,246,64,308,133
382,170926,Llançà,2019,4836,2394,2442,650,3078,1108
383,251253,Llardecans,2019,451,236,215,38,260,153
384,251266,Llavorsí,2019,352,180,172,43,240,69
385,251207,Lleida,2019,138956,68657,70299,21489,92712,24755
386,170932,Llers,2019,1239,617,622,171,810,258
387,251272,Lles de Cerdanya,2019,253,148,105,30,156,67
388,081075,Lliçà d'Amunt,2019,15256,7819,7437,2431,10298,2527
389,081081,Lliçà de Vall,2019,6542,3335,3207,1005,4315,1222
390,251288,Llimiana,2019,145,88,57,11,87,47
391,081069,Llinars del Vallès,2019,9938,4946,4992,1499,6668,1771
392,170947,Llívia,2019,1417,748,669,183,981,253
393,430727,"Lloar, el",2019,107,58,49,15,62,30
394,251291,Llobera,2019,188,104,84,24,108,56
395,430733,Llorac,2019,100,52,48,7,67,26
396,430748,Llorenç del Penedès,2019,2393,1172,1221,397,1523,473
397,170950,Lloret de Mar,2019,38373,19528,18845,5967,26882,5524
398,170963,"Llosses, les",2019,218,121,97,38,144,36
399,081094,Lluçà,2019,273,134,139,51,181,41
400,171024,Maçanet de Cabrenys,2019,688,340,348,70,418,200
401,171030,Maçanet de la Selva,2019,7006,3598,3408,1073,4650,1283
402,170979,Madremanya,2019,283,138,145,53,173,57
403,170985,Maià de Montcal,2019,449,251,198,62,290,97
404,251333,Maials,2019,920,517,403,91,561,268
405,251305,Maldà,2019,220,109,111,23,133,64
406,081108,Malgrat de Mar,2019,18579,9280,9299,2666,12102,3811
407,081115,Malla,2019,273,139,134,43,175,55
408,081120,Manlleu,2019,20573,10314,10259,3521,13437,3615
409,081136,Manresa,2019,77714,38066,39648,12402,49894,15418
410,430764,Marçà,2019,594,314,280,76,387,131
411,430751,Margalef,2019,97,59,38,6,57,34
412,082423,Marganell,2019,266,131,135,23,175,68
413,081141,Martorell,2019,28189,14329,13860,4922,18618,4649
414,081154,Martorelles,2019,4801,2422,2379,682,3162,957
415,430770,Mas de Barberans,2019,578,288,290,50,343,185
416,171002,Masarac,2019,288,150,138,32,197,59
417,430786,Masdenverge,2019,1070,546,524,135,672,263
418,081167,"Masies de Roda, les",2019,700,355,345,101,444,155
419,081173,"Masies de Voltregà, les",2019,3141,1551,1590,448,2113,580
420,430799,Masllorenç,2019,504,283,221,76,330,98
421,081189,"Masnou, el",2019,23515,11357,12158,3446,15510,4559
422,430803,"Masó, la",2019,276,146,130,38,159,79
423,430810,Maspujols,2019,827,426,401,153,553,121
424,081192,Masquefa,2019,9211,4641,4570,1650,6273,1288
425,430825,"Masroig, el",2019,497,270,227,57,294,146
426,251312,Massalcoreig,2019,598,338,260,48,414,136
427,171019,Massanes,2019,761,405,356,144,462,155
428,251327,Massoteres,2019,218,119,99,40,139,39
429,081206,Matadepera,2019,9326,4657,4669,1709,6043,1574
430,081213,Mataró,2019,128265,63637,64628,20988,84897,22380
431,081228,Mediona,2019,2322,1159,1163,401,1429,492
432,251348,Menàrguens,2019,806,440,366,71,525,210
433,170998,Meranges,2019,104,58,46,18,64,22
434,171058,Mieres,2019,318,160,158,40,195,83
435,430831,"Milà, el",2019,178,85,93,28,106,44
436,251351,Miralcamp,2019,1351,677,674,221,840,290
437,430846,Miravet,2019,691,369,322,83,414,194
438,081385,Moià,2019,6267,3190,3077,994,4181,1092
439,430859,"Molar, el",2019,297,158,139,22,182,93
440,081234,Molins de Rei,2019,25868,12612,13256,4502,16976,4390
441,251370,Mollerussa,2019,14683,7543,7140,2690,9900,2093
442,171061,Mollet de Peralada,2019,189,96,93,29,102,58
443,081249,Mollet del Vallès,2019,51318,25222,26096,8088,34501,8729
444,171077,Molló,2019,337,162,175,44,200,93
445,251364,"Molsosa, la",2019,107,53,54,6,68,33
446,081287,Monistrol de Calders,2019,682,357,325,69,464,149
447,081271,Monistrol de Montserrat,2019,3034,1551,1483,459,1983,592
448,171096,Montagut i Oix,2019,916,475,441,124,623,169
449,430862,Montblanc,2019,7364,3737,3627,1154,4825,1385
450,430884,Montbrió del Camp,2019,2890,1485,1405,569,1894,427
451,081252,Montcada i Reixac,2019,36239,17901,18338,6114,24649,5476
452,081304,Montclar,2019,136,71,65,23,81,32
453,251399,Montellà i Martinet,2019,579,324,255,57,380,142
454,081311,Montesquiu,2019,998,501,497,163,622,213
455,251403,Montferrer i Castellbò,2019,1041,566,475,179,650,212
456,430897,Montferri,2019,387,202,185,72,244,71
457,251386,Montgai,2019,625,329,296,49,370,206
458,081265,Montgat,2019,12041,5938,6103,2083,8104,1854
459,081326,Montmajor,2019,464,231,233,74,262,128
460,081332,Montmaneu,2019,150,83,67,11,93,46
461,430901,"Montmell, el",2019,1512,808,704,227,1006,279
462,081350,Montmeló,2019,8755,4275,4480,1273,5797,1685
463,251425,Montoliu de Lleida,2019,489,251,238,52,312,125
464,251410,Montoliu de Segarra,2019,179,100,79,19,106,54
465,251431,Montornès de Segarra,2019,100,47,53,10,51,39
466,081363,Montornès del Vallès,2019,16393,8251,8142,2992,10892,2509
467,430918,Mont-ral,2019,162,94,68,20,112,30
468,171100,Mont-ras,2019,1679,846,833,200,1123,356
469,430923,Mont-roig del Camp,2019,12136,6260,5876,1910,8019,2207
470,081379,Montseny,2019,342,179,163,50,213,79
471,430939,Móra d'Ebre,2019,5690,2845,2845,888,3719,1083
472,430944,Móra la Nova,2019,3087,1541,1546,416,2047,624
473,430957,"Morell, el",2019,3704,1881,1823,674,2561,469
474,430960,"Morera de Montsant, la",2019,152,85,67,18,101,33
475,081290,Muntanyola,2019,634,321,313,116,432,86
476,081398,Mura,2019,224,122,102,40,134,50
477,251459,Nalec,2019,87,45,42,5,47,35
478,250254,Naut Aran,2019,1803,935,868,252,1295,256
479,081402,Navarcles,2019,5977,2914,3063,827,3861,1289
480,081419,Navàs,2019,6020,2998,3022,910,3864,1246
481,171117,Navata,2019,1381,671,710,238,894,249
482,251462,Navès,2019,280,147,133,39,184,57
483,081424,"Nou de Berguedà, la",2019,161,83,78,17,94,50
484,430976,"Nou de Gaià, la",2019,603,300,303,135,364,104
485,430982,Nulles,2019,492,267,225,94,296,102
486,251484,Odèn,2019,249,149,100,14,157,78
487,081430,Òdena,2019,3643,1848,1795,668,2368,607
488,171122,Ogassa,2019,234,130,104,32,152,50
489,081458,Olèrdola,2019,3692,1900,1792,617,2471,604
490,081461,Olesa de Bonesvalls,2019,1810,949,861,306,1222,282
491,081477,Olesa de Montserrat,2019,23904,11913,11991,4304,15770,3830
492,251497,Oliana,2019,1810,906,904,199,1100,511
493,251500,Oliola,2019,197,106,91,14,130,53
494,251517,Olius,2019,986,527,459,199,616,171
495,081483,Olivella,2019,3799,1985,1814,746,2566,487
496,081496,Olost,2019,1198,588,610,140,760,298
497,171143,Olot,2019,35228,17569,17659,5255,23126,6847
498,251522,"Oluges, les",2019,167,88,79,15,93,59
499,081445,Olvan,2019,854,416,438,97,551,206
500,251538,"Omellons, els",2019,211,111,100,14,119,78
501,251543,"Omells de na Gaia, els",2019,131,72,59,8,84,39
502,171156,Ordis,2019,371,199,172,58,231,82
503,251556,Organyà,2019,784,388,396,95,458,231
504,081509,Orís,2019,315,159,156,45,220,50
505,081516,Oristà,2019,541,274,267,67,317,157
506,081521,Orpí,2019,147,80,67,25,98,24
507,081537,Òrrius,2019,739,381,358,133,496,110
508,251569,Os de Balaguer,2019,994,507,487,150,623,221
509,171169,Osor,2019,428,227,201,48,286,94
510,251575,Ossó de Sió,2019,204,98,106,30,121,53
511,081542,Pacs del Penedès,2019,922,469,453,150,610,162
512,081555,Palafolls,2019,9405,4690,4715,1701,6420,1284
513,171175,Palafrugell,2019,22974,11377,11597,3865,14962,4147
514,171181,Palamós,2019,17910,8766,9144,2452,11864,3594
515,251581,"Palau d'Anglesola, el",2019,2166,1061,1105,357,1395,414
516,171194,Palau de Santa Eulàlia,2019,91,52,39,12,55,24
517,171215,Palau-sator,2019,310,166,144,46,192,72
518,171208,Palau-saverdera,2019,1476,741,735,263,891,322
519,081568,Palau-solità i Plegamans,2019,14771,7246,7525,2385,9975,2411
520,431009,"Pallaresos, els",2019,4777,2404,2373,982,3262,533
521,081574,Pallejà,2019,11508,5728,5780,2028,7692,1788
522,430995,"Palma d'Ebre, la",2019,340,166,174,24,185,131
523,089058,"Palma de Cervelló, la",2019,2954,1460,1494,439,2040,475
524,171236,Palol de Revardit,2019,455,228,227,76,280,99
525,171241,Pals,2019,2411,1222,1189,327,1516,568
526,081580,"Papiol, el",2019,4145,2052,2093,711,2766,668
527,171254,Pardines,2019,162,89,73,22,98,42
528,081593,Parets del Vallès,2019,19082,9541,9541,3274,12875,2933
529,171267,Parlavà,2019,394,199,195,55,241,98
530,431016,Passanant i Belltall,2019,163,95,68,7,99,57
531,171289,Pau,2019,560,285,275,71,341,148
532,431021,Paüls,2019,556,277,279,65,300,191
533,171292,Pedret i Marzà,2019,198,101,97,37,126,35
534,251641,Penelles,2019,452,262,190,54,274,124
535,171306,"Pera, la",2019,446,221,225,69,278,99
536,081607,Perafita,2019,395,202,193,47,240,108
537,431037,Perafort,2019,1261,654,607,257,850,154
538,171328,Peralada,2019,1850,906,944,261,1219,370
539,251654,Peramola,2019,347,177,170,30,216,101
540,431042,"Perelló, el",2019,2770,1421,1349,394,1629,747
541,081614,Piera,2019,15603,7976,7627,2556,10395,2652
542,431055,"Piles, les",2019,212,120,92,42,127,43
543,081635,Pineda de Mar,2019,27272,13588,13684,3923,17674,5675
544,431068,"Pinell de Brai, el",2019,1017,516,501,106,601,310
545,251667,Pinell de Solsonès,2019,200,118,82,18,124,58
546,251673,Pinós,2019,287,151,136,42,178,67
547,431074,Pira,2019,493,261,232,73,319,101
548,431080,"Pla de Santa Maria, el",2019,2327,1215,1112,336,1540,451
549,081640,"Pla del Penedès, el",2019,1256,636,620,225,816,215
550,171334,"Planes d'Hostoles, les",2019,1683,851,832,228,990,465
551,171349,Planoles,2019,288,157,131,33,182,73
552,259118,"Plans de Sió, els",2019,506,272,234,51,312,143
553,251689,"Poal, el",2019,648,340,308,79,409,160
554,251692,"Pobla de Cérvoles, la",2019,191,107,84,12,119,60
555,081653,"Pobla de Claramunt, la",2019,2193,1104,1089,394,1372,427
556,081666,"Pobla de Lillet, la",2019,1095,528,567,82,627,386
557,431093,"Pobla de Mafumet, la",2019,3904,1982,1922,818,2774,312
558,431107,"Pobla de Massaluca, la",2019,318,181,137,29,177,112
559,431114,"Pobla de Montornès, la",2019,2839,1486,1353,461,1805,573
560,251713,"Pobla de Segur, la",2019,2984,1469,1515,403,1795,786
561,431129,Poboleda,2019,313,166,147,36,188,89
562,081672,Polinyà,2019,8479,4295,4184,1769,5814,896
563,431135,"Pont d'Armentera, el",2019,505,258,247,51,303,151
564,250306,"Pont de Bar, el",2019,157,87,70,17,96,44
565,171352,Pont de Molins,2019,529,267,262,73,347,109
566,251734,"Pont de Suert, el",2019,2220,1107,1113,314,1446,460
567,081825,"Pont de Vilomara i Rocafort, el",2019,3830,1969,1861,642,2506,682
568,431418,Pontils,2019,117,66,51,7,71,39
569,081688,Pontons,2019,532,289,243,65,360,107
570,171365,Pontós,2019,266,141,125,43,168,55
571,251728,Ponts,2019,2601,1305,1296,363,1657,581
572,171371,Porqueres,2019,4621,2288,2333,780,3012,829
573,431140,Porrera,2019,439,229,210,40,294,105
574,171404,"Port de la Selva, el",2019,970,501,469,112,589,269
575,171387,Portbou,2019,1075,528,547,84,614,377
576,251749,"Portella, la",2019,728,412,316,81,509,138
577,431153,Pradell de la Teixeta,2019,152,70,82,15,96,41
578,431166,Prades,2019,589,309,280,71,366,152
579,431172,Prat de Comte,2019,183,98,85,19,109,55
580,081691,"Prat de Llobregat, el",2019,64599,31621,32978,10037,42261,12301
581,431188,Pratdip,2019,738,395,343,77,415,246
582,081712,Prats de Lluçanès,2019,2569,1280,1289,317,1675,577
583,081705,"Prats de Rei, els",2019,532,283,249,72,337,123
584,251752,Prats i Sansor,2019,219,114,105,23,149,47
585,251765,Preixana,2019,385,199,186,51,209,125
586,251771,Preixens,2019,432,218,214,53,232,147
587,082303,Premià de Dalt,2019,10448,5207,5241,1724,6840,1884
588,081727,Premià de Mar,2019,28119,13704,14415,4220,18320,5579
589,171390,"Preses, les",2019,1788,890,898,305,1150,333
590,251790,Prullans,2019,231,109,122,35,143,53
591,171411,Puigcerdà,2019,9258,4585,4673,1403,6418,1437
592,081748,Puigdàlber,2019,526,256,270,101,336,89
593,251804,Puiggròs,2019,276,138,138,32,173,71
594,431191,Puigpelat,2019,1149,590,559,213,814,122
595,081751,Puig-reig,2019,4178,2086,2092,495,2588,1095
596,251811,Puigverd d'Agramunt,2019,255,146,109,29,165,61
597,251826,Puigverd de Lleida,2019,1355,701,654,199,881,275
598,081764,Pujalt,2019,210,119,91,36,125,49
599,081770,"Quar, la",2019,53,29,24,9,25,19
600,171426,Quart,2019,3724,1855,1869,824,2391,509
601,170433,Queralbs,2019,191,104,87,14,127,50
602,431205,Querol,2019,507,285,222,51,330,126
603,171432,Rabós,2019,178,89,89,18,105,55
604,081786,Rajadell,2019,548,275,273,74,357,117
605,431212,Rasquera,2019,781,384,397,86,446,249
606,171447,Regencós,2019,269,141,128,31,171,67
607,081799,Rellinars,2019,780,403,377,125,529,126
608,431227,Renau,2019,157,82,75,35,109,13
609,431233,Reus,2019,104373,50415,53958,17739,68009,18625
610,251832,Rialp,2019,661,330,331,74,473,114
611,431248,"Riba, la",2019,585,321,264,64,355,166
612,431251,Riba-roja d'Ebre,2019,1126,593,533,114,678,334
613,259059,Ribera d'Ondara,2019,426,213,213,44,258,124
614,251850,Ribera d'Urgellet,2019,935,488,447,147,605,183
615,171450,Ribes de Freser,2019,1754,882,872,171,1074,509
616,171463,Riells i Viabrea,2019,4124,2113,2011,621,2898,605
617,431264,"Riera de Gaià, la",2019,1744,867,877,363,1119,262
618,251863,Riner,2019,263,132,131,41,153,69
619,171479,Ripoll,2019,10686,5273,5413,1474,6722,2490
620,081803,Ripollet,2019,38665,19080,19585,6903,25919,5843
621,259139,Riu de Cerdanya,2019,93,55,38,5,68,20
622,171485,Riudarenes,2019,2182,1125,1057,359,1421,402
623,171498,Riudaura,2019,478,232,246,87,304,87
624,431270,Riudecanyes,2019,1124,590,534,179,734,211
625,431286,Riudecols,2019,1180,611,569,152,797,231
626,171501,Riudellots de la Selva,2019,2076,1053,1023,341,1400,335
627,431299,Riudoms,2019,6594,3380,3214,1128,4197,1269
628,171518,Riumors,2019,258,126,132,36,162,60
629,081810,"Roca del Vallès, la",2019,10650,5319,5331,1866,7162,1622
630,431303,Rocafort de Queralt,2019,225,122,103,27,122,76
631,431310,Roda de Berà,2019,6567,3341,3226,999,4158,1410
632,081831,Roda de Ter,2019,6301,3118,3183,1033,4147,1121
633,431325,Rodonyà,2019,490,262,228,61,332,97
634,431331,Roquetes,2019,7973,4126,3847,1259,5294,1420
635,171523,Roses,2019,19550,9862,9688,3150,12854,3546
636,251898,Rosselló,2019,3145,1602,1543,531,2131,483
637,431346,"Rourell, el",2019,366,191,175,52,250,64
638,081846,Rubí,2019,77464,38358,39106,13107,52348,12009
639,081859,Rubió,2019,239,133,106,30,151,58
640,171539,Rupià,2019,272,138,134,45,157,70
641,089019,Rupit i Pruit,2019,279,139,140,29,162,88
642,081878,Sabadell,2019,213644,103847,109797,34227,139504,39913
643,081884,Sagàs,2019,148,80,68,28,94,26
644,251902,Salàs de Pallars,2019,320,174,146,35,191,94
645,081901,Saldes,2019,274,159,115,11,175,88
646,171544,Sales de Llierca,2019,154,77,77,26,109,19
647,081918,Sallent,2019,6658,3211,3447,907,4053,1698
648,431359,Salomó,2019,557,295,262,95,347,115
649,439057,Salou,2019,27476,14141,13335,4300,19630,3546
650,171557,Salt,2019,31362,16454,14908,6477,21002,3883
651,251919,Sanaüja,2019,380,202,178,35,221,124
652,081944,Sant Adrià de Besòs,2019,37097,18251,18846,6079,24613,6405
653,081957,Sant Agustí de Lluçanès,2019,85,42,43,9,54,22
654,081960,Sant Andreu de la Barca,2019,27558,13679,13879,5101,18362,4095
655,081976,Sant Andreu de Llavaneres,2019,10968,5424,5544,1729,7352,1887
656,171576,Sant Andreu Salou,2019,155,79,76,24,96,35
657,171833,Sant Aniol de Finestres,2019,341,177,164,51,215,75
658,081982,Sant Antoni de Vilamajor,2019,6135,3031,3104,1032,4156,947
659,081995,Sant Bartomeu del Grau,2019,858,460,398,129,552,177
660,082009,Sant Boi de Llobregat,2019,83605,40877,42728,12893,54739,15973
661,082016,Sant Boi de Lluçanès,2019,541,269,272,53,302,186
662,431362,Sant Carles de la Ràpita,2019,14789,7238,7551,1987,9515,3287
663,082037,Sant Cebrià de Vallalta,2019,3385,1764,1621,614,2262,509
664,082021,Sant Celoni,2019,17904,8939,8965,3031,11762,3111
665,082042,Sant Climent de Llobregat,2019,4129,2075,2054,807,2774,548
666,171582,Sant Climent Sescebes,2019,626,364,262,84,422,120
667,082055,Sant Cugat del Vallès,2019,91006,44197,46809,17503,60781,12722
668,082068,Sant Cugat Sesgarrigues,2019,1007,488,519,181,638,188
669,251961,Sant Esteve de la Sarga,2019,124,72,52,7,73,44
670,082074,Sant Esteve de Palautordera,2019,2820,1391,1429,528,1912,380
671,082080,Sant Esteve Sesrovires,2019,7612,3835,3777,1239,5162,1211
672,171595,Sant Feliu de Buixalleu,2019,783,410,373,105,512,166
673,082107,Sant Feliu de Codines,2019,6259,3168,3091,991,4264,1004
674,171609,Sant Feliu de Guíxols,2019,21925,10802,11123,3389,14129,4407
675,082114,Sant Feliu de Llobregat,2019,44860,21767,23093,7062,29281,8517
676,171616,Sant Feliu de Pallerols,2019,1371,667,704,213,856,302
677,082129,Sant Feliu Sasserra,2019,602,312,290,83,363,156
678,171621,Sant Ferriol,2019,243,124,119,50,147,46
679,082093,Sant Fost de Campsentelles,2019,8737,4352,4385,1271,5669,1797
680,082135,Sant Fruitós de Bages,2019,8703,4295,4408,1496,5820,1387
681,171637,Sant Gregori,2019,3817,1959,1858,738,2469,610
682,251924,Sant Guim de Freixenet,2019,1025,538,487,153,625,247
683,251977,Sant Guim de la Plana,2019,185,106,79,18,112,55
684,171642,Sant Hilari Sacalm,2019,5627,2843,2784,848,3580,1199
685,082153,Sant Hipòlit de Voltregà,2019,3484,1729,1755,534,2285,665
686,081939,Sant Iscle de Vallalta,2019,1332,687,645,246,888,198
687,439023,Sant Jaume d'Enveja,2019,3503,1765,1738,471,2191,841
688,082166,Sant Jaume de Frontanyà,2019,30,18,12,3,16,11
689,171655,Sant Jaume de Llierca,2019,865,416,449,129,531,205
690,431378,Sant Jaume dels Domenys,2019,2622,1342,1280,503,1685,434
691,171674,Sant Joan de les Abadesses,2019,3232,1604,1628,393,1911,928
692,171680,Sant Joan de Mollet,2019,507,248,259,83,322,102
693,082188,Sant Joan de Vilatorrada,2019,10936,5490,5446,1780,7051,2105
694,082172,Sant Joan Despí,2019,34123,16585,17538,5616,22626,5881
695,171851,Sant Joan les Fonts,2019,3006,1541,1465,424,1871,711
696,171668,Sant Jordi Desvalls,2019,761,380,381,126,474,161
697,089030,Sant Julià de Cerdanyola,2019,228,125,103,25,149,54
698,171693,Sant Julià de Ramis,2019,3515,1780,1735,668,2381,466
699,082205,Sant Julià de Vilatorta,2019,3114,1539,1575,511,2067,536
700,179032,Sant Julià del Llor i Bonmatí,2019,1286,651,635,230,861,195
701,082212,Sant Just Desvern,2019,17805,8544,9261,3081,11306,3418
702,082227,Sant Llorenç d'Hortons,2019,2413,1226,1187,395,1632,386
703,171714,Sant Llorenç de la Muga,2019,264,135,129,34,171,59
704,251930,Sant Llorenç de Morunys,2019,949,457,492,115,562,272
705,082233,Sant Llorenç Savall,2019,2373,1197,1176,335,1507,531
706,082251,Sant Martí d'Albars,2019,112,56,56,17,63,32
707,082248,Sant Martí de Centelles,2019,1167,600,567,165,821,181
708,171729,Sant Martí de Llémena,2019,633,330,303,103,445,85
709,259025,Sant Martí de Riucorb,2019,646,334,312,72,354,220
710,082264,Sant Martí de Tous,2019,1235,637,598,243,762,230
711,082270,Sant Martí Sarroca,2019,3264,1608,1656,541,2120,603
712,082286,Sant Martí Sesgueioles,2019,343,176,167,38,236,69
713,171735,Sant Martí Vell,2019,252,131,121,31,169,52
714,082299,Sant Mateu de Bages,2019,603,302,301,59,349,195
715,171740,Sant Miquel de Campmajor,2019,231,127,104,44,144,43
716,171753,Sant Miquel de Fluvià,2019,764,397,367,112,504,148
717,171766,Sant Mori,2019,177,90,87,23,116,38
718,171772,Sant Pau de Segúries,2019,697,347,350,90,421,186
719,082310,Sant Pere de Ribes,2019,30719,15268,15451,5138,20967,4614
720,082325,Sant Pere de Riudebitlles,2019,2368,1181,1187,418,1434,516
721,082331,Sant Pere de Torelló,2019,2419,1242,1177,360,1541,518
722,082346,Sant Pere de Vilamajor,2019,4472,2239,2233,760,3044,668
723,171788,Sant Pere Pescador,2019,2042,1084,958,342,1362,338
724,081897,Sant Pere Sallavinera,2019,152,82,70,25,83,44
725,082359,Sant Pol de Mar,2019,5299,2604,2695,820,3354,1125
726,082362,Sant Quintí de Mediona,2019,2254,1154,1100,374,1466,414
727,082378,Sant Quirze de Besora,2019,2167,1054,1113,292,1318,557
728,082384,Sant Quirze del Vallès,2019,20141,9865,10276,3761,13557,2823
729,082397,Sant Quirze Safaja,2019,627,336,291,114,435,78
730,251945,Sant Ramon,2019,491,254,237,54,278,159
731,082401,Sant Sadurní d'Anoia,2019,12887,6348,6539,2225,8496,2166
732,082418,Sant Sadurní d'Osormort,2019,78,47,31,5,56,17
733,080983,Sant Salvador de Guardiola,2019,3179,1630,1549,518,2087,574
734,082628,Sant Vicenç de Castellet,2019,9523,4760,4763,1529,6183,1811
735,082649,Sant Vicenç de Montalt,2019,6407,3199,3208,1065,4219,1123
736,082652,Sant Vicenç de Torelló,2019,2058,1019,1039,327,1364,367
737,082634,Sant Vicenç dels Horts,2019,28117,13959,14158,4456,19033,4628
738,431384,Santa Bàrbara,2019,3707,1881,1826,553,2350,804
739,082439,Santa Cecília de Voltregà,2019,187,99,88,23,128,36
740,082444,Santa Coloma de Cervelló,2019,8218,4026,4192,1618,5501,1099
741,171805,Santa Coloma de Farners,2019,13143,6621,6522,2262,8693,2188
742,082457,Santa Coloma de Gramenet,2019,119215,58895,60320,18332,77486,23397
743,431397,Santa Coloma de Queralt,2019,2673,1328,1345,384,1651,638
744,171812,Santa Cristina d'Aro,2019,5223,2624,2599,846,3449,928
745,082460,Santa Eugènia de Berga,2019,2248,1142,1106,327,1518,403
746,082476,Santa Eulàlia de Riuprimer,2019,1345,686,659,275,859,211
747,082482,Santa Eulàlia de Ronçana,2019,7288,3639,3649,1221,4808,1259
748,082495,Santa Fe del Penedès,2019,374,185,189,61,253,60
749,171827,Santa Llogaia d'Àlguema,2019,370,189,181,78,234,58
750,082508,Santa Margarida de Montbui,2019,9980,4993,4987,1762,6479,1739
751,082515,Santa Margarida i els Monjos,2019,7611,3856,3755,1504,5018,1089
752,082589,Santa Maria d'Oló,2019,1025,521,504,150,623,252
753,082536,Santa Maria de Besora,2019,150,78,72,19,91,40
754,082567,Santa Maria de Martorelles,2019,893,449,444,156,598,139
755,082554,Santa Maria de Merlès,2019,184,89,95,40,116,28
756,082573,Santa Maria de Miralles,2019,126,68,58,15,79,32
757,082592,Santa Maria de Palautordera,2019,9423,4760,4663,1505,6355,1563
758,431401,Santa Oliva,2019,3320,1685,1635,577,2130,613
759,171848,Santa Pau,2019,1565,792,773,220,991,354
760,082606,Santa Perpètua de Mogoda,2019,25799,12958,12841,4563,17346,3890
761,082613,Santa Susanna,2019,3446,1721,1725,597,2274,575
762,081923,Santpedor,2019,7554,3755,3799,1402,4814,1338
763,431423,Sarral,2019,1548,789,759,248,988,312
764,171864,Sarrià de Ter,2019,5170,2530,2640,885,3416,869
765,252017,Sarroca de Bellera,2019,121,68,53,6,72,43
766,252000,Sarroca de Lleida,2019,363,200,163,32,202,129
767,171870,"Saus, Camallera i Llampaies",2019,837,424,413,126,519,192
768,431439,Savallà del Comtat,2019,58,31,27,1,39,18
769,431444,"Secuita, la",2019,1687,851,836,293,1122,272
770,171886,"Selva de Mar, la",2019,196,108,88,13,124,59
771,431457,"Selva del Camp, la",2019,5652,2836,2816,950,3793,909
772,431460,Senan,2019,48,33,15,6,27,15
773,430445,"Sénia, la",2019,5681,2844,2837,806,3707,1168
774,252022,Senterada,2019,137,80,57,10,105,22
775,250352,"Sentiu de Sió, la",2019,406,216,190,36,253,117
776,082671,Sentmenat,2019,9078,4611,4467,1608,6169,1301
777,171903,Serinyà,2019,1136,576,560,201,735,200
778,252043,Seròs,2019,1922,1029,893,280,1229,413
779,171910,Serra de Daró,2019,221,122,99,33,138,50
780,171925,Setcases,2019,177,98,79,15,117,45
781,252038,"Seu d'Urgell, la",2019,12089,5842,6247,1745,8036,2308
782,082690,Seva,2019,3519,1784,1735,559,2331,629
783,252056,Sidamon,2019,734,383,351,117,489,128
784,171931,Sils,2019,6093,3108,2985,1035,4056,1002
785,082704,Sitges,2019,29307,14708,14599,4162,19738,5407
786,170524,Siurana,2019,168,84,84,21,108,39
787,082711,Sobremunt,2019,79,36,43,7,56,16
788,252069,"Soleràs, el",2019,332,173,159,35,190,107
789,431476,Solivella,2019,633,333,300,74,385,174
790,252075,Solsona,2019,9094,4488,4606,1466,5911,1717
791,082726,Sora,2019,209,117,92,35,131,43
792,252081,Soriguera,2019,410,220,190,59,287,64
793,252094,Sort,2019,2149,1077,1072,325,1422,402
794,252108,Soses,2019,1763,923,840,309,1110,344
795,082732,Subirats,2019,3044,1577,1467,475,1972,597
796,252115,Sudanell,2019,853,465,388,87,561,205
797,252120,Sunyer,2019,352,205,147,30,251,71
798,082747,Súria,2019,5942,2897,3045,770,3788,1384
799,171946,Susqueda,2019,101,60,41,8,74,19
800,082763,Tagamanent,2019,323,169,154,50,225,48
801,082779,Talamanca,2019,206,115,91,31,132,43
802,252154,Talarn,2019,585,387,198,51,447,87
803,252167,Talavera,2019,283,158,125,27,166,90
804,171959,"Tallada d'Empordà, la",2019,463,241,222,67,293,103
805,082785,Taradell,2019,6489,3238,3251,1048,4192,1249
806,431482,Tarragona,2019,134515,65505,69010,21113,89022,24380
807,252173,Tàrrega,2019,17098,8489,8609,3011,11343,2744
808,252189,Tarrés,2019,106,56,50,16,61,29
809,252192,Tarroja de Segarra,2019,187,104,83,27,112,48
810,082750,Tavèrnoles,2019,316,159,157,52,203,61
811,082802,Tavertet,2019,111,57,54,8,68,35
812,082819,Teià,2019,6397,3134,3263,960,4110,1327
813,252206,Térmens,2019,1333,678,655,172,826,335
814,171962,Terrades,2019,329,162,167,48,216,65
815,082798,Terrassa,2019,220556,108469,112087,37692,145942,36922
816,082824,Tiana,2019,8840,4233,4607,1510,5892,1438
817,252213,Tírvia,2019,131,63,68,9,87,35
818,252228,Tiurana,2019,73,33,40,6,47,20
819,431495,Tivenys,2019,899,458,441,83,547,269
820,431508,Tivissa,2019,1602,799,803,188,989,425
821,082830,Tona,2019,8241,4099,4142,1352,5451,1438
822,252234,Torà,2019,1255,639,616,157,818,280
823,082845,Tordera,2019,17216,8722,8494,2968,11323,2925
824,082858,Torelló,2019,14347,7137,7210,2297,9278,2772
825,252249,"Torms, els",2019,144,77,67,10,83,51
826,252252,Tornabous,2019,858,461,397,115,521,222
827,252271,"Torre de Cabdella, la",2019,760,383,377,60,469,231
828,082861,"Torre de Claramunt, la",2019,3714,1923,1791,589,2529,596
829,431515,"Torre de Fontaubella, la",2019,138,68,70,20,73,45
830,431520,"Torre de l'Espanyol, la",2019,611,311,300,77,374,160
831,252265,Torrebesses,2019,282,150,132,33,164,85
832,431536,Torredembarra,2019,16184,7925,8259,2486,10631,3067
833,252287,Torrefarrera,2019,4605,2328,2277,928,3113,564
834,259078,Torrefeta i Florejacs,2019,602,322,280,65,383,154
835,252304,Torregrossa,2019,2202,1140,1062,296,1378,528
836,252311,Torrelameu,2019,743,433,310,92,493,158
837,082877,Torrelavit,2019,1419,723,696,245,909,265
838,082883,Torrelles de Foix,2019,2348,1267,1081,342,1582,424
839,082896,Torrelles de Llobregat,2019,6041,3003,3038,1115,4141,785
840,171978,Torrent,2019,175,92,83,21,114,40
841,252326,Torres de Segre,2019,2277,1179,1098,272,1578,427
842,252332,Torre-serona,2019,397,208,189,43,267,87
843,171984,Torroella de Fluvià,2019,694,354,340,104,478,112
844,171997,Torroella de Montgrí,2019,11645,5900,5745,1841,7688,2116
845,431541,Torroja del Priorat,2019,149,81,68,12,88,49
846,172001,Tortellà,2019,809,393,416,124,510,175
847,431554,Tortosa,2019,33372,16496,16876,5118,21389,6865
848,172018,Toses,2019,171,102,69,20,115,36
849,172023,Tossa de Mar,2019,5683,2861,2822,733,3840,1110
850,252347,Tremp,2019,5844,2884,2960,803,3714,1327
851,172044,Ullà,2019,1153,632,521,218,771,164
852,082900,Ullastrell,2019,2093,1052,1041,429,1378,286
853,172057,Ullastret,2019,290,140,150,47,181,62
854,431567,Ulldecona,2019,6300,3286,3014,931,4091,1278
855,431573,Ulldemolins,2019,396,229,167,29,231,136
856,172039,Ultramort,2019,223,118,105,41,123,59
857,172060,Urús,2019,189,93,96,15,136,38
858,082917,Vacarisses,2019,6688,3436,3252,1289,4554,845
859,170144,"Vajol, la",2019,89,48,41,9,59,21
860,172076,"Vall d'en Bas, la",2019,3072,1553,1519,494,1949,629
861,172082,"Vall de Bianya, la",2019,1264,639,625,197,837,230
862,250432,"Vall de Boí, la",2019,1021,546,475,133,712,176
863,259010,Vall de Cardós,2019,364,195,169,47,236,81
864,082922,Vallbona d'Anoia,2019,1373,719,654,204,894,275
865,252385,Vallbona de les Monges,2019,233,120,113,19,131,83
866,082938,Vallcebre,2019,250,142,108,13,161,76
867,431589,Vallclara,2019,98,57,41,13,63,22
868,252402,Vallfogona de Balaguer,2019,1876,937,939,325,1202,349
869,171707,Vallfogona de Ripollès,2019,206,109,97,20,119,67
870,431592,Vallfogona de Riucorb,2019,91,55,36,1,53,37
871,082943,Vallgorguina,2019,2891,1451,1440,595,1946,350
872,082956,Vallirana,2019,15006,7523,7483,2561,9891,2554
873,172095,Vall-llobrega,2019,899,446,453,171,624,104
874,431606,Vallmoll,2019,1756,890,866,277,1180,299
875,082969,Vallromanes,2019,2579,1328,1251,494,1773,312
876,431613,Valls,2019,24359,12210,12149,3874,16013,4472
877,259062,"Valls d'Aguilar, les",2019,260,145,115,18,164,78
878,252398,"Valls de Valira, les",2019,791,412,379,95,538,158
879,431628,Vandellòs i l'Hospitalet de l'Infant,2019,6482,3246,3236,1098,4293,1091
880,259097,"Vansa i Fórnols, la",2019,161,84,77,5,108,48
881,082975,Veciana,2019,182,99,83,35,96,51
882,431634,"Vendrell, el",2019,37606,18631,18975,6190,24420,6996
883,172109,Ventalló,2019,859,438,421,134,547,178
884,252424,Verdú,2019,919,441,478,112,557,250
885,172116,Verges,2019,1171,572,599,197,689,285
886,431649,Vespella de Gaià,2019,410,232,178,63,254,93
887,082981,Vic,2019,46214,23306,22908,8025,31046,7143
888,172121,Vidrà,2019,167,83,84,22,114,31
889,172137,Vidreres,2019,7797,4048,3749,1213,5204,1380
890,252430,Vielha e Mijaran,2019,5559,2837,2722,775,4065,719
891,431652,Vilabella,2019,736,378,358,87,463,186
892,172142,Vilabertran,2019,979,489,490,184,591,204
893,172155,Vilablareix,2019,2897,1438,1459,538,1919,440
894,082994,Vilada,2019,416,217,199,27,251,138
895,172174,Viladamat,2019,468,241,227,68,294,106
896,172168,Viladasens,2019,200,107,93,28,132,40
897,083015,Viladecans,2019,66611,32930,33681,11408,44307,10896
898,083008,Viladecavalls,2019,7512,3724,3788,1210,5226,1076
899,172180,Vilademuls,2019,815,424,391,141,518,156
900,172207,Viladrau,2019,1040,509,531,157,682,201
901,172214,Vilafant,2019,5394,2636,2758,865,3556,973
902,083054,Vilafranca del Penedès,2019,39746,19341,20405,6895,25810,7041
903,252445,Vilagrassa,2019,541,278,263,90,356,95
904,172235,Vilajuïga,2019,1104,549,555,156,760,188
905,431750,Vilalba dels Arcs,2019,625,318,307,67,354,204
906,083067,Vilalba Sasserra,2019,716,357,359,121,479,116
907,252458,Vilaller,2019,561,294,267,68,359,134
908,172240,Vilallonga de Ter,2019,398,212,186,42,257,99
909,431665,Vilallonga del Camp,2019,2389,1206,1183,498,1567,324
910,172253,Vilamacolum,2019,348,193,155,54,220,74
911,172266,Vilamalla,2019,1181,586,595,206,761,214
912,172272,Vilamaniscle,2019,200,116,84,28,129,43
913,252477,Vilamòs,2019,187,100,87,20,143,24
914,172288,Vilanant,2019,392,197,195,64,257,71
915,431671,Vilanova d'Escornalbou,2019,545,288,257,87,342,116
916,252483,Vilanova de Bellpuig,2019,1181,599,582,175,646,360
917,252496,Vilanova de l'Aguda,2019,197,97,100,13,120,64
918,252542,Vilanova de la Barca,2019,1036,535,501,128,669,239
919,252509,Vilanova de Meià,2019,389,223,166,41,217,131
920,431687,Vilanova de Prades,2019,112,60,52,15,72,25
921,083036,Vilanova de Sau,2019,299,142,157,34,180,85
922,252516,Vilanova de Segrià,2019,977,518,459,141,642,194
923,083020,Vilanova del Camí,2019,12458,6227,6231,2166,8234,2058
924,089024,Vilanova del Vallès,2019,5432,2760,2672,1110,3663,659
925,083073,Vilanova i la Geltrú,2019,67086,32456,34630,9945,44356,12785
926,431690,Vilaplana,2019,574,302,272,61,390,123
927,431704,Vila-rodona,2019,1255,660,595,200,813,242
928,172305,Vila-sacra,2019,760,372,388,151,482,127
929,252521,Vila-sana,2019,742,376,366,122,486,134
930,431711,Vila-seca,2019,22187,11113,11074,4221,14986,2980
931,082140,Vilassar de Dalt,2019,9043,4462,4581,1398,5957,1688
932,082191,Vilassar de Mar,2019,20837,10068,10769,3383,13475,3979
933,172229,Vilaür,2019,157,81,76,36,93,28
934,431726,Vilaverd,2019,452,240,212,63,306,83
935,431732,"Vilella Alta, la",2019,135,73,62,19,80,36
936,431747,"Vilella Baixa, la",2019,202,113,89,27,123,52
937,172333,Vilobí d'Onyar,2019,3291,1711,1580,581,2167,543
938,083041,Vilobí del Penedès,2019,1107,569,538,191,690,226
939,172327,Vilopriu,2019,202,107,95,33,113,56
940,252537,"Vilosell, el",2019,169,88,81,8,98,63
941,431763,Vimbodí i Poblet,2019,892,488,404,91,538,263
942,252555,Vinaixa,2019,470,249,221,46,281,143
943,431779,Vinebre,2019,428,221,207,66,262,100
944,431785,Vinyols i els Arcs,2019,2056,1070,986,346,1376,334
945,083089,Viver i Serrateix,2019,168,87,81,23,96,49
946,430521,Xerta,2019,1170,571,599,124,714,332
947,000000,Catalunya,2019,7675217,3770123,3905094,1172116,5060347,1442754
0,250019,Abella de la Conca,2020,183,99,84,18,121,44
1,080018,Abrera,2020,12538,6325,6213,2236,8365,1937
2,250024,Àger,2020,580,314,266,51,355,174
3,250030,Agramunt,2020,5411,2710,2701,837,3485,1089
4,080023,Aguilar de Segarra,2020,282,148,134,54,177,51
5,170010,Agullana,2020,863,431,432,135,545,183
6,080142,Aiguafreda,2020,2512,1221,1291,322,1625,565
7,430017,Aiguamúrcia,2020,930,483,447,127,582,221
8,170025,Aiguaviva,2020,765,385,380,139,511,115
9,250387,Aitona,2020,2567,1338,1229,403,1577,587
10,250045,"Alamús, els",2020,811,412,399,106,536,169
11,250058,Alàs i Cerc,2020,320,158,162,40,180,100
12,250061,"Albagés, l'",2020,361,189,172,27,224,110
13,170031,Albanyà,2020,155,79,76,37,93,25
14,250077,Albatàrrec,2020,2236,1142,1094,367,1595,274
15,250083,Albesa,2020,1561,848,713,212,983,366
16,250096,"Albi, l'",2020,744,378,366,101,415,228
17,430022,Albinyana,2020,2468,1273,1195,356,1630,482
18,430038,"Albiol, l'",2020,500,272,228,106,324,70
19,170046,Albons,2020,759,391,368,107,504,148
20,430043,Alcanar,2020,9434,4782,4652,1307,6109,2018
21,250100,Alcanó,2020,238,121,117,32,142,64
22,250117,Alcarràs,2020,9707,5096,4611,1806,6725,1176
23,250122,Alcoletge,2020,3435,1805,1630,600,2381,454
24,430056,Alcover,2020,5144,2555,2589,865,3359,920
25,439044,"Aldea, l'",2020,4147,2197,1950,599,2646,902
26,430069,Aldover,2020,905,457,448,101,548,256
27,430075,"Aleixar, l'",2020,893,458,435,132,608,153
28,080039,Alella,2020,9904,4838,5066,1588,6227,2089
29,430081,Alfara de Carles,2020,376,201,175,33,228,115
30,250138,Alfarràs,2020,2765,1440,1325,357,1741,667
31,250143,Alfés,2020,297,159,138,36,181,80
32,430094,Alforja,2020,1783,919,864,237,1197,349
33,250156,Algerri,2020,404,219,185,38,217,149
34,250169,Alguaire,2020,3029,1606,1423,431,1960,638
35,250175,Alins,2020,272,143,129,24,167,81
36,430108,Alió,2020,458,219,239,80,276,102
37,250194,Almacelles,2020,6826,3649,3177,967,4521,1338
38,250208,Almatret,2020,305,170,135,12,178,115
39,250215,Almenar,2020,3357,1774,1583,425,2138,794
40,430115,Almoster,2020,1341,674,667,180,961,200
41,250220,Alòs de Balaguer,2020,132,79,53,8,76,48
42,170062,Alp,2020,1593,823,770,183,1172,238
43,080044,Alpens,2020,261,137,124,31,183,47
44,250236,Alpicat,2020,6266,3138,3128,1141,4220,905
45,250241,Alt Àneu,2020,414,239,175,37,283,94
46,430120,Altafulla,2020,5307,2579,2728,917,3413,977
47,170078,Amer,2020,2332,1144,1188,311,1453,568
48,430136,"Ametlla de Mar, l'",2020,6866,3492,3374,925,4272,1669
49,080057,"Ametlla del Vallès, l'",2020,8646,4358,4288,1380,5964,1302
50,439060,"Ampolla, l'",2020,3277,1683,1594,383,2024,870
51,430141,Amposta,2020,21115,10675,10440,3435,13697,3983
52,170084,Anglès,2020,5654,2817,2837,953,3640,1061
53,250273,Anglesola,2020,1365,689,676,224,819,322
54,250292,Arbeca,2020,2126,1101,1025,230,1330,566
55,430167,"Arboç, l'",2020,5609,2881,2728,1031,3670,908
56,430154,Arbolí,2020,127,74,53,10,90,27
57,170097,Arbúcies,2020,6608,3416,3192,1080,4317,1211
58,080060,Arenys de Mar,2020,15941,7761,8180,2253,10225,3463
59,080076,Arenys de Munt,2020,9121,4591,4530,1434,6080,1607
60,170101,Argelaguer,2020,396,207,189,41,267,88
61,080082,Argençola,2020,219,113,106,30,149,40
62,430173,"Argentera, l'",2020,117,66,51,3,80,34
63,080095,Argentona,2020,12536,6197,6339,1987,8287,2262
64,170118,"Armentera, l'",2020,951,478,473,172,582,197
65,430189,Arnes,2020,444,219,225,40,228,176
66,250313,Arres,2020,60,39,21,4,48,8
67,250328,Arsèguel,2020,81,46,35,14,52,15
68,080109,Artés,2020,5762,2911,2851,916,3785,1061
69,250334,Artesa de Lleida,2020,1535,816,719,190,1046,299
70,250349,Artesa de Segre,2020,3400,1756,1644,462,2193,745
71,430192,Ascó,2020,1644,844,800,196,1037,411
72,250365,Aspa,2020,220,115,105,20,127,73
73,250371,"Avellanes i Santa Linya, les",2020,433,249,184,47,235,151
74,080116,Avià,2020,2220,1113,1107,334,1425,461
75,080121,Avinyó,2020,2289,1137,1152,334,1456,499
76,170123,Avinyonet de Puigventós,2020,1641,818,823,294,1161,186
77,080137,Avinyonet del Penedès,2020,1697,899,798,224,1135,338
78,080155,Badalona,2020,223166,110018,113148,34096,146722,42348
79,089045,Badia del Vallès,2020,13415,6568,6847,2006,8573,2836
80,080168,Bagà,2020,2140,1061,1079,229,1321,590
81,250390,Baix Pallars,2020,331,180,151,38,214,79
82,250404,Balaguer,2020,17472,8953,8519,2984,11437,3051
83,080174,Balenyà,2020,3840,1921,1919,605,2583,652
84,080180,Balsareny,2020,3192,1576,1616,391,2069,732
85,430206,Banyeres del Penedès,2020,3207,1625,1582,553,2114,540
86,170157,Banyoles,2020,20053,9986,10067,3518,13073,3462
87,250411,Barbens,2020,878,468,410,108,557,213
88,430213,Barberà de la Conca,2020,471,260,211,65,287,119
89,082520,Barberà del Vallès,2020,33334,16395,16939,5541,22043,5750
90,080193,Barcelona,2020,1664182,790708,873474,204272,1107924,351986
91,250426,"Baronia de Rialb, la",2020,229,116,113,16,140,73
92,170160,Bàscara,2020,1001,521,480,149,634,218
93,250447,Bassella,2020,217,112,105,19,137,61
94,430228,Batea,2020,1901,949,952,265,1063,573
95,250450,Bausen,2020,60,30,30,2,31,27
96,080207,Begues,2020,7300,3650,3650,1353,4942,1005
97,170139,Begur,2020,3891,1955,1936,472,2580,839
98,250463,Belianes,2020,520,261,259,50,302,168
99,251706,Bellaguarda,2020,287,150,137,20,176,91
100,170182,Bellcaire d'Empordà,2020,678,325,353,98,431,149
101,250479,Bellcaire d'Urgell,2020,1199,607,592,147,733,319
102,250485,Bell-lloc d'Urgell,2020,2335,1159,1176,327,1524,484
103,250498,Bellmunt d'Urgell,2020,185,90,95,22,113,50
104,430234,Bellmunt del Priorat,2020,273,142,131,27,171,75
105,080214,Bellprat,2020,64,41,23,1,38,25
106,250501,Bellpuig,2020,5218,2774,2444,793,3484,941
107,430249,Bellvei,2020,2237,1162,1075,396,1459,382
108,250518,Bellver de Cerdanya,2020,2005,1035,970,282,1283,440
109,250523,Bellvís,2020,2260,1159,1101,300,1393,567
110,250539,Benavent de Segrià,2020,1518,806,712,219,1064,235
111,430252,Benifallet,2020,723,336,387,57,433,233
112,430265,Benissanet,2020,1140,630,510,133,730,277
113,080229,Berga,2020,16760,8315,8445,2349,10684,3727
114,170195,Besalú,2020,2487,1181,1306,404,1504,579
115,170209,Bescanó,2020,4991,2522,2469,946,3251,794
116,170216,Beuda,2020,186,99,87,34,130,22
117,080235,Bigues i Riells del Fai,2020,9358,4779,4579,1540,6400,1418
118,250557,Biosca,2020,177,94,83,10,103,64
119,170221,"Bisbal d'Empordà, la",2020,11159,5565,5594,1996,7298,1865
120,430271,"Bisbal de Falset, la",2020,211,116,95,26,119,66
121,430287,"Bisbal del Penedès, la",2020,3631,1918,1713,490,2389,752
122,172348,Biure,2020,241,125,116,23,146,72
123,430290,Blancafort,2020,382,200,182,40,241,101
124,170237,Blanes,2020,39914,19846,20068,5557,26755,7602
125,170293,Boadella i les Escaules,2020,272,137,135,31,181,60
126,170242,Bolvir,2020,375,197,178,44,255,76
127,430304,Bonastre,2020,685,359,326,115,456,114
128,250576,"Bòrdes, Es",2020,255,142,113,34,175,46
129,170255,Bordils,2020,1761,885,876,283,1175,303
130,250582,"Borges Blanques, les",2020,6173,3152,3021,959,3877,1337
131,430311,"Borges del Camp, les",2020,2056,1053,1003,345,1314,397
132,170268,Borrassà,2020,733,380,353,138,460,135
133,080240,Borredà,2020,464,257,207,40,300,124
134,250595,Bossòst,2020,1115,544,571,145,764,206
135,430326,Bot,2020,554,284,270,46,306,202
136,430332,Botarell,2020,1077,552,525,184,747,146
137,250560,Bovera,2020,248,138,110,20,133,95
138,430347,Bràfim,2020,695,355,340,123,412,160
139,170274,Breda,2020,3762,1842,1920,505,2440,817
140,080253,"Bruc, el",2020,2110,1128,982,377,1454,279
141,080266,"Brull, el",2020,258,142,116,51,167,40
142,170280,Brunyola i Sant Martí Sapresa,2020,389,203,186,47,247,95
143,430350,Cabacés,2020,302,162,140,41,177,84
144,250609,Cabanabona,2020,71,34,37,2,46,23
145,170314,Cabanelles,2020,267,150,117,43,163,61
146,170307,Cabanes,2020,968,520,448,136,618,214
147,080272,"Cabanyes, les",2020,979,499,480,182,658,139
148,250616,Cabó,2020,93,50,43,8,56,29
149,430363,Cabra del Camp,2020,1175,613,562,152,792,231
150,080288,Cabrera d'Anoia,2020,1482,795,687,219,1051,212
151,080291,Cabrera de Mar,2020,4747,2381,2366,711,3201,835
152,080305,Cabrils,2020,7432,3667,3765,1209,5110,1113
153,170329,Cadaqués,2020,2695,1300,1395,346,1859,490
154,080312,Calaf,2020,3656,1843,1813,657,2237,762
155,430379,Calafell,2020,27601,13887,13714,4045,18064,5492
156,080348,Calders,2020,1045,530,515,158,707,180
157,080327,Caldes d'Estrac,2020,3021,1442,1579,402,1998,621
158,170335,Caldes de Malavella,2020,7872,3935,3937,1326,5237,1309
159,080333,Caldes de Montbui,2020,17812,8873,8939,2752,11784,3276
160,080351,Calella,2020,19277,9399,9878,2713,12554,4010
161,080370,Calldetenes,2020,2513,1281,1232,397,1662,454
162,080386,Callús,2020,2129,1053,1076,368,1390,371
163,080364,Calonge de Segarra,2020,188,92,96,19,115,54
164,170340,Calonge i Sant Antoni,2020,11331,5681,5650,1624,7446,2261
165,250621,Camarasa,2020,810,406,404,88,467,255
166,439039,Camarles,2020,3194,1617,1577,430,1982,782
167,430385,Cambrils,2020,34734,16990,17744,5902,23082,5750
168,170353,Camós,2020,677,340,337,92,409,176
169,170366,Campdevànol,2020,3232,1560,1672,408,1955,869
170,170372,Campelles,2020,140,73,67,10,94,36
171,080399,Campins,2020,541,283,258,75,382,84
172,170388,Campllong,2020,537,264,273,116,359,62
173,170391,Camprodon,2020,2298,1124,1174,272,1411,615
174,250637,Canejan,2020,89,45,44,6,62,21
175,170405,Canet d'Adri,2020,729,382,347,123,448,158
176,080403,Canet de Mar,2020,14865,7294,7571,2185,9518,3162
177,439076,"Canonja, la",2020,5956,2912,3044,1052,3986,918
178,080410,Canovelles,2020,16829,8693,8136,3022,11190,2617
179,080425,Cànoves i Samalús,2020,3156,1611,1545,514,2108,534
180,170412,Cantallops,2020,309,153,156,41,184,84
181,080431,Canyelles,2020,4699,2430,2269,753,3232,714
182,430398,Capafonts,2020,111,58,53,9,72,30
183,430402,Capçanes,2020,392,197,195,41,240,111
184,080446,Capellades,2020,5342,2665,2677,769,3425,1148
185,170427,Capmany,2020,611,305,306,80,390,141
186,080459,Capolat,2020,84,39,45,18,50,16
187,080462,Cardedeu,2020,18424,8975,9449,3252,12220,2952
188,080478,Cardona,2020,4639,2266,2373,591,2790,1258
189,080484,Carme,2020,785,411,374,115,499,171
190,430419,Caseres,2020,237,117,120,18,131,88
191,170448,Cassà de la Selva,2020,10410,5293,5117,1789,6905,1716
192,080497,Casserres,2020,1588,803,785,219,944,425
193,080575,Castell de l'Areny,2020,67,37,30,6,50,11
194,259046,Castell de Mur,2020,173,96,77,14,101,58
195,250642,Castellar de la Ribera,2020,131,66,65,26,72,33
196,080522,Castellar de n'Hug,2020,156,84,72,11,106,39
197,080500,Castellar del Riu,2020,176,99,77,31,109,36
198,080517,Castellar del Vallès,2020,24488,12089,12399,3926,16462,4100
199,080538,Castellbell i el Vilar,2020,3719,1901,1818,541,2476,702
200,080543,Castellbisbal,2020,12539,6307,6232,2223,8610,1706
201,080556,Castellcir,2020,742,397,345,132,510,100
202,250674,Castelldans,2020,930,497,433,111,601,218
203,080569,Castelldefels,2020,67460,33162,34298,10803,46551,10106
204,080581,Castellet i la Gornal,2020,2382,1239,1143,332,1584,466
205,170464,Castellfollit de la Roca,2020,947,488,459,134,566,247
206,080608,Castellfollit de Riubregós,2020,162,91,71,14,97,51
207,080594,Castellfollit del Boix,2020,447,228,219,73,282,92
208,080615,Castellgalí,2020,2119,1102,1017,373,1347,399
209,080620,Castellnou de Bages,2020,1437,770,667,260,994,183
210,250680,Castellnou de Seana,2020,665,354,311,90,380,195
211,170470,Castelló d'Empúries,2020,11100,5604,5496,1731,7337,2032
212,250693,Castelló de Farfanya,2020,539,291,248,66,328,145
213,080636,Castellolí,2020,626,302,324,124,396,106
214,170486,Castell-Platja d'Aro,2020,11030,5426,5604,1565,7303,2162
215,250707,Castellserà,2020,996,505,491,118,597,281
216,080641,Castellterçol,2020,2548,1275,1273,324,1632,592
217,430424,Castellvell del Camp,2020,2828,1417,1411,445,1957,426
218,080654,Castellví de la Marca,2020,1575,795,780,213,1018,344
219,080667,Castellví de Rosanes,2020,1933,949,984,306,1328,299
220,430430,"Catllar, el",2020,4557,2366,2191,759,3114,684
221,250714,Cava,2020,45,29,16,3,27,15
222,171899,"Cellera de Ter, la",2020,1950,959,991,279,1215,456
223,170499,Celrà,2020,5561,2796,2765,1164,3814,583
224,080673,Centelles,2020,7513,3696,3817,1169,4883,1461
225,082687,Cercs,2020,1150,568,582,119,701,330
226,082665,Cerdanyola del Vallès,2020,57855,28284,29571,7967,38574,11314
227,080689,Cervelló,2020,9077,4571,4506,1476,6019,1582
228,250729,Cervera,2020,9350,4778,4572,1559,6261,1530
229,250735,Cervià de les Garrigues,2020,662,350,312,65,393,204
230,170502,Cervià de Ter,2020,966,494,472,169,625,172
231,170519,Cistella,2020,282,137,145,37,183,62
232,250740,Ciutadilla,2020,208,111,97,24,119,65
233,250753,Clariana de Cardener,2020,161,86,75,21,110,30
234,250766,"Cogul, el",2020,151,83,68,7,88,56
235,170545,Colera,2020,445,217,228,33,267,145
236,250772,Coll de Nargó,2020,540,277,263,59,325,156
237,080692,Collbató,2020,4544,2359,2185,795,3116,633
238,430458,Colldejou,2020,168,93,75,18,106,44
239,080706,Collsuspina,2020,359,183,176,69,220,70
240,170558,Colomers,2020,174,84,90,18,107,49
241,251636,"Coma i la Pedra, la",2020,255,151,104,23,179,53
242,251615,Conca de Dalt,2020,410,209,201,50,226,134
243,430461,Conesa,2020,100,50,50,8,63,29
244,430477,Constantí,2020,6665,3445,3220,1256,4436,973
245,080713,Copons,2020,321,157,164,59,188,74
246,430483,Corbera d'Ebre,2020,1003,529,474,106,623,274
247,080728,Corbera de Llobregat,2020,14882,7454,7428,2411,10300,2171
248,250788,Corbins,2020,1462,811,651,229,944,289
249,170577,Corçà,2020,1268,642,626,205,767,296
250,080734,Cornellà de Llobregat,2020,89936,43622,46314,13073,58892,17971
251,170561,Cornellà del Terri,2020,2399,1215,1184,403,1524,472
252,430496,Cornudella de Montsant,2020,944,501,443,97,636,211
253,430509,Creixell,2020,3758,1895,1863,541,2339,878
254,170583,Crespià,2020,254,127,127,34,161,59
255,179011,"Cruïlles, Monells i Sant Sadurní de l'Heura",2020,1270,632,638,176,837,257
256,080749,Cubelles,2020,15770,7944,7826,2598,10478,2694
257,250791,Cubells,2020,338,179,159,26,202,110
258,430516,Cunit,2020,13533,6650,6883,2001,8476,3056
259,170600,Darnius,2020,537,272,265,56,340,141
260,170617,Das,2020,234,121,113,44,150,40
261,439018,Deltebre,2020,11578,5849,5729,1598,7414,2566
262,080752,Dosrius,2020,5652,2881,2771,949,3931,772
263,430537,Duesaigües,2020,244,138,106,31,160,53
264,170622,"Escala, l'",2020,10244,5187,5057,1384,6564,2296
265,080765,Esparreguera,2020,22302,11273,11029,3486,15065,3751
266,170638,Espinelves,2020,221,112,109,31,144,46
267,250812,"Espluga Calba, l'",2020,329,168,161,32,182,115
268,430542,"Espluga de Francolí, l'",2020,3736,1830,1906,494,2406,836
269,080771,Esplugues de Llobregat,2020,47150,22461,24689,6533,29710,10907
270,170643,Espolla,2020,412,204,208,46,240,126
271,170656,Esponellà,2020,463,234,229,86,264,113
272,250827,Espot,2020,366,197,169,39,257,70
273,080787,"Espunyola, l'",2020,242,120,122,27,152,63
274,082541,"Esquirol, l'",2020,2186,1098,1088,276,1392,518
275,250886,Estamariu,2020,125,72,53,17,69,39
276,080790,"Estany, l'",2020,408,215,193,51,238,119
277,250851,Estaràs,2020,156,79,77,17,89,50
278,250864,Esterri d'Àneu,2020,804,382,422,102,576,126
279,250870,Esterri de Cardós,2020,64,34,30,10,42,12
280,430555,Falset,2020,2735,1359,1376,429,1695,611
281,170059,"Far d'Empordà, el",2020,602,311,291,101,393,108
282,250899,Farrera,2020,108,63,45,12,70,26
283,430568,"Fatarella, la",2020,926,451,475,85,513,328
284,430574,"Febró, la",2020,40,25,15,0,27,13
285,081347,Figaró-Montmany,2020,1142,559,583,163,756,223
286,080804,Fígols,2020,43,26,17,3,27,13
287,259084,Fígols i Alinyà,2020,244,140,104,21,148,75
288,430580,"Figuera, la",2020,114,62,52,6,69,39
289,170669,Figueres,2020,47235,23363,23872,8339,31548,7348
290,430593,Figuerola del Camp,2020,329,164,165,51,210,68
291,170675,Flaçà,2020,1130,551,579,183,720,227
292,430607,Flix,2020,3410,1723,1687,343,2095,972
293,250925,"Floresta, la",2020,140,76,64,8,92,40
294,080826,Fogars de la Selva,2020,1469,757,712,178,1004,287
295,080811,Fogars de Montclús,2020,475,249,226,91,304,80
296,170681,Foixà,2020,303,151,152,26,184,93
297,080832,Folgueroles,2020,2265,1150,1115,417,1476,372
298,250931,Fondarella,2020,776,388,388,107,514,155
299,080847,Fonollosa,2020,1459,752,707,200,962,297
300,170694,Fontanals de Cerdanya,2020,437,212,225,50,280,107
301,170708,Fontanilles,2020,146,81,65,17,90,39
302,170715,Fontcoberta,2020,1469,732,737,252,956,261
303,080850,Font-rubí,2020,1414,744,670,201,908,305
304,250946,Foradada,2020,203,132,71,25,124,54
305,179026,Forallac,2020,1695,827,868,238,1090,367
306,430614,Forès,2020,43,26,17,1,21,21
307,170736,Fornells de la Selva,2020,2670,1333,1337,520,1790,360
308,170741,Fortià,2020,787,395,392,111,518,158
309,080863,"Franqueses del Vallès, les",2020,20364,10331,10033,3799,13751,2814
310,430629,Freginals,2020,385,206,179,27,253,105
311,250962,"Fuliola, la",2020,1250,620,630,204,754,292
312,250978,Fulleda,2020,102,53,49,3,63,36
313,080902,Gaià,2020,183,98,85,28,123,32
314,430635,"Galera, la",2020,736,382,354,88,438,210
315,080879,Gallifa,2020,167,89,78,15,114,38
316,430640,Gandesa,2020,3096,1589,1507,456,1936,704
317,430653,Garcia,2020,527,259,268,66,318,143
318,430666,"Garidells, els",2020,190,96,94,21,135,34
319,080885,"Garriga, la",2020,16668,8056,8612,2708,11117,2843
320,170754,Garrigàs,2020,451,234,217,71,299,81
321,170767,Garrigoles,2020,167,88,79,28,103,36
322,170773,Garriguella,2020,853,425,428,131,531,191
323,080898,Gavà,2020,47057,23022,24035,7485,31218,8354
324,250984,Gavet de la Conca,2020,261,131,130,19,147,95
325,080919,Gelida,2020,7670,3842,3828,1329,5147,1194
326,170789,Ger,2020,449,222,227,80,280,89
327,259123,Gimenells i el Pla de la Font,2020,1120,600,520,152,707,261
328,430672,Ginestar,2020,764,407,357,69,461,234
329,170792,Girona,2020,103369,49809,53560,16601,70380,16388
330,080924,Gironella,2020,4946,2461,2485,733,2950,1263
331,080930,Gisclareny,2020,26,16,10,2,18,6
332,430688,Godall,2020,598,296,302,62,339,197
333,250997,Golmés,2020,1855,940,915,311,1214,330
334,170806,Gombrèn,2020,192,95,97,35,113,44
335,251001,Gósol,2020,206,118,88,17,130,59
336,080945,"Granada, la",2020,2208,1097,1111,385,1484,339
337,251018,"Granadella, la",2020,716,392,324,82,425,209
338,080958,Granera,2020,77,52,25,5,54,18
339,251023,"Granja d'Escarp, la",2020,922,509,413,102,589,231
340,080961,Granollers,2020,62419,30891,31528,9262,41929,11228
341,251039,Granyanella,2020,143,80,63,9,88,46
342,251057,Granyena de les Garrigues,2020,140,85,55,15,83,42
343,251044,Granyena de Segarra,2020,151,82,69,19,81,51
344,430691,Gratallops,2020,237,128,109,16,155,66
345,080977,Gualba,2020,1548,794,754,310,1020,218
346,170813,Gualta,2020,402,234,168,64,264,74
347,080996,Guardiola de Berguedà,2020,941,492,449,100,605,236
348,430705,"Guiamets, els",2020,278,133,145,21,167,90
349,170828,Guils de Cerdanya,2020,549,294,255,76,368,105
350,251095,Guimerà,2020,271,141,130,26,145,100
351,259031,"Guingueta d'Àneu, la",2020,289,156,133,29,183,77
352,251109,Guissona,2020,7248,3893,3355,1378,5167,703
353,251116,Guixers,2020,132,80,52,12,77,43
354,081000,Gurb,2020,2713,1399,1314,434,1821,458
355,430712,Horta de Sant Joan,2020,1146,599,547,130,678,338
356,081017,"Hospitalet de Llobregat, l'",2020,269382,130289,139093,37495,178121,53766
357,081629,"Hostalets de Pierola, els",2020,2980,1518,1462,503,2054,423
358,170834,Hostalric,2020,4291,2158,2133,740,2800,751
359,081022,Igualada,2020,40742,20073,20669,6643,25983,8116
360,251155,Isona i Conca Dellà,2020,1042,562,480,113,602,327
361,170849,Isòvol,2020,281,163,118,42,177,62
362,251137,Ivars d'Urgell,2020,1537,806,731,205,884,448
363,251121,Ivars de Noguera,2020,332,173,159,39,204,89
364,251142,Ivorra,2020,108,59,49,2,70,36
365,170852,Jafre,2020,387,209,178,49,233,105
366,170865,"Jonquera, la",2020,3320,1661,1659,573,2255,492
367,081038,Jorba,2020,833,429,404,135,586,112
368,259101,Josa i Tuixén,2020,103,59,44,5,67,31
369,170871,Juià,2020,319,163,156,50,211,58
370,251180,Juncosa,2020,395,206,189,34,247,114
371,251193,Juneda,2020,3501,1877,1624,519,2217,765
372,251214,Les,2020,971,464,507,140,698,133
373,251229,Linyola,2020,2717,1367,1350,396,1745,576
374,081043,"Llacuna, la",2020,903,493,410,114,563,226
375,170887,Lladó,2020,844,411,433,172,539,133
376,251235,Lladorre,2020,237,119,118,26,149,62
377,251240,Lladurs,2020,180,95,85,19,109,52
378,081056,"Llagosta, la",2020,13587,6691,6896,2119,8872,2596
379,170890,Llagostera,2020,8647,4373,4274,1482,5695,1470
380,170904,Llambilles,2020,713,366,347,109,475,129
381,170911,Llanars,2020,535,274,261,70,324,141
382,170926,Llançà,2020,4775,2353,2422,632,3070,1073
383,251253,Llardecans,2020,444,237,207,38,254,152
384,251266,Llavorsí,2020,346,176,170,39,232,75
385,251207,Lleida,2020,140403,69541,70862,21505,93644,25254
386,170932,Llers,2020,1237,609,628,174,800,263
387,251272,Lles de Cerdanya,2020,270,157,113,31,169,70
388,081075,Lliçà d'Amunt,2020,15469,7906,7563,2424,10480,2565
389,081081,Lliçà de Vall,2020,6497,3319,3178,951,4317,1229
390,251288,Llimiana,2020,146,86,60,15,84,47
391,081069,Llinars del Vallès,2020,10018,4991,5027,1448,6758,1812
392,170947,Llívia,2020,1431,745,686,191,980,260
393,430727,"Lloar, el",2020,105,56,49,12,65,28
394,251291,Llobera,2020,188,107,81,25,107,56
395,430733,Llorac,2020,91,48,43,7,60,24
396,430748,Llorenç del Penedès,2020,2395,1180,1215,373,1529,493
397,170950,Lloret de Mar,2020,39089,19926,19163,6009,27334,5746
398,170963,"Llosses, les",2020,212,121,91,34,145,33
399,081094,Lluçà,2020,276,135,141,53,180,43
400,171024,Maçanet de Cabrenys,2020,698,352,346,66,425,207
401,171030,Maçanet de la Selva,2020,7066,3636,3430,1050,4718,1298
402,170979,Madremanya,2020,288,137,151,52,178,58
403,170985,Maià de Montcal,2020,463,260,203,60,306,97
404,251333,Maials,2020,909,500,409,86,559,264
405,251305,Maldà,2020,227,109,118,22,131,74
406,081108,Malgrat de Mar,2020,18772,9329,9443,2613,12244,3915
407,081115,Malla,2020,272,138,134,43,171,58
408,081120,Manlleu,2020,20912,10512,10400,3602,13646,3664
409,081136,Manresa,2020,78245,38335,39910,12450,50293,15502
410,430764,Marçà,2020,600,312,288,79,389,132
411,430751,Margalef,2020,106,63,43,9,65,32
412,082423,Marganell,2020,266,127,139,24,177,65
413,081141,Martorell,2020,28772,14655,14117,4862,19195,4715
414,081154,Martorelles,2020,4820,2435,2385,685,3160,975
415,430770,Mas de Barberans,2020,564,281,283,50,329,185
416,171002,Masarac,2020,288,150,138,33,201,54
417,430786,Masdenverge,2020,1071,546,525,136,669,266
418,081167,"Masies de Roda, les",2020,719,368,351,104,456,159
419,081173,"Masies de Voltregà, les",2020,3132,1549,1583,429,2098,605
420,430799,Masllorenç,2020,505,274,231,68,336,101
421,081189,"Masnou, el",2020,23831,11524,12307,3437,15700,4694
422,430803,"Masó, la",2020,280,148,132,39,158,83
423,430810,Maspujols,2020,823,421,402,147,554,122
424,081192,Masquefa,2020,9402,4758,4644,1598,6481,1323
425,430825,"Masroig, el",2020,492,273,219,49,304,139
426,251312,Massalcoreig,2020,610,354,256,50,423,137
427,171019,Massanes,2020,796,420,376,154,471,171
428,251327,Massoteres,2020,212,117,95,36,142,34
429,081206,Matadepera,2020,9496,4756,4740,1678,6207,1611
430,081213,Mataró,2020,129661,64476,65185,20736,86035,22890
431,081228,Mediona,2020,2369,1192,1177,389,1493,487
432,251348,Menàrguens,2020,813,445,368,79,531,203
433,170998,Meranges,2020,100,55,45,15,67,18
434,171058,Mieres,2020,345,176,169,48,218,79
435,430831,"Milà, el",2020,190,91,99,30,120,40
436,251351,Miralcamp,2020,1385,717,668,234,855,296
437,430846,Miravet,2020,706,375,331,98,413,195
438,081385,Moià,2020,6383,3281,3102,969,4289,1125
439,430859,"Molar, el",2020,291,155,136,19,176,96
440,081234,Molins de Rei,2020,25940,12639,13301,4353,17111,4476
441,251370,Mollerussa,2020,14649,7524,7125,2635,9906,2108
442,171061,Mollet de Peralada,2020,198,104,94,32,106,60
443,081249,Mollet del Vallès,2020,51600,25410,26190,7801,34752,9047
444,171077,Molló,2020,336,166,170,47,192,97
445,251364,"Molsosa, la",2020,104,51,53,6,65,33
446,081287,Monistrol de Calders,2020,702,366,336,82,459,161
447,081271,Monistrol de Montserrat,2020,3139,1603,1536,492,2043,604
448,171096,Montagut i Oix,2020,930,481,449,126,631,173
449,430862,Montblanc,2020,7379,3742,3637,1122,4857,1400
450,430884,Montbrió del Camp,2020,2909,1499,1410,575,1890,444
451,081252,Montcada i Reixac,2020,36803,18148,18655,6125,25110,5568
452,081304,Montclar,2020,139,72,67,26,83,30
453,251399,Montellà i Martinet,2020,578,318,260,58,379,141
454,081311,Montesquiu,2020,1030,513,517,173,638,219
455,251403,Montferrer i Castellbò,2020,1034,559,475,176,640,218
456,430897,Montferri,2020,403,210,193,70,254,79
457,251386,Montgai,2020,643,342,301,56,372,215
458,081265,Montgat,2020,12200,6029,6171,2096,8205,1899
459,081326,Montmajor,2020,469,232,237,82,262,125
460,081332,Montmaneu,2020,151,81,70,13,89,49
461,430901,"Montmell, el",2020,1582,842,740,221,1065,296
462,081350,Montmeló,2020,8831,4320,4511,1249,5860,1722
463,251425,Montoliu de Lleida,2020,483,253,230,57,303,123
464,251410,Montoliu de Segarra,2020,187,102,85,16,114,57
465,251431,Montornès de Segarra,2020,96,46,50,8,51,37
466,081363,Montornès del Vallès,2020,16644,8390,8254,2948,11104,2592
467,430918,Mont-ral,2020,168,99,69,20,112,36
468,171100,Mont-ras,2020,1680,851,829,196,1120,364
469,430923,Mont-roig del Camp,2020,12460,6423,6037,1895,8301,2264
470,081379,Montseny,2020,351,187,164,54,222,75
471,430939,Móra d'Ebre,2020,5695,2874,2821,871,3714,1110
472,430944,Móra la Nova,2020,3108,1567,1541,430,2035,643
473,430957,"Morell, el",2020,3742,1917,1825,660,2602,480
474,430960,"Morera de Montsant, la",2020,159,87,72,20,106,33
475,081290,Muntanyola,2020,632,328,304,102,436,94
476,081398,Mura,2020,220,117,103,33,135,52
477,251459,Nalec,2020,90,46,44,7,45,38
478,250254,Naut Aran,2020,1836,953,883,253,1316,267
479,081402,Navarcles,2020,6057,2958,3099,797,3936,1324
480,081419,Navàs,2020,6018,2987,3031,912,3839,1267
481,171117,Navata,2020,1427,692,735,242,928,257
482,251462,Navès,2020,284,146,138,41,184,59
483,081424,"Nou de Berguedà, la",2020,162,84,78,16,94,52
484,430976,"Nou de Gaià, la",2020,600,294,306,129,369,102
485,430982,Nulles,2020,509,274,235,106,300,103
486,251484,Odèn,2020,258,152,106,20,160,78
487,081430,Òdena,2020,3668,1881,1787,663,2403,602
488,171122,Ogassa,2020,240,132,108,30,159,51
489,081458,Olèrdola,2020,3768,1955,1813,632,2516,620
490,081461,Olesa de Bonesvalls,2020,1840,968,872,291,1259,290
491,081477,Olesa de Montserrat,2020,24144,12058,12086,4186,16022,3936
492,251497,Oliana,2020,1843,918,925,214,1102,527
493,251500,Oliola,2020,203,109,94,21,131,51
494,251517,Olius,2020,981,527,454,200,616,165
495,081483,Olivella,2020,3935,2054,1881,747,2677,511
496,081496,Olost,2020,1202,586,616,149,752,301
497,171143,Olot,2020,35926,17989,17937,5226,23723,6977
498,251522,"Oluges, les",2020,171,90,81,15,95,61
499,081445,Olvan,2020,858,419,439,98,540,220
500,251538,"Omellons, els",2020,206,110,96,17,112,77
501,251543,"Omells de na Gaia, els",2020,130,74,56,6,87,37
502,171156,Ordis,2020,361,193,168,50,232,79
503,251556,Organyà,2020,771,387,384,88,460,223
504,081509,Orís,2020,322,164,158,44,228,50
505,081516,Oristà,2020,549,282,267,62,327,160
506,081521,Orpí,2020,151,79,72,28,99,24
507,081537,Òrrius,2020,758,387,371,133,514,111
508,251569,Os de Balaguer,2020,980,501,479,137,637,206
509,171169,Osor,2020,428,232,196,46,285,97
510,251575,Ossó de Sió,2020,203,97,106,25,122,56
511,081542,Pacs del Penedès,2020,918,463,455,146,608,164
512,081555,Palafolls,2020,9613,4814,4799,1686,6587,1340
513,171175,Palafrugell,2020,23244,11531,11713,3886,15138,4220
514,171181,Palamós,2020,18135,8873,9262,2438,11981,3716
515,251581,"Palau d'Anglesola, el",2020,2166,1071,1095,348,1405,413
516,171194,Palau de Santa Eulàlia,2020,90,51,39,12,52,26
517,171215,Palau-sator,2020,310,169,141,49,186,75
518,171208,Palau-saverdera,2020,1456,738,718,249,881,326
519,081568,Palau-solità i Plegamans,2020,14892,7289,7603,2333,10045,2514
520,431009,"Pallaresos, els",2020,4850,2423,2427,949,3333,568
521,081574,Pallejà,2020,11622,5794,5828,2021,7749,1852
522,430995,"Palma d'Ebre, la",2020,338,165,173,24,182,132
523,089058,"Palma de Cervelló, la",2020,2992,1475,1517,450,2046,496
524,171236,Palol de Revardit,2020,448,223,225,70,278,100
525,171241,Pals,2020,2395,1232,1163,319,1547,529
526,081580,"Papiol, el",2020,4172,2063,2109,692,2809,671
527,171254,Pardines,2020,169,90,79,22,106,41
528,081593,Parets del Vallès,2020,19071,9518,9553,3198,12875,2998
529,171267,Parlavà,2020,391,196,195,56,233,102
530,431016,Passanant i Belltall,2020,155,94,61,4,91,60
531,171289,Pau,2020,557,280,277,66,351,140
532,431021,Paüls,2020,545,273,272,63,293,189
533,171292,Pedret i Marzà,2020,191,97,94,32,124,35
534,251641,Penelles,2020,436,255,181,46,267,123
535,171306,"Pera, la",2020,435,217,218,67,269,99
536,081607,Perafita,2020,405,208,197,49,250,106
537,431037,Perafort,2020,1264,659,605,251,854,159
538,171328,Peralada,2020,1898,937,961,260,1247,391
539,251654,Peramola,2020,347,173,174,32,215,100
540,431042,"Perelló, el",2020,2826,1442,1384,412,1664,750
541,081614,Piera,2020,16134,8253,7881,2575,10850,2709
542,431055,"Piles, les",2020,210,114,96,40,128,42
543,081635,Pineda de Mar,2020,27984,13940,14044,3943,18156,5885
544,431068,"Pinell de Brai, el",2020,1008,513,495,101,606,301
545,251667,Pinell de Solsonès,2020,193,113,80,16,120,57
546,251673,Pinós,2020,286,152,134,39,173,74
547,431074,Pira,2020,503,270,233,71,331,101
548,431080,"Pla de Santa Maria, el",2020,2348,1229,1119,332,1548,468
549,081640,"Pla del Penedès, el",2020,1275,638,637,233,826,216
550,171334,"Planes d'Hostoles, les",2020,1712,866,846,239,1013,460
551,171349,Planoles,2020,304,165,139,41,183,80
552,259118,"Plans de Sió, els",2020,491,266,225,42,304,145
553,251689,"Poal, el",2020,670,350,320,84,420,166
554,251692,"Pobla de Cérvoles, la",2020,189,104,85,9,118,62
555,081653,"Pobla de Claramunt, la",2020,2185,1110,1075,365,1389,431
556,081666,"Pobla de Lillet, la",2020,1093,531,562,79,622,392
557,431093,"Pobla de Mafumet, la",2020,3971,2017,1954,844,2803,324
558,431107,"Pobla de Massaluca, la",2020,317,180,137,31,180,106
559,431114,"Pobla de Montornès, la",2020,2884,1503,1381,449,1857,578
560,251713,"Pobla de Segur, la",2020,3043,1515,1528,417,1838,788
561,431129,Poboleda,2020,321,166,155,39,197,85
562,081672,Polinyà,2020,8504,4320,4184,1713,5850,941
563,431135,"Pont d'Armentera, el",2020,488,249,239,49,291,148
564,250306,"Pont de Bar, el",2020,152,91,61,18,94,40
565,171352,Pont de Molins,2020,516,261,255,65,341,110
566,251734,"Pont de Suert, el",2020,2257,1128,1129,329,1456,472
567,081825,"Pont de Vilomara i Rocafort, el",2020,3907,2007,1900,621,2593,693
568,431418,Pontils,2020,122,66,56,9,72,41
569,081688,Pontons,2020,528,283,245,65,363,100
570,171365,Pontós,2020,260,141,119,41,164,55
571,251728,Ponts,2020,2644,1337,1307,370,1705,569
572,171371,Porqueres,2020,4677,2304,2373,759,3071,847
573,431140,Porrera,2020,424,223,201,39,287,98
574,171404,"Port de la Selva, el",2020,958,497,461,114,579,265
575,171387,Portbou,2020,1063,521,542,82,608,373
576,251749,"Portella, la",2020,743,423,320,84,516,143
577,431153,Pradell de la Teixeta,2020,158,74,84,12,103,43
578,431166,Prades,2020,588,311,277,69,364,155
579,431172,Prat de Comte,2020,177,97,80,15,104,58
580,081691,"Prat de Llobregat, el",2020,65385,31951,33434,10012,42700,12673
581,431188,Pratdip,2020,726,388,338,78,414,234
582,081712,Prats de Lluçanès,2020,2604,1305,1299,338,1667,599
583,081705,"Prats de Rei, els",2020,537,286,251,75,340,122
584,251752,Prats i Sansor,2020,222,116,106,21,152,49
585,251765,Preixana,2020,387,200,187,48,222,117
586,251771,Preixens,2020,418,211,207,52,222,144
587,082303,Premià de Dalt,2020,10441,5201,5240,1686,6845,1910
588,081727,Premià de Mar,2020,28531,13913,14618,4173,18619,5739
589,171390,"Preses, les",2020,1855,921,934,321,1200,334
590,251790,Prullans,2020,226,104,122,30,144,52
591,171411,Puigcerdà,2020,9486,4712,4774,1399,6607,1480
592,081748,Puigdàlber,2020,524,249,275,101,334,89
593,251804,Puiggròs,2020,278,142,136,31,175,72
594,431191,Puigpelat,2020,1163,604,559,214,821,128
595,081751,Puig-reig,2020,4295,2135,2160,530,2671,1094
596,251811,Puigverd d'Agramunt,2020,229,131,98,17,151,61
597,251826,Puigverd de Lleida,2020,1349,694,655,198,884,267
598,081764,Pujalt,2020,210,118,92,34,123,53
599,081770,"Quar, la",2020,49,26,23,9,25,15
600,171426,Quart,2020,3798,1910,1888,811,2459,528
601,170433,Queralbs,2020,188,98,90,10,128,50
602,431205,Querol,2020,518,285,233,63,328,127
603,171432,Rabós,2020,184,92,92,23,111,50
604,081786,Rajadell,2020,534,273,261,69,347,118
605,431212,Rasquera,2020,783,388,395,87,445,251
606,171447,Regencós,2020,276,150,126,33,175,68
607,081799,Rellinars,2020,809,417,392,132,549,128
608,431227,Renau,2020,162,85,77,34,116,12
609,431233,Reus,2020,106168,51335,54833,17795,69245,19128
610,251832,Rialp,2020,641,319,322,72,459,110
611,431248,"Riba, la",2020,585,319,266,60,359,166
612,431251,Riba-roja d'Ebre,2020,1110,583,527,108,660,342
613,259059,Ribera d'Ondara,2020,433,215,218,49,262,122
614,251850,Ribera d'Urgellet,2020,932,480,452,135,614,183
615,171450,Ribes de Freser,2020,1760,883,877,172,1096,492
616,171463,Riells i Viabrea,2020,4153,2110,2043,586,2923,644
617,431264,"Riera de Gaià, la",2020,1742,874,868,352,1120,270
618,251863,Riner,2020,263,133,130,41,153,69
619,171479,Ripoll,2020,10803,5369,5434,1486,6813,2504
620,081803,Ripollet,2020,39179,19396,19783,6818,26362,5999
621,259139,Riu de Cerdanya,2020,93,55,38,5,67,21
622,171485,Riudarenes,2020,2204,1134,1070,347,1451,406
623,171498,Riudaura,2020,481,230,251,89,307,85
624,431270,Riudecanyes,2020,1146,611,535,179,757,210
625,431286,Riudecols,2020,1189,617,572,150,807,232
626,171501,Riudellots de la Selva,2020,2071,1055,1016,335,1382,354
627,431299,Riudoms,2020,6569,3352,3217,1089,4180,1300
628,171518,Riumors,2020,246,121,125,32,152,62
629,081810,"Roca del Vallès, la",2020,10754,5356,5398,1802,7258,1694
630,431303,Rocafort de Queralt,2020,211,114,97,22,119,70
631,431310,Roda de Berà,2020,6785,3463,3322,1021,4309,1455
632,081831,Roda de Ter,2020,6490,3235,3255,1057,4298,1135
633,431325,Rodonyà,2020,494,265,229,63,333,98
634,431331,Roquetes,2020,8079,4170,3909,1286,5347,1446
635,171523,Roses,2020,19807,10016,9791,3126,13102,3579
636,251898,Rosselló,2020,3237,1663,1574,546,2219,472
637,431346,"Rourell, el",2020,372,193,179,57,250,65
638,081846,Rubí,2020,78591,38889,39702,13044,53201,12346
639,081859,Rubió,2020,239,134,105,30,148,61
640,171539,Rupià,2020,273,140,133,44,159,70
641,089019,Rupit i Pruit,2020,271,132,139,24,156,91
642,081878,Sabadell,2020,216520,105388,111132,34121,141918,40481
643,081884,Sagàs,2020,145,77,68,23,97,25
644,251902,Salàs de Pallars,2020,327,174,153,36,196,95
645,081901,Saldes,2020,278,159,119,14,171,93
646,171544,Sales de Llierca,2020,159,82,77,26,112,21
647,081918,Sallent,2020,6735,3260,3475,913,4087,1735
648,431359,Salomó,2020,549,286,263,92,344,113
649,439057,Salou,2020,28526,14736,13790,4403,20384,3739
650,171557,Salt,2020,32138,16920,15218,6574,21598,3966
651,251919,Sanaüja,2020,379,198,181,33,226,120
652,081944,Sant Adrià de Besòs,2020,37447,18369,19078,6083,24889,6475
653,081957,Sant Agustí de Lluçanès,2020,89,44,45,10,57,22
654,081960,Sant Andreu de la Barca,2020,27569,13644,13925,4907,18457,4205
655,081976,Sant Andreu de Llavaneres,2020,11133,5513,5620,1729,7455,1949
656,171576,Sant Andreu Salou,2020,160,78,82,24,101,35
657,171833,Sant Aniol de Finestres,2020,345,180,165,51,225,69
658,081982,Sant Antoni de Vilamajor,2020,6208,3066,3142,1030,4207,971
659,081995,Sant Bartomeu del Grau,2020,884,475,409,133,574,177
660,082009,Sant Boi de Llobregat,2020,84500,41235,43265,12792,55453,16255
661,082016,Sant Boi de Lluçanès,2020,580,293,287,58,323,199
662,431362,Sant Carles de la Ràpita,2020,14953,7316,7637,1958,9617,3378
663,082037,Sant Cebrià de Vallalta,2020,3438,1791,1647,596,2320,522
664,082021,Sant Celoni,2020,18136,9032,9104,2998,11920,3218
665,082042,Sant Climent de Llobregat,2020,4160,2097,2063,778,2816,566
666,171582,Sant Climent Sescebes,2020,707,439,268,85,504,118
667,082055,Sant Cugat del Vallès,2020,92977,45216,47761,17596,62137,13244
668,082068,Sant Cugat Sesgarrigues,2020,1009,491,518,175,642,192
669,251961,Sant Esteve de la Sarga,2020,122,74,48,6,73,43
670,082074,Sant Esteve de Palautordera,2020,2864,1412,1452,514,1944,406
671,082080,Sant Esteve Sesrovires,2020,7696,3862,3834,1209,5246,1241
672,171595,Sant Feliu de Buixalleu,2020,797,414,383,104,527,166
673,082107,Sant Feliu de Codines,2020,6363,3232,3131,988,4330,1045
674,171609,Sant Feliu de Guíxols,2020,22097,10871,11226,3368,14290,4439
675,082114,Sant Feliu de Llobregat,2020,45467,22104,23363,6962,29722,8783
676,171616,Sant Feliu de Pallerols,2020,1437,724,713,219,901,317
677,082129,Sant Feliu Sasserra,2020,605,319,286,87,364,154
678,171621,Sant Ferriol,2020,236,125,111,47,141,48
679,082093,Sant Fost de Campsentelles,2020,8853,4408,4445,1260,5730,1863
680,082135,Sant Fruitós de Bages,2020,8837,4348,4489,1471,5931,1435
681,171637,Sant Gregori,2020,3928,2017,1911,731,2558,639
682,251924,Sant Guim de Freixenet,2020,1037,539,498,147,630,260
683,251977,Sant Guim de la Plana,2020,181,99,82,15,112,54
684,171642,Sant Hilari Sacalm,2020,5703,2884,2819,880,3616,1207
685,082153,Sant Hipòlit de Voltregà,2020,3540,1765,1775,530,2329,681
686,081939,Sant Iscle de Vallalta,2020,1342,712,630,234,913,195
687,439023,Sant Jaume d'Enveja,2020,3527,1781,1746,458,2223,846
688,082166,Sant Jaume de Frontanyà,2020,30,18,12,3,15,12
689,171655,Sant Jaume de Llierca,2020,871,420,451,133,529,209
690,431378,Sant Jaume dels Domenys,2020,2624,1348,1276,501,1677,446
691,171674,Sant Joan de les Abadesses,2020,3224,1595,1629,397,1914,913
692,171680,Sant Joan de Mollet,2020,498,241,257,80,321,97
693,082188,Sant Joan de Vilatorrada,2020,10998,5521,5477,1730,7152,2116
694,082172,Sant Joan Despí,2020,34267,16692,17575,5499,22735,6033
695,171851,Sant Joan les Fonts,2020,3044,1553,1491,441,1887,716
696,171668,Sant Jordi Desvalls,2020,760,377,383,126,478,156
697,089030,Sant Julià de Cerdanyola,2020,229,127,102,23,151,55
698,171693,Sant Julià de Ramis,2020,3576,1814,1762,670,2420,486
699,082205,Sant Julià de Vilatorta,2020,3140,1559,1581,513,2078,549
700,179032,Sant Julià del Llor i Bonmatí,2020,1313,660,653,220,890,203
701,082212,Sant Just Desvern,2020,18670,8951,9719,3260,11885,3525
702,082227,Sant Llorenç d'Hortons,2020,2428,1234,1194,399,1645,384
703,171714,Sant Llorenç de la Muga,2020,265,134,131,33,172,60
704,251930,Sant Llorenç de Morunys,2020,960,467,493,115,567,278
705,082233,Sant Llorenç Savall,2020,2417,1216,1201,334,1537,546
706,082251,Sant Martí d'Albars,2020,114,57,57,17,65,32
707,082248,Sant Martí de Centelles,2020,1184,609,575,169,832,183
708,171729,Sant Martí de Llémena,2020,641,334,307,107,443,91
709,259025,Sant Martí de Riucorb,2020,639,328,311,73,353,213
710,082264,Sant Martí de Tous,2020,1228,634,594,228,765,235
711,082270,Sant Martí Sarroca,2020,3261,1605,1656,527,2132,602
712,082286,Sant Martí Sesgueioles,2020,342,178,164,39,231,72
713,171735,Sant Martí Vell,2020,251,136,115,29,171,51
714,082299,Sant Mateu de Bages,2020,608,313,295,67,348,193
715,171740,Sant Miquel de Campmajor,2020,229,127,102,41,145,43
716,171753,Sant Miquel de Fluvià,2020,761,396,365,121,496,144
717,171766,Sant Mori,2020,166,84,82,22,107,37
718,171772,Sant Pau de Segúries,2020,688,344,344,91,407,190
719,082310,Sant Pere de Ribes,2020,31111,15456,15655,5073,21217,4821
720,082325,Sant Pere de Riudebitlles,2020,2380,1191,1189,398,1462,520
721,082331,Sant Pere de Torelló,2020,2470,1276,1194,350,1586,534
722,082346,Sant Pere de Vilamajor,2020,4544,2279,2265,743,3110,691
723,171788,Sant Pere Pescador,2020,2090,1112,978,356,1397,337
724,081897,Sant Pere Sallavinera,2020,151,83,68,24,82,45
725,082359,Sant Pol de Mar,2020,5428,2690,2738,793,3466,1169
726,082362,Sant Quintí de Mediona,2020,2317,1192,1125,386,1513,418
727,082378,Sant Quirze de Besora,2020,2154,1041,1113,286,1304,564
728,082384,Sant Quirze del Vallès,2020,20195,9901,10294,3623,13627,2945
729,082397,Sant Quirze Safaja,2020,631,346,285,120,434,77
730,251945,Sant Ramon,2020,487,259,228,49,274,164
731,082401,Sant Sadurní d'Anoia,2020,12841,6328,6513,2137,8487,2217
732,082418,Sant Sadurní d'Osormort,2020,76,46,30,5,55,16
733,080983,Sant Salvador de Guardiola,2020,3221,1659,1562,492,2146,583
734,082628,Sant Vicenç de Castellet,2020,9767,4892,4875,1568,6336,1863
735,082649,Sant Vicenç de Montalt,2020,6452,3245,3207,1019,4281,1152
736,082652,Sant Vicenç de Torelló,2020,2058,1023,1035,320,1365,373
737,082634,Sant Vicenç dels Horts,2020,28268,14044,14224,4354,19150,4764
738,431384,Santa Bàrbara,2020,3715,1886,1829,549,2339,827
739,082439,Santa Cecília de Voltregà,2020,182,100,82,25,123,34
740,082444,Santa Coloma de Cervelló,2020,8268,4037,4231,1540,5555,1173
741,171805,Santa Coloma de Farners,2020,13363,6762,6601,2273,8838,2252
742,082457,Santa Coloma de Gramenet,2020,120443,59527,60916,18347,78547,23549
743,431397,Santa Coloma de Queralt,2020,2672,1341,1331,369,1659,644
744,171812,Santa Cristina d'Aro,2020,5287,2661,2626,847,3487,953
745,082460,Santa Eugènia de Berga,2020,2278,1161,1117,331,1522,425
746,082476,Santa Eulàlia de Riuprimer,2020,1383,700,683,283,884,216
747,082482,Santa Eulàlia de Ronçana,2020,7426,3729,3697,1224,4924,1278
748,082495,Santa Fe del Penedès,2020,367,180,187,56,252,59
749,171827,Santa Llogaia d'Àlguema,2020,368,189,179,68,244,56
750,082508,Santa Margarida de Montbui,2020,10225,5148,5077,1823,6599,1803
751,082515,Santa Margarida i els Monjos,2020,7676,3919,3757,1471,5079,1126
752,082589,Santa Maria d'Oló,2020,1024,518,506,144,628,252
753,082536,Santa Maria de Besora,2020,161,84,77,20,99,42
754,082567,Santa Maria de Martorelles,2020,890,446,444,151,594,145
755,082554,Santa Maria de Merlès,2020,184,89,95,41,117,26
756,082573,Santa Maria de Miralles,2020,119,64,55,13,75,31
757,082592,Santa Maria de Palautordera,2020,9630,4870,4760,1521,6504,1605
758,431401,Santa Oliva,2020,3353,1714,1639,564,2172,617
759,171848,Santa Pau,2020,1614,837,777,232,1011,371
760,082606,Santa Perpètua de Mogoda,2020,25999,13083,12916,4461,17541,3997
761,082613,Santa Susanna,2020,3548,1775,1773,614,2348,586
762,081923,Santpedor,2020,7604,3789,3815,1355,4866,1383
763,431423,Sarral,2020,1538,798,740,244,988,306
764,171864,Sarrià de Ter,2020,5229,2567,2662,898,3452,879
765,252017,Sarroca de Bellera,2020,116,68,48,6,71,39
766,252000,Sarroca de Lleida,2020,358,203,155,30,202,126
767,171870,"Saus, Camallera i Llampaies",2020,856,426,430,131,527,198
768,431439,Savallà del Comtat,2020,53,26,27,1,34,18
769,431444,"Secuita, la",2020,1708,859,849,301,1136,271
770,171886,"Selva de Mar, la",2020,195,105,90,14,125,56
771,431457,"Selva del Camp, la",2020,5683,2867,2816,929,3829,925
772,431460,Senan,2020,44,30,14,6,25,13
773,430445,"Sénia, la",2020,5640,2839,2801,782,3677,1181
774,252022,Senterada,2020,139,82,57,12,104,23
775,250352,"Sentiu de Sió, la",2020,414,217,197,44,250,120
776,082671,Sentmenat,2020,9235,4681,4554,1625,6259,1351
777,171903,Serinyà,2020,1133,574,559,197,732,204
778,252043,Seròs,2020,1946,1048,898,289,1242,415
779,171910,Serra de Daró,2020,222,121,101,35,138,49
780,171925,Setcases,2020,170,96,74,14,109,47
781,252038,"Seu d'Urgell, la",2020,12206,5919,6287,1701,8154,2351
782,082690,Seva,2020,3544,1806,1738,540,2380,624
783,252056,Sidamon,2020,748,397,351,119,503,126
784,171931,Sils,2020,6219,3187,3032,1051,4160,1008
785,082704,Sitges,2020,29553,14811,14742,4093,19914,5546
786,170524,Siurana,2020,171,82,89,22,107,42
787,082711,Sobremunt,2020,78,34,44,6,56,16
788,252069,"Soleràs, el",2020,332,175,157,38,189,105
789,431476,Solivella,2020,632,333,299,71,383,178
790,252075,Solsona,2020,9137,4511,4626,1473,5931,1733
791,082726,Sora,2020,212,121,91,38,128,46
792,252081,Soriguera,2020,420,225,195,64,294,62
793,252094,Sort,2020,2154,1066,1088,325,1413,416
794,252108,Soses,2020,1761,913,848,309,1102,350
795,082732,Subirats,2020,3104,1619,1485,462,2037,605
796,252115,Sudanell,2020,840,457,383,88,545,207
797,252120,Sunyer,2020,343,200,143,37,238,68
798,082747,Súria,2020,5948,2894,3054,779,3797,1372
799,171946,Susqueda,2020,93,55,38,7,66,20
800,082763,Tagamanent,2020,318,161,157,42,228,48
801,082779,Talamanca,2020,209,118,91,37,129,43
802,252154,Talarn,2020,595,402,193,48,459,88
803,252167,Talavera,2020,279,156,123,28,161,90
804,171959,"Tallada d'Empordà, la",2020,454,237,217,64,285,105
805,082785,Taradell,2020,6640,3326,3314,1067,4300,1273
806,431482,Tarragona,2020,136496,66666,69830,20833,90728,24935
807,252173,Tàrrega,2020,17445,8658,8787,3064,11602,2779
808,252189,Tarrés,2020,102,54,48,14,57,31
809,252192,Tarroja de Segarra,2020,188,99,89,28,108,52
810,082750,Tavèrnoles,2020,322,166,156,57,197,68
811,082802,Tavertet,2020,105,52,53,7,62,36
812,082819,Teià,2020,6427,3153,3274,935,4135,1357
813,252206,Térmens,2020,1360,688,672,164,863,333
814,171962,Terrades,2020,338,166,172,45,224,69
815,082798,Terrassa,2020,223627,109948,113679,37422,148410,37795
816,082824,Tiana,2020,8945,4305,4640,1489,5952,1504
817,252213,Tírvia,2020,134,63,71,12,85,37
818,252228,Tiurana,2020,77,34,43,7,51,19
819,431495,Tivenys,2020,902,457,445,77,546,279
820,431508,Tivissa,2020,1619,812,807,188,999,432
821,082830,Tona,2020,8356,4156,4200,1299,5567,1490
822,252234,Torà,2020,1237,627,610,156,802,279
823,082845,Tordera,2020,17519,8870,8649,2945,11566,3008
824,082858,Torelló,2020,14400,7171,7229,2224,9329,2847
825,252249,"Torms, els",2020,138,74,64,9,82,47
826,252252,Tornabous,2020,822,440,382,107,506,209
827,252271,"Torre de Cabdella, la",2020,759,381,378,61,467,231
828,082861,"Torre de Claramunt, la",2020,3741,1935,1806,575,2556,610
829,431515,"Torre de Fontaubella, la",2020,131,69,62,19,71,41
830,431520,"Torre de l'Espanyol, la",2020,601,308,293,70,373,158
831,252265,Torrebesses,2020,267,143,124,27,155,85
832,431536,Torredembarra,2020,16567,8134,8433,2501,10860,3206
833,252287,Torrefarrera,2020,4694,2381,2313,892,3205,597
834,259078,Torrefeta i Florejacs,2020,607,326,281,66,381,160
835,252304,Torregrossa,2020,2179,1143,1036,288,1377,514
836,252311,Torrelameu,2020,735,443,292,86,491,158
837,082877,Torrelavit,2020,1422,721,701,247,907,268
838,082883,Torrelles de Foix,2020,2398,1281,1117,344,1616,438
839,082896,Torrelles de Llobregat,2020,6073,3021,3052,1089,4193,791
840,171978,Torrent,2020,164,87,77,22,105,37
841,252326,Torres de Segre,2020,2366,1228,1138,282,1645,439
842,252332,Torre-serona,2020,398,208,190,47,268,83
843,171984,Torroella de Fluvià,2020,703,367,336,98,488,117
844,171997,Torroella de Montgrí,2020,11836,5983,5853,1847,7809,2180
845,431541,Torroja del Priorat,2020,152,85,67,13,89,50
846,172001,Tortellà,2020,818,391,427,119,510,189
847,431554,Tortosa,2020,33439,16594,16845,5088,21440,6911
848,172018,Toses,2020,168,98,70,21,111,36
849,172023,Tossa de Mar,2020,5818,2927,2891,734,3921,1163
850,252347,Tremp,2020,5911,2895,3016,812,3771,1328
851,172044,Ullà,2020,1177,648,529,225,782,170
852,082900,Ullastrell,2020,2089,1053,1036,419,1374,296
853,172057,Ullastret,2020,274,138,136,43,168,63
854,431567,Ulldecona,2020,6525,3494,3031,938,4285,1302
855,431573,Ulldemolins,2020,398,226,172,30,225,143
856,172039,Ultramort,2020,225,117,108,43,123,59
857,172060,Urús,2020,196,96,100,16,140,40
858,082917,Vacarisses,2020,6832,3500,3332,1270,4715,847
859,170144,"Vajol, la",2020,89,51,38,5,61,23
860,172076,"Vall d'en Bas, la",2020,3093,1568,1525,495,1959,639
861,172082,"Vall de Bianya, la",2020,1275,641,634,196,847,232
862,250432,"Vall de Boí, la",2020,1019,543,476,136,714,169
863,259010,Vall de Cardós,2020,350,189,161,39,227,84
864,082922,Vallbona d'Anoia,2020,1357,703,654,187,893,277
865,252385,Vallbona de les Monges,2020,243,127,116,17,140,86
866,082938,Vallcebre,2020,249,140,109,14,158,77
867,431589,Vallclara,2020,88,52,36,10,57,21
868,252402,Vallfogona de Balaguer,2020,1906,951,955,332,1219,355
869,171707,Vallfogona de Ripollès,2020,196,107,89,18,117,61
870,431592,Vallfogona de Riucorb,2020,77,47,30,0,43,34
871,082943,Vallgorguina,2020,2988,1513,1475,586,2039,363
872,082956,Vallirana,2020,15312,7691,7621,2570,10113,2629
873,172095,Vall-llobrega,2020,897,451,446,154,629,114
874,431606,Vallmoll,2020,1774,890,884,293,1176,305
875,082969,Vallromanes,2020,2558,1322,1236,457,1780,321
876,431613,Valls,2020,24477,12286,12191,3812,16139,4526
877,259062,"Valls d'Aguilar, les",2020,245,140,105,15,155,75
878,252398,"Valls de Valira, les",2020,784,404,380,98,526,160
879,431628,Vandellòs i l'Hospitalet de l'Infant,2020,6603,3304,3299,1138,4328,1137
880,259097,"Vansa i Fórnols, la",2020,149,78,71,5,98,46
881,082975,Veciana,2020,175,95,80,31,90,54
882,431634,"Vendrell, el",2020,38373,19052,19321,6198,24906,7269
883,172109,Ventalló,2020,846,428,418,135,532,179
884,252424,Verdú,2020,902,421,481,103,550,249
885,172116,Verges,2020,1169,575,594,180,706,283
886,431649,Vespella de Gaià,2020,417,230,187,64,258,95
887,082981,Vic,2020,47630,24098,23532,8183,32110,7337
888,172121,Vidrà,2020,177,88,89,29,117,31
889,172137,Vidreres,2020,7951,4130,3821,1207,5344,1400
890,252430,Vielha e Mijaran,2020,5611,2858,2753,791,4070,750
891,431652,Vilabella,2020,729,373,356,82,464,183
892,172142,Vilabertran,2020,993,493,500,189,600,204
893,172155,Vilablareix,2020,3063,1517,1546,589,1997,477
894,082994,Vilada,2020,419,221,198,32,243,144
895,172174,Viladamat,2020,458,232,226,67,283,108
896,172168,Viladasens,2020,206,110,96,28,138,40
897,083015,Viladecans,2020,67197,33231,33966,11241,44819,11137
898,083008,Viladecavalls,2020,7545,3760,3785,1200,5224,1121
899,172180,Vilademuls,2020,835,431,404,152,530,153
900,172207,Viladrau,2020,1047,508,539,159,686,202
901,172214,Vilafant,2020,5421,2660,2761,857,3551,1013
902,083054,Vilafranca del Penedès,2020,40154,19516,20638,6857,26121,7176
903,252445,Vilagrassa,2020,560,294,266,87,375,98
904,172235,Vilajuïga,2020,1116,558,558,157,770,189
905,431750,Vilalba dels Arcs,2020,621,313,308,68,352,201
906,083067,Vilalba Sasserra,2020,753,384,369,124,506,123
907,252458,Vilaller,2020,549,291,258,64,352,133
908,172240,Vilallonga de Ter,2020,398,213,185,40,260,98
909,431665,Vilallonga del Camp,2020,2405,1223,1182,510,1555,340
910,172253,Vilamacolum,2020,377,211,166,63,241,73
911,172266,Vilamalla,2020,1161,586,575,194,756,211
912,172272,Vilamaniscle,2020,212,121,91,27,137,48
913,252477,Vilamòs,2020,178,95,83,19,133,26
914,172288,Vilanant,2020,386,194,192,65,255,66
915,431671,Vilanova d'Escornalbou,2020,565,296,269,86,364,115
916,252483,Vilanova de Bellpuig,2020,1183,600,583,180,646,357
917,252496,Vilanova de l'Aguda,2020,200,98,102,11,121,68
918,252542,Vilanova de la Barca,2020,1088,592,496,127,723,238
919,252509,Vilanova de Meià,2020,415,249,166,39,240,136
920,431687,Vilanova de Prades,2020,107,56,51,13,74,20
921,083036,Vilanova de Sau,2020,312,148,164,38,188,86
922,252516,Vilanova de Segrià,2020,985,529,456,145,648,192
923,083020,Vilanova del Camí,2020,12596,6292,6304,2161,8318,2117
924,089024,Vilanova del Vallès,2020,5503,2781,2722,1099,3717,687
925,083073,Vilanova i la Geltrú,2020,67733,32752,34981,9776,44815,13142
926,431690,Vilaplana,2020,555,297,258,58,380,117
927,431704,Vila-rodona,2020,1276,677,599,196,838,242
928,172305,Vila-sacra,2020,758,377,381,151,465,142
929,252521,Vila-sana,2020,734,373,361,118,482,134
930,431711,Vila-seca,2020,22555,11317,11238,4197,15260,3098
931,082140,Vilassar de Dalt,2020,9072,4464,4608,1349,5959,1764
932,082191,Vilassar de Mar,2020,21035,10186,10849,3328,13587,4120
933,172229,Vilaür,2020,158,80,78,33,95,30
934,431726,Vilaverd,2020,443,237,206,57,299,87
935,431732,"Vilella Alta, la",2020,133,72,61,19,78,36
936,431747,"Vilella Baixa, la",2020,204,110,94,24,131,49
937,172333,Vilobí d'Onyar,2020,3333,1732,1601,562,2205,566
938,083041,Vilobí del Penedès,2020,1102,570,532,183,685,234
939,172327,Vilopriu,2020,204,109,95,29,117,58
940,252537,"Vilosell, el",2020,173,89,84,12,96,65
941,431763,Vimbodí i Poblet,2020,890,478,412,83,543,264
942,252555,Vinaixa,2020,450,235,215,44,262,144
943,431779,Vinebre,2020,425,215,210,64,263,98
944,431785,Vinyols i els Arcs,2020,2124,1113,1011,371,1405,348
945,083089,Viver i Serrateix,2020,172,88,84,27,98,47
946,430521,Xerta,2020,1154,569,585,116,697,341
947,000000,Catalunya,2020,7780479,3826964,3953515,1165865,5146253,1468361
