,Codi,Literal,Saldo migratori total,Any,Immigracions,Emigracions
0,250019,Abella de la Conca,-1,2002,9,10
1,080018,Abrera,283,2002,763,480
2,250024,Àger,5,2002,16,11
3,250030,Agramunt,43,2002,243,200
4,080023,Aguilar de Segarra,7,2002,11,4
5,170010,Agullana,28,2002,53,25
6,080142,Aiguafreda,28,2002,138,110
7,430017,Aiguamúrcia,14,2002,50,36
8,170025,Aiguaviva,22,2002,39,17
9,250387,Aitona,-52,2002,52,104
10,250045,"Alamús, els",6,2002,28,22
11,250058,Alàs i Cerc,-7,2002,7,14
12,250061,"Albagés, l'",-2,2002,13,15
13,170031,Albanyà,14,2002,17,3
14,250077,Albatàrrec,53,2002,106,53
15,250083,Albesa,17,2002,58,41
16,250096,"Albi, l'",21,2002,43,22
17,430022,Albinyana,91,2002,217,126
18,430038,"Albiol, l'",33,2002,52,19
19,170046,Albons,19,2002,36,17
20,430043,Alcanar,235,2002,513,278
21,250100,Alcanó,5,2002,9,4
22,250117,Alcarràs,-4,2002,124,128
23,250122,Alcoletge,41,2002,126,85
24,430056,Alcover,133,2002,255,122
25,439044,"Aldea, l'",16,2002,103,87
26,430069,Aldover,26,2002,37,11
27,430075,"Aleixar, l'",20,2002,38,18
28,080039,Alella,110,2002,533,423
29,430081,Alfara de Carles,19,2002,26,7
30,250138,Alfarràs,-33,2002,42,75
31,250143,Alfés,-4,2002,5,9
32,430094,Alforja,54,2002,79,25
33,250156,Algerri,1,2002,13,12
34,250169,Alguaire,39,2002,117,78
35,250175,Alins,1,2002,9,8
36,430108,Alió,-5,2002,8,13
37,250194,Almacelles,24,2002,173,149
38,250208,Almatret,-1,2002,8,9
39,250215,Almenar,-15,2002,75,90
40,430115,Almoster,79,2002,134,55
41,250220,Alòs de Balaguer,-10,2002,8,18
42,170062,Alp,24,2002,101,77
43,080044,Alpens,9,2002,14,5
44,250236,Alpicat,194,2002,335,141
45,250241,Alt Àneu,-13,2002,19,32
46,430120,Altafulla,153,2002,359,206
47,170078,Amer,9,2002,47,38
48,430136,"Ametlla de Mar, l'",117,2002,325,208
49,080057,"Ametlla del Vallès, l'",374,2002,677,303
50,439060,"Ampolla, l'",45,2002,116,71
51,430141,Amposta,242,2002,735,493
52,170084,Anglès,-15,2002,159,174
53,250273,Anglesola,-1,2002,54,55
54,250292,Arbeca,-79,2002,40,119
55,430167,"Arboç, l'",123,2002,287,164
56,430154,Arbolí,0,2002,8,8
57,170097,Arbúcies,243,2002,445,202
58,080060,Arenys de Mar,264,2002,895,631
59,080076,Arenys de Munt,175,2002,489,314
60,170101,Argelaguer,6,2002,26,20
61,080082,Argençola,2,2002,13,11
62,430173,"Argentera, l'",7,2002,12,5
63,080095,Argentona,64,2002,558,494
64,170118,"Armentera, l'",-11,2002,21,32
65,430189,Arnes,12,2002,23,11
66,250313,Arres,6,2002,7,1
67,250328,Arsèguel,-2,2002,7,9
68,080109,Artés,108,2002,221,113
69,250334,Artesa de Lleida,-6,2002,41,47
70,250349,Artesa de Segre,151,2002,268,117
71,430192,Ascó,-2,2002,35,37
72,250365,Aspa,0,2002,2,2
73,250371,"Avellanes i Santa Linya, les",-4,2002,8,12
74,080116,Avià,55,2002,97,42
75,080121,Avinyó,2,2002,76,74
76,170123,Avinyonet de Puigventós,71,2002,101,30
77,080137,Avinyonet del Penedès,29,2002,93,64
78,080155,Badalona,-2180,2002,6806,8986
79,089045,Badia del Vallès,-464,2002,524,988
80,080168,Bagà,-8,2002,55,63
81,250390,Baix Pallars,13,2002,31,18
82,250404,Balaguer,57,2002,454,397
83,080174,Balenyà,14,2002,160,146
84,080180,Balsareny,23,2002,101,78
85,430206,Banyeres del Penedès,25,2002,160,135
86,170157,Banyoles,321,2002,905,584
87,250411,Barbens,-1,2002,38,39
88,430213,Barberà de la Conca,17,2002,38,21
89,082520,Barberà del Vallès,-64,2002,1288,1352
90,080193,Barcelona,-26303,2002,33443,59746
91,250426,"Baronia de Rialb, la",10,2002,20,10
92,170160,Bàscara,9,2002,50,41
93,250447,Bassella,-13,2002,6,19
94,430228,Batea,38,2002,73,35
95,250450,Bausen,-2,2002,0,2
96,080207,Begues,206,2002,365,159
97,170139,Begur,126,2002,316,190
98,250463,Belianes,12,2002,29,17
99,251706,Bellaguarda,-7,2002,3,10
100,170182,Bellcaire d'Empordà,30,2002,60,30
101,250479,Bellcaire d'Urgell,-32,2002,4,36
102,250485,Bell-lloc d'Urgell,-27,2002,26,53
103,250498,Bellmunt d'Urgell,-2,2002,4,6
104,430234,Bellmunt del Priorat,6,2002,15,9
105,080214,Bellprat,-1,2002,0,1
106,250501,Bellpuig,34,2002,156,122
107,430249,Bellvei,58,2002,135,77
108,250518,Bellver de Cerdanya,51,2002,126,75
109,250523,Bellvís,4,2002,75,71
110,250539,Benavent de Segrià,40,2002,64,24
111,430252,Benifallet,-5,2002,9,14
112,430265,Benissanet,43,2002,70,27
113,080229,Berga,389,2002,856,467
114,170195,Besalú,52,2002,122,70
115,170209,Bescanó,108,2002,239,131
116,170216,Beuda,5,2002,25,20
117,080235,Bigues i Riells del Fai,353,2002,690,337
118,250557,Biosca,-1,2002,6,7
119,170221,"Bisbal d'Empordà, la",149,2002,437,288
120,430271,"Bisbal de Falset, la",0,2002,2,2
121,430287,"Bisbal del Penedès, la",143,2002,262,119
122,172348,Biure,8,2002,16,8
123,430290,Blancafort,9,2002,36,27
124,170237,Blanes,484,2002,1840,1356
125,170293,Boadella i les Escaules,16,2002,18,2
126,170242,Bolvir,0,2002,11,11
127,430304,Bonastre,50,2002,73,23
128,250576,"Bòrdes, Es",-4,2002,16,20
129,170255,Bordils,14,2002,75,61
130,250582,"Borges Blanques, les",95,2002,247,152
131,430311,"Borges del Camp, les",-9,2002,73,82
132,170268,Borrassà,9,2002,35,26
133,080240,Borredà,6,2002,32,26
134,250595,Bossòst,11,2002,85,74
135,430326,Bot,-7,2002,11,18
136,430332,Botarell,76,2002,100,24
137,250560,Bovera,-1,2002,3,4
138,430347,Bràfim,20,2002,32,12
139,170274,Breda,56,2002,157,101
140,080253,"Bruc, el",80,2002,154,74
141,080266,"Brull, el",2,2002,13,11
142,170280,Brunyola i Sant Martí Sapresa,-2,2002,13,15
143,430350,Cabacés,7,2002,12,5
144,250609,Cabanabona,-4,2002,1,5
145,170314,Cabanelles,17,2002,23,6
146,170307,Cabanes,29,2002,78,49
147,080272,"Cabanyes, les",23,2002,43,20
148,250616,Cabó,-1,2002,0,1
149,430363,Cabra del Camp,54,2002,98,44
150,080288,Cabrera d'Anoia,61,2002,107,46
151,080291,Cabrera de Mar,12,2002,247,235
152,080305,Cabrils,333,2002,614,281
153,170329,Cadaqués,109,2002,198,89
154,080312,Calaf,39,2002,155,116
155,430379,Calafell,1393,2002,2345,952
156,080348,Calders,6,2002,52,46
157,080327,Caldes d'Estrac,188,2002,347,159
158,170335,Caldes de Malavella,238,2002,409,171
159,080333,Caldes de Montbui,372,2002,870,498
160,080351,Calella,870,2002,1743,873
161,080370,Calldetenes,24,2002,106,82
162,080386,Callús,54,2002,96,42
163,080364,Calonge de Segarra,-1,2002,1,2
164,170340,Calonge i Sant Antoni,462,2002,875,413
165,250621,Camarasa,9,2002,29,20
166,439039,Camarles,-22,2002,70,92
167,430385,Cambrils,1138,2002,2214,1076
168,170353,Camós,19,2002,41,22
169,170366,Campdevànol,14,2002,118,104
170,170372,Campelles,4,2002,8,4
171,080399,Campins,11,2002,19,8
172,170388,Campllong,16,2002,31,15
173,170391,Camprodon,56,2002,169,113
174,250637,Canejan,-1,2002,1,2
175,170405,Canet d'Adri,-3,2002,16,19
176,080403,Canet de Mar,514,2002,899,385
177,080410,Canovelles,276,2002,1101,825
178,080425,Cànoves i Samalús,78,2002,222,144
179,170412,Cantallops,8,2002,19,11
180,080431,Canyelles,229,2002,393,164
181,430398,Capafonts,-1,2002,4,5
182,430402,Capçanes,-7,2002,4,11
183,080446,Capellades,60,2002,251,191
184,170427,Capmany,-13,2002,30,43
185,080459,Capolat,5,2002,5,0
186,080462,Cardedeu,596,2002,1156,560
187,080478,Cardona,-67,2002,88,155
188,080484,Carme,28,2002,51,23
189,430419,Caseres,7,2002,11,4
190,170448,Cassà de la Selva,23,2002,285,262
191,080497,Casserres,19,2002,59,40
192,080575,Castell de l'Areny,8,2002,11,3
193,259046,Castell de Mur,10,2002,13,3
194,250642,Castellar de la Ribera,2,2002,5,3
195,080522,Castellar de n'Hug,12,2002,25,13
196,080500,Castellar del Riu,12,2002,14,2
197,080517,Castellar del Vallès,312,2002,961,649
198,080538,Castellbell i el Vilar,47,2002,220,173
199,080543,Castellbisbal,439,2002,900,461
200,080556,Castellcir,39,2002,62,23
201,250674,Castelldans,6,2002,29,23
202,080569,Castelldefels,447,2002,3495,3048
203,080581,Castellet i la Gornal,56,2002,154,98
204,170464,Castellfollit de la Roca,4,2002,49,45
205,080608,Castellfollit de Riubregós,-2,2002,7,9
206,080594,Castellfollit del Boix,5,2002,15,10
207,080615,Castellgalí,78,2002,129,51
208,080620,Castellnou de Bages,53,2002,82,29
209,250680,Castellnou de Seana,-15,2002,22,37
210,170470,Castelló d'Empúries,624,2002,999,375
211,250693,Castelló de Farfanya,-7,2002,17,24
212,080636,Castellolí,10,2002,14,4
213,170486,Castell-Platja d'Aro,325,2002,886,561
214,250707,Castellserà,23,2002,57,34
215,080641,Castellterçol,64,2002,153,89
216,430424,Castellvell del Camp,121,2002,168,47
217,080654,Castellví de la Marca,39,2002,89,50
218,080667,Castellví de Rosanes,75,2002,132,57
219,430430,"Catllar, el",183,2002,303,120
220,250714,Cava,-2,2002,1,3
221,171899,"Cellera de Ter, la",13,2002,75,62
222,170499,Celrà,208,2002,307,99
223,080673,Centelles,205,2002,366,161
224,082687,Cercs,-25,2002,30,55
225,082665,Cerdanyola del Vallès,491,2002,2951,2460
226,080689,Cervelló,314,2002,638,324
227,250729,Cervera,286,2002,710,424
228,250735,Cervià de les Garrigues,-5,2002,36,41
229,170502,Cervià de Ter,25,2002,41,16
230,170519,Cistella,8,2002,19,11
231,250740,Ciutadilla,22,2002,25,3
232,250753,Clariana de Cardener,10,2002,11,1
233,250766,"Cogul, el",-6,2002,5,11
234,170545,Colera,36,2002,81,45
235,250772,Coll de Nargó,-5,2002,19,24
236,080692,Collbató,193,2002,352,159
237,430458,Colldejou,-3,2002,1,4
238,080706,Collsuspina,2,2002,19,17
239,170558,Colomers,-5,2002,3,8
240,251636,"Coma i la Pedra, la",10,2002,20,10
241,251615,Conca de Dalt,10,2002,19,9
242,430461,Conesa,-2,2002,9,11
243,430477,Constantí,-34,2002,167,201
244,080713,Copons,-2,2002,7,9
245,430483,Corbera d'Ebre,0,2002,20,20
246,080728,Corbera de Llobregat,374,2002,891,517
247,250788,Corbins,32,2002,68,36
248,170577,Corçà,19,2002,67,48
249,080734,Cornellà de Llobregat,-1539,2002,2807,4346
250,170561,Cornellà del Terri,13,2002,90,77
251,430496,Cornudella de Montsant,-10,2002,27,37
252,430509,Creixell,164,2002,327,163
253,170583,Crespià,24,2002,29,5
254,179011,"Cruïlles, Monells i Sant Sadurní de l'Heura",-1,2002,56,57
255,080749,Cubelles,844,2002,1336,492
256,250791,Cubells,11,2002,23,12
257,430516,Cunit,373,2002,972,599
258,170600,Darnius,4,2002,43,39
259,170617,Das,3,2002,10,7
260,439018,Deltebre,183,2002,332,149
261,080752,Dosrius,229,2002,446,217
262,430537,Duesaigües,-6,2002,1,7
263,170622,"Escala, l'",374,2002,693,319
264,080765,Esparreguera,498,2002,1332,834
265,170638,Espinelves,11,2002,21,10
266,250812,"Espluga Calba, l'",1,2002,15,14
267,430542,"Espluga de Francolí, l'",49,2002,160,111
268,080771,Esplugues de Llobregat,110,2002,2827,2717
269,170643,Espolla,-1,2002,11,12
270,170656,Esponellà,35,2002,49,14
271,250827,Espot,20,2002,28,8
272,080787,"Espunyola, l'",-6,2002,2,8
273,082541,"Esquirol, l'",71,2002,116,45
274,250886,Estamariu,-2,2002,4,6
275,080790,"Estany, l'",8,2002,14,6
276,250851,Estaràs,4,2002,6,2
277,250864,Esterri d'Àneu,36,2002,69,33
278,250870,Esterri de Cardós,-1,2002,1,2
279,430555,Falset,-25,2002,57,82
280,170059,"Far d'Empordà, el",7,2002,27,20
281,250899,Farrera,10,2002,15,5
282,430568,"Fatarella, la",-1,2002,15,16
283,430574,"Febró, la",-2,2002,0,2
284,081347,Figaró-Montmany,52,2002,106,54
285,080804,Fígols,0,2002,5,5
286,259084,Fígols i Alinyà,11,2002,15,4
287,430580,"Figuera, la",15,2002,20,5
288,170669,Figueres,948,2002,2599,1651
289,430593,Figuerola del Camp,-3,2002,9,12
290,170675,Flaçà,15,2002,49,34
291,430607,Flix,-12,2002,85,97
292,250925,"Floresta, la",-2,2002,10,12
293,080826,Fogars de la Selva,92,2002,160,68
294,080811,Fogars de Montclús,16,2002,31,15
295,170681,Foixà,0,2002,10,10
296,080832,Folgueroles,39,2002,99,60
297,250931,Fondarella,35,2002,46,11
298,080847,Fonollosa,54,2002,79,25
299,170694,Fontanals de Cerdanya,-5,2002,17,22
300,170708,Fontanilles,21,2002,26,5
301,170715,Fontcoberta,-14,2002,35,49
302,080850,Font-rubí,3,2002,83,80
303,250946,Foradada,5,2002,23,18
304,179026,Forallac,-2,2002,86,88
305,430614,Forès,-2,2002,1,3
306,170736,Fornells de la Selva,81,2002,120,39
307,170741,Fortià,13,2002,35,22
308,080863,"Franqueses del Vallès, les",473,2002,1180,707
309,430629,Freginals,10,2002,23,13
310,250962,"Fuliola, la",-9,2002,24,33
311,250978,Fulleda,2,2002,2,0
312,080902,Gaià,7,2002,16,9
313,430635,"Galera, la",-3,2002,15,18
314,080879,Gallifa,3,2002,19,16
315,430640,Gandesa,131,2002,180,49
316,430653,Garcia,2,2002,21,19
317,430666,"Garidells, els",7,2002,11,4
318,080885,"Garriga, la",63,2002,570,507
319,170754,Garrigàs,4,2002,13,9
320,170767,Garrigoles,-10,2002,3,13
321,170773,Garriguella,-14,2002,37,51
322,080898,Gavà,941,2002,2938,1997
323,250984,Gavet de la Conca,-6,2002,7,13
324,080919,Gelida,202,2002,377,175
325,170789,Ger,-15,2002,15,30
326,259123,Gimenells i el Pla de la Font,-13,2002,14,27
327,430672,Ginestar,57,2002,68,11
328,170792,Girona,2476,2002,6003,3527
329,080924,Gironella,101,2002,208,107
330,080930,Gisclareny,1,2002,2,1
331,430688,Godall,-8,2002,15,23
332,250997,Golmés,24,2002,77,53
333,170806,Gombrèn,13,2002,20,7
334,251001,Gósol,-3,2002,9,12
335,080945,"Granada, la",46,2002,92,46
336,251018,"Granadella, la",-5,2002,14,19
337,080958,Granera,8,2002,11,3
338,251023,"Granja d'Escarp, la",-30,2002,10,40
339,080961,Granollers,1021,2002,3969,2948
340,251039,Granyanella,5,2002,9,4
341,251057,Granyena de les Garrigues,4,2002,10,6
342,251044,Granyena de Segarra,2,2002,7,5
343,430691,Gratallops,0,2002,6,6
344,080977,Gualba,60,2002,113,53
345,170813,Gualta,-3,2002,23,26
346,080996,Guardiola de Berguedà,-9,2002,43,52
347,430705,"Guiamets, els",4,2002,9,5
348,170828,Guils de Cerdanya,14,2002,33,19
349,251095,Guimerà,-11,2002,5,16
350,259031,"Guingueta d'Àneu, la",23,2002,43,20
351,251109,Guissona,382,2002,564,182
352,251116,Guixers,15,2002,23,8
353,081000,Gurb,41,2002,125,84
354,430712,Horta de Sant Joan,-20,2002,16,36
355,081017,"Hospitalet de Llobregat, l'",4038,2002,17701,13663
356,081629,"Hostalets de Pierola, els",136,2002,210,74
357,170834,Hostalric,103,2002,225,122
358,081022,Igualada,451,2002,1586,1135
359,251155,Isona i Conca Dellà,29,2002,66,37
360,170849,Isòvol,5,2002,8,3
361,251137,Ivars d'Urgell,-10,2002,58,68
362,251121,Ivars de Noguera,6,2002,13,7
363,251142,Ivorra,-4,2002,6,10
364,170852,Jafre,22,2002,32,10
365,170865,"Jonquera, la",73,2002,276,203
366,081038,Jorba,-5,2002,23,28
367,259101,Josa i Tuixén,35,2002,37,2
368,170871,Juià,5,2002,22,17
369,251180,Juncosa,-6,2002,16,22
370,251193,Juneda,81,2002,161,80
371,251214,Les,10,2002,38,28
372,251229,Linyola,-9,2002,84,93
373,081043,"Llacuna, la",32,2002,53,21
374,170887,Lladó,22,2002,38,16
375,251235,Lladorre,-7,2002,1,8
376,251240,Lladurs,0,2002,7,7
377,081056,"Llagosta, la",291,2002,890,599
378,170890,Llagostera,236,2002,415,179
379,170904,Llambilles,21,2002,60,39
380,170911,Llanars,-10,2002,24,34
381,170926,Llançà,78,2002,213,135
382,251253,Llardecans,3,2002,14,11
383,251266,Llavorsí,13,2002,32,19
384,251207,Lleida,1774,2002,4908,3134
385,170932,Llers,27,2002,84,57
386,251272,Lles de Cerdanya,-11,2002,0,11
387,081075,Lliçà d'Amunt,545,2002,1104,559
388,081081,Lliçà de Vall,107,2002,381,274
389,251288,Llimiana,25,2002,29,4
390,081069,Llinars del Vallès,254,2002,623,369
391,170947,Llívia,44,2002,113,69
392,430727,"Lloar, el",-2,2002,3,5
393,251291,Llobera,6,2002,11,5
394,430733,Llorac,5,2002,9,4
395,430748,Llorenç del Penedès,107,2002,167,60
396,170950,Lloret de Mar,1657,2002,2776,1119
397,170963,"Llosses, les",2,2002,17,15
398,081094,Lluçà,-9,2002,2,11
399,171024,Maçanet de Cabrenys,35,2002,67,32
400,171030,Maçanet de la Selva,285,2002,483,198
401,170979,Madremanya,-33,2002,6,39
402,170985,Maià de Montcal,16,2002,36,20
403,251333,Maials,7,2002,17,10
404,251305,Maldà,-3,2002,13,16
405,081108,Malgrat de Mar,613,2002,1243,630
406,081115,Malla,-1,2002,6,7
407,081120,Manlleu,231,2002,885,654
408,081136,Manresa,1334,2002,3427,2093
409,430764,Marçà,-16,2002,24,40
410,430751,Margalef,-4,2002,1,5
411,082423,Marganell,16,2002,32,16
412,081141,Martorell,213,2002,1359,1146
413,081154,Martorelles,-67,2002,233,300
414,430770,Mas de Barberans,2,2002,17,15
415,171002,Masarac,13,2002,19,6
416,430786,Masdenverge,18,2002,53,35
417,081167,"Masies de Roda, les",-16,2002,29,45
418,081173,"Masies de Voltregà, les",23,2002,112,89
419,430799,Masllorenç,13,2002,25,12
420,081189,"Masnou, el",-202,2002,884,1086
421,430803,"Masó, la",10,2002,16,6
422,430810,Maspujols,3,2002,29,26
423,081192,Masquefa,453,2002,742,289
424,430825,"Masroig, el",11,2002,23,12
425,251312,Massalcoreig,10,2002,20,10
426,171019,Massanes,2,2002,57,55
427,251327,Massoteres,21,2002,44,23
428,081206,Matadepera,70,2002,437,367
429,081213,Mataró,1981,2002,5317,3336
430,081228,Mediona,92,2002,190,98
431,251348,Menàrguens,6,2002,34,28
432,170998,Meranges,2,2002,3,1
433,171058,Mieres,19,2002,38,19
434,430831,"Milà, el",-1,2002,7,8
435,251351,Miralcamp,24,2002,58,34
436,430846,Miravet,-7,2002,22,29
437,081385,Moià,307,2002,438,131
438,430859,"Molar, el",4,2002,13,9
439,081234,Molins de Rei,755,2002,1469,714
440,251370,Mollerussa,307,2002,755,448
441,171061,Mollet de Peralada,-3,2002,8,11
442,081249,Mollet del Vallès,-188,2002,2254,2442
443,171077,Molló,1,2002,6,5
444,251364,"Molsosa, la",-3,2002,0,3
445,081287,Monistrol de Calders,3,2002,25,22
446,081271,Monistrol de Montserrat,-19,2002,96,115
447,171096,Montagut i Oix,17,2002,51,34
448,430862,Montblanc,137,2002,309,172
449,430884,Montbrió del Camp,9,2002,77,68
450,081252,Montcada i Reixac,560,2002,1865,1305
451,081304,Montclar,3,2002,4,1
452,251399,Montellà i Martinet,-4,2002,22,26
453,081311,Montesquiu,5,2002,44,39
454,251403,Montferrer i Castellbò,23,2002,45,22
455,430897,Montferri,-9,2002,0,9
456,251386,Montgai,19,2002,28,9
457,081265,Montgat,42,2002,524,482
458,081326,Montmajor,-4,2002,23,27
459,081332,Montmaneu,11,2002,16,5
460,430901,"Montmell, el",47,2002,101,54
461,081350,Montmeló,-93,2002,340,433
462,251425,Montoliu de Lleida,14,2002,23,9
463,251410,Montoliu de Segarra,19,2002,21,2
464,251431,Montornès de Segarra,0,2002,3,3
465,081363,Montornès del Vallès,11,2002,675,664
466,430918,Mont-ral,9,2002,25,16
467,171100,Mont-ras,63,2002,122,59
468,430923,Mont-roig del Camp,140,2002,544,404
469,081379,Montseny,22,2002,34,12
470,430939,Móra d'Ebre,31,2002,161,130
471,430944,Móra la Nova,-25,2002,101,126
472,430957,"Morell, el",56,2002,168,112
473,430960,"Morera de Montsant, la",19,2002,27,8
474,081290,Muntanyola,12,2002,30,18
475,081398,Mura,11,2002,19,8
476,251459,Nalec,-2,2002,0,2
477,250254,Naut Aran,52,2002,120,68
478,081402,Navarcles,45,2002,180,135
479,081419,Navàs,36,2002,194,158
480,171117,Navata,39,2002,77,38
481,251462,Navès,3,2002,6,3
482,081424,"Nou de Berguedà, la",-2,2002,5,7
483,430976,"Nou de Gaià, la",-2,2002,19,21
484,430982,Nulles,0,2002,15,15
485,251484,Odèn,1,2002,5,4
486,081430,Òdena,2,2002,121,119
487,171122,Ogassa,2,2002,16,14
488,081458,Olèrdola,98,2002,220,122
489,081461,Olesa de Bonesvalls,80,2002,184,104
490,081477,Olesa de Montserrat,622,2002,1254,632
491,251497,Oliana,5,2002,66,61
492,251500,Oliola,55,2002,58,3
493,251517,Olius,13,2002,26,13
494,081483,Olivella,171,2002,291,120
495,081496,Olost,24,2002,48,24
496,171143,Olot,409,2002,1161,752
497,251522,"Oluges, les",2,2002,6,4
498,081445,Olvan,23,2002,50,27
499,251538,"Omellons, els",3,2002,9,6
500,251543,"Omells de na Gaia, els",4,2002,5,1
501,171156,Ordis,8,2002,11,3
502,251556,Organyà,-1,2002,33,34
503,081509,Orís,1,2002,10,9
504,081516,Oristà,-4,2002,15,19
505,081521,Orpí,5,2002,12,7
506,081537,Òrrius,-21,2002,0,21
507,251569,Os de Balaguer,38,2002,50,12
508,171169,Osor,29,2002,39,10
509,251575,Ossó de Sió,6,2002,7,1
510,081542,Pacs del Penedès,-8,2002,36,44
511,081555,Palafolls,284,2002,594,310
512,171175,Palafrugell,514,2002,1228,714
513,171181,Palamós,321,2002,1065,744
514,251581,"Palau d'Anglesola, el",26,2002,60,34
515,171194,Palau de Santa Eulàlia,4,2002,7,3
516,171215,Palau-sator,-2,2002,9,11
517,171208,Palau-saverdera,105,2002,152,47
518,081568,Palau-solità i Plegamans,234,2002,796,562
519,431009,"Pallaresos, els",4,2002,205,201
520,081574,Pallejà,401,2002,770,369
521,430995,"Palma d'Ebre, la",1,2002,11,10
522,089058,"Palma de Cervelló, la",75,2002,232,157
523,171236,Palol de Revardit,28,2002,33,5
524,171241,Pals,87,2002,198,111
525,081580,"Papiol, el",-11,2002,158,169
526,171254,Pardines,4,2002,10,6
527,081593,Parets del Vallès,305,2002,1061,756
528,171267,Parlavà,-10,2002,10,20
529,431016,Passanant i Belltall,22,2002,44,22
530,171289,Pau,6,2002,32,26
531,431021,Paüls,2,2002,6,4
532,171292,Pedret i Marzà,2,2002,7,5
533,251641,Penelles,8,2002,16,8
534,171306,"Pera, la",6,2002,20,14
535,081607,Perafita,-4,2002,26,30
536,431037,Perafort,27,2002,65,38
537,171328,Peralada,49,2002,97,48
538,251654,Peramola,12,2002,19,7
539,431042,"Perelló, el",-11,2002,44,55
540,081614,Piera,551,2002,1051,500
541,431055,"Piles, les",-7,2002,8,15
542,081635,Pineda de Mar,798,2002,2045,1247
543,431068,"Pinell de Brai, el",0,2002,23,23
544,251667,Pinell de Solsonès,-2,2002,2,4
545,251673,Pinós,-3,2002,11,14
546,431074,Pira,4,2002,16,12
547,431080,"Pla de Santa Maria, el",49,2002,130,81
548,081640,"Pla del Penedès, el",-6,2002,43,49
549,171334,"Planes d'Hostoles, les",-16,2002,26,42
550,171349,Planoles,10,2002,30,20
551,259118,"Plans de Sió, els",4,2002,12,8
552,251689,"Poal, el",4,2002,18,14
553,251692,"Pobla de Cérvoles, la",14,2002,17,3
554,081653,"Pobla de Claramunt, la",56,2002,133,77
555,081666,"Pobla de Lillet, la",-5,2002,29,34
556,431093,"Pobla de Mafumet, la",64,2002,92,28
557,431107,"Pobla de Massaluca, la",0,2002,14,14
558,431114,"Pobla de Montornès, la",81,2002,191,110
559,251713,"Pobla de Segur, la",84,2002,196,112
560,431129,Poboleda,3,2002,13,10
561,081672,Polinyà,224,2002,476,252
562,431135,"Pont d'Armentera, el",14,2002,37,23
563,250306,"Pont de Bar, el",-3,2002,5,8
564,171352,Pont de Molins,14,2002,36,22
565,251734,"Pont de Suert, el",23,2002,126,103
566,081825,"Pont de Vilomara i Rocafort, el",85,2002,190,105
567,431418,Pontils,-5,2002,6,11
568,081688,Pontons,42,2002,69,27
569,171365,Pontós,1,2002,9,8
570,251728,Ponts,-33,2002,79,112
571,171371,Porqueres,18,2002,152,134
572,431140,Porrera,3,2002,14,11
573,171404,"Port de la Selva, el",8,2002,63,55
574,171387,Portbou,4,2002,60,56
575,251749,"Portella, la",12,2002,32,20
576,431153,Pradell de la Teixeta,3,2002,7,4
577,431166,Prades,11,2002,32,21
578,431172,Prat de Comte,7,2002,14,7
579,081691,"Prat de Llobregat, el",-741,2002,1500,2241
580,431188,Pratdip,13,2002,38,25
581,081712,Prats de Lluçanès,-25,2002,47,72
582,081705,"Prats de Rei, els",-11,2002,18,29
583,251752,Prats i Sansor,-9,2002,7,16
584,251765,Preixana,-1,2002,8,9
585,251771,Preixens,7,2002,23,16
586,082303,Premià de Dalt,158,2002,703,545
587,081727,Premià de Mar,79,2002,1655,1576
588,171390,"Preses, les",58,2002,114,56
589,251790,Prullans,2,2002,23,21
590,171411,Puigcerdà,271,2002,657,386
591,081748,Puigdàlber,30,2002,38,8
592,251804,Puiggròs,1,2002,3,2
593,431191,Puigpelat,138,2002,178,40
594,081751,Puig-reig,7,2002,116,109
595,251811,Puigverd d'Agramunt,3,2002,17,14
596,251826,Puigverd de Lleida,8,2002,55,47
597,081764,Pujalt,1,2002,4,3
598,081770,"Quar, la",-6,2002,3,9
599,171426,Quart,46,2002,147,101
600,170433,Queralbs,-5,2002,3,8
601,431205,Querol,20,2002,48,28
602,171432,Rabós,1,2002,11,10
603,081786,Rajadell,-14,2002,27,41
604,431212,Rasquera,-2,2002,13,15
605,171447,Regencós,2,2002,15,13
606,081799,Rellinars,130,2002,164,34
607,431227,Renau,16,2002,22,6
608,431233,Reus,172,2002,3035,2863
609,251832,Rialp,-19,2002,26,45
610,431248,"Riba, la",-14,2002,14,28
611,431251,Riba-roja d'Ebre,22,2002,64,42
612,259059,Ribera d'Ondara,4,2002,21,17
613,251850,Ribera d'Urgellet,-26,2002,24,50
614,171450,Ribes de Freser,16,2002,77,61
615,171463,Riells i Viabrea,227,2002,356,129
616,431264,"Riera de Gaià, la",93,2002,131,38
617,251863,Riner,-4,2002,3,7
618,171479,Ripoll,1,2002,329,328
619,081803,Ripollet,436,2002,1729,1293
620,259139,Riu de Cerdanya,2,2002,6,4
621,171485,Riudarenes,14,2002,84,70
622,171498,Riudaura,2,2002,22,20
623,431270,Riudecanyes,0,2002,29,29
624,431286,Riudecols,-7,2002,37,44
625,171501,Riudellots de la Selva,90,2002,158,68
626,431299,Riudoms,126,2002,304,178
627,171518,Riumors,-6,2002,0,6
628,081810,"Roca del Vallès, la",265,2002,648,383
629,431303,Rocafort de Queralt,12,2002,15,3
630,431310,Roda de Berà,236,2002,513,277
631,081831,Roda de Ter,23,2002,194,171
632,431325,Rodonyà,6,2002,29,23
633,431331,Roquetes,197,2002,438,241
634,171523,Roses,499,2002,1070,571
635,251898,Rosselló,33,2002,133,100
636,431346,"Rourell, el",21,2002,24,3
637,081846,Rubí,335,2002,2658,2323
638,081859,Rubió,5,2002,8,3
639,171539,Rupià,-11,2002,2,13
640,089019,Rupit i Pruit,-7,2002,6,13
641,081878,Sabadell,2644,2002,8216,5572
642,081884,Sagàs,-9,2002,0,9
643,251902,Salàs de Pallars,-1,2002,17,18
644,081901,Saldes,5,2002,25,20
645,171544,Sales de Llierca,7,2002,10,3
646,081918,Sallent,35,2002,203,168
647,431359,Salomó,-9,2002,7,16
648,439057,Salou,1460,2002,2592,1132
649,171557,Salt,1091,2002,2517,1426
650,251919,Sanaüja,12,2002,20,8
651,081944,Sant Adrià de Besòs,175,2002,1745,1570
652,081957,Sant Agustí de Lluçanès,0,2002,5,5
653,081960,Sant Andreu de la Barca,411,2002,1660,1249
654,081976,Sant Andreu de Llavaneres,336,2002,773,437
655,171576,Sant Andreu Salou,5,2002,7,2
656,171833,Sant Aniol de Finestres,10,2002,24,14
657,081982,Sant Antoni de Vilamajor,178,2002,386,208
658,081995,Sant Bartomeu del Grau,-5,2002,50,55
659,082009,Sant Boi de Llobregat,-621,2002,2570,3191
660,082016,Sant Boi de Lluçanès,13,2002,32,19
661,431362,Sant Carles de la Ràpita,263,2002,604,341
662,082037,Sant Cebrià de Vallalta,92,2002,235,143
663,082021,Sant Celoni,376,2002,938,562
664,082042,Sant Climent de Llobregat,41,2002,184,143
665,171582,Sant Climent Sescebes,7,2002,22,15
666,082055,Sant Cugat del Vallès,1818,2002,4376,2558
667,082068,Sant Cugat Sesgarrigues,45,2002,74,29
668,251961,Sant Esteve de la Sarga,5,2002,11,6
669,082074,Sant Esteve de Palautordera,89,2002,178,89
670,082080,Sant Esteve Sesrovires,178,2002,414,236
671,171595,Sant Feliu de Buixalleu,1,2002,40,39
672,082107,Sant Feliu de Codines,164,2002,446,282
673,171609,Sant Feliu de Guíxols,153,2002,801,648
674,082114,Sant Feliu de Llobregat,421,2002,2181,1760
675,171616,Sant Feliu de Pallerols,22,2002,51,29
676,082129,Sant Feliu Sasserra,0,2002,23,23
677,171621,Sant Ferriol,6,2002,16,10
678,082093,Sant Fost de Campsentelles,103,2002,459,356
679,082135,Sant Fruitós de Bages,279,2002,477,198
680,171637,Sant Gregori,99,2002,166,67
681,251924,Sant Guim de Freixenet,2,2002,68,66
682,251977,Sant Guim de la Plana,-5,2002,6,11
683,171642,Sant Hilari Sacalm,188,2002,308,120
684,082153,Sant Hipòlit de Voltregà,29,2002,113,84
685,081939,Sant Iscle de Vallalta,33,2002,78,45
686,439023,Sant Jaume d'Enveja,8,2002,87,79
687,082166,Sant Jaume de Frontanyà,1,2002,1,0
688,171655,Sant Jaume de Llierca,6,2002,31,25
689,431378,Sant Jaume dels Domenys,67,2002,153,86
690,171674,Sant Joan de les Abadesses,-3,2002,101,104
691,171680,Sant Joan de Mollet,4,2002,16,12
692,082188,Sant Joan de Vilatorrada,161,2002,468,307
693,082172,Sant Joan Despí,672,2002,2097,1425
694,171851,Sant Joan les Fonts,13,2002,115,102
695,171668,Sant Jordi Desvalls,-16,2002,19,35
696,089030,Sant Julià de Cerdanyola,4,2002,11,7
697,171693,Sant Julià de Ramis,62,2002,168,106
698,082205,Sant Julià de Vilatorta,89,2002,172,83
699,179032,Sant Julià del Llor i Bonmatí,28,2002,47,19
700,082212,Sant Just Desvern,260,2002,955,695
701,082227,Sant Llorenç d'Hortons,61,2002,147,86
702,171714,Sant Llorenç de la Muga,1,2002,5,4
703,251930,Sant Llorenç de Morunys,15,2002,51,36
704,082233,Sant Llorenç Savall,69,2002,151,82
705,082251,Sant Martí d'Albars,-10,2002,0,10
706,082248,Sant Martí de Centelles,49,2002,93,44
707,171729,Sant Martí de Llémena,23,2002,42,19
708,259025,Sant Martí de Riucorb,-1,2002,15,16
709,082264,Sant Martí de Tous,19,2002,48,29
710,082270,Sant Martí Sarroca,32,2002,148,116
711,082286,Sant Martí Sesgueioles,-7,2002,7,14
712,171735,Sant Martí Vell,-12,2002,0,12
713,082299,Sant Mateu de Bages,-9,2002,16,25
714,171740,Sant Miquel de Campmajor,12,2002,26,14
715,171753,Sant Miquel de Fluvià,19,2002,49,30
716,171766,Sant Mori,8,2002,21,13
717,171772,Sant Pau de Segúries,7,2002,21,14
718,082310,Sant Pere de Ribes,643,2002,1904,1261
719,082325,Sant Pere de Riudebitlles,-4,2002,66,70
720,082331,Sant Pere de Torelló,35,2002,99,64
721,082346,Sant Pere de Vilamajor,74,2002,305,231
722,171788,Sant Pere Pescador,-26,2002,53,79
723,081897,Sant Pere Sallavinera,5,2002,9,4
724,082359,Sant Pol de Mar,206,2002,411,205
725,082362,Sant Quintí de Mediona,56,2002,136,80
726,082378,Sant Quirze de Besora,-1,2002,64,65
727,082384,Sant Quirze del Vallès,620,2002,1226,606
728,082397,Sant Quirze Safaja,8,2002,50,42
729,251945,Sant Ramon,9,2002,26,17
730,082401,Sant Sadurní d'Anoia,466,2002,717,251
731,082418,Sant Sadurní d'Osormort,3,2002,13,10
732,080983,Sant Salvador de Guardiola,149,2002,269,120
733,082628,Sant Vicenç de Castellet,104,2002,366,262
734,082649,Sant Vicenç de Montalt,228,2002,468,240
735,082652,Sant Vicenç de Torelló,32,2002,102,70
736,082634,Sant Vicenç dels Horts,233,2002,1281,1048
737,431384,Santa Bàrbara,7,2002,110,103
738,082439,Santa Cecília de Voltregà,-4,2002,3,7
739,082444,Santa Coloma de Cervelló,478,2002,720,242
740,171805,Santa Coloma de Farners,57,2002,370,313
741,082457,Santa Coloma de Gramenet,-2064,2002,4232,6296
742,431397,Santa Coloma de Queralt,-11,2002,90,101
743,171812,Santa Cristina d'Aro,284,2002,469,185
744,082460,Santa Eugènia de Berga,7,2002,87,80
745,082476,Santa Eulàlia de Riuprimer,-7,2002,24,31
746,082482,Santa Eulàlia de Ronçana,197,2002,436,239
747,082495,Santa Fe del Penedès,9,2002,24,15
748,171827,Santa Llogaia d'Àlguema,8,2002,23,15
749,082508,Santa Margarida de Montbui,47,2002,406,359
750,082515,Santa Margarida i els Monjos,158,2002,396,238
751,082589,Santa Maria d'Oló,26,2002,52,26
752,082536,Santa Maria de Besora,9,2002,21,12
753,082567,Santa Maria de Martorelles,19,2002,46,27
754,082554,Santa Maria de Merlès,2,2002,6,4
755,082573,Santa Maria de Miralles,3,2002,9,6
756,082592,Santa Maria de Palautordera,274,2002,535,261
757,431401,Santa Oliva,135,2002,294,159
758,171848,Santa Pau,-6,2002,40,46
759,082606,Santa Perpètua de Mogoda,219,2002,1307,1088
760,082613,Santa Susanna,163,2002,316,153
761,081923,Santpedor,111,2002,264,153
762,431423,Sarral,41,2002,93,52
763,171864,Sarrià de Ter,147,2002,263,116
764,252017,Sarroca de Bellera,3,2002,7,4
765,252000,Sarroca de Lleida,-8,2002,1,9
766,171870,"Saus, Camallera i Llampaies",1,2002,47,46
767,431439,Savallà del Comtat,6,2002,12,6
768,431444,"Secuita, la",-25,2002,49,74
769,171886,"Selva de Mar, la",2,2002,17,15
770,431457,"Selva del Camp, la",85,2002,186,101
771,431460,Senan,2,2002,2,0
772,430445,"Sénia, la",191,2002,435,244
773,252022,Senterada,0,2002,8,8
774,250352,"Sentiu de Sió, la",8,2002,21,13
775,082671,Sentmenat,305,2002,512,207
776,171903,Serinyà,31,2002,64,33
777,252043,Seròs,25,2002,62,37
778,171910,Serra de Daró,-1,2002,17,18
779,171925,Setcases,12,2002,18,6
780,252038,"Seu d'Urgell, la",132,2002,585,453
781,082690,Seva,96,2002,190,94
782,252056,Sidamon,92,2002,127,35
783,171931,Sils,151,2002,314,163
784,082704,Sitges,352,2002,1504,1152
785,170524,Siurana,-11,2002,2,13
786,082711,Sobremunt,-2,2002,3,5
787,252069,"Soleràs, el",-9,2002,16,25
788,431476,Solivella,-29,2002,0,29
789,252075,Solsona,274,2002,428,154
790,082726,Sora,10,2002,18,8
791,252081,Soriguera,2,2002,29,27
792,252094,Sort,52,2002,149,97
793,252108,Soses,27,2002,67,40
794,082732,Subirats,52,2002,148,96
795,252115,Sudanell,26,2002,39,13
796,252120,Sunyer,5,2002,7,2
797,082747,Súria,48,2002,189,141
798,171946,Susqueda,8,2002,14,6
799,082763,Tagamanent,15,2002,28,13
800,082779,Talamanca,7,2002,17,10
801,252154,Talarn,1,2002,18,17
802,252167,Talavera,1,2002,7,6
803,171959,"Tallada d'Empordà, la",1,2002,25,24
804,082785,Taradell,129,2002,301,172
805,431482,Tarragona,434,2002,3589,3155
806,252173,Tàrrega,328,2002,895,567
807,252189,Tarrés,-3,2002,1,4
808,252192,Tarroja de Segarra,-4,2002,2,6
809,082750,Tavèrnoles,5,2002,8,3
810,082802,Tavertet,7,2002,21,14
811,082819,Teià,61,2002,288,227
812,252206,Térmens,-27,2002,21,48
813,171962,Terrades,-2,2002,0,2
814,082798,Terrassa,1426,2002,6251,4825
815,082824,Tiana,277,2002,551,274
816,252213,Tírvia,12,2002,14,2
817,252228,Tiurana,-2,2002,0,2
818,431495,Tivenys,-4,2002,11,15
819,431508,Tivissa,24,2002,67,43
820,082830,Tona,292,2002,488,196
821,252234,Torà,4,2002,71,67
822,082845,Tordera,445,2002,890,445
823,082858,Torelló,82,2002,463,381
824,252249,"Torms, els",-6,2002,4,10
825,252252,Tornabous,20,2002,56,36
826,252271,"Torre de Cabdella, la",13,2002,23,10
827,082861,"Torre de Claramunt, la",188,2002,315,127
828,431515,"Torre de Fontaubella, la",6,2002,16,10
829,431520,"Torre de l'Espanyol, la",-16,2002,15,31
830,252265,Torrebesses,-8,2002,1,9
831,431536,Torredembarra,530,2002,1187,657
832,252287,Torrefarrera,127,2002,180,53
833,259078,Torrefeta i Florejacs,-6,2002,21,27
834,252304,Torregrossa,43,2002,98,55
835,252311,Torrelameu,-21,2002,17,38
836,082877,Torrelavit,4,2002,44,40
837,082883,Torrelles de Foix,84,2002,198,114
838,082896,Torrelles de Llobregat,147,2002,332,185
839,171978,Torrent,-8,2002,7,15
840,252326,Torres de Segre,-15,2002,43,58
841,252332,Torre-serona,7,2002,19,12
842,171984,Torroella de Fluvià,24,2002,48,24
843,171997,Torroella de Montgrí,262,2002,654,392
844,431541,Torroja del Priorat,11,2002,14,3
845,172001,Tortellà,0,2002,24,24
846,431554,Tortosa,943,2002,1813,870
847,172018,Toses,10,2002,22,12
848,172023,Tossa de Mar,15,2002,188,173
849,252347,Tremp,120,2002,305,185
850,172044,Ullà,55,2002,134,79
851,082900,Ullastrell,61,2002,132,71
852,172057,Ullastret,-3,2002,4,7
853,431567,Ulldecona,-96,2002,165,261
854,431573,Ulldemolins,13,2002,27,14
855,172039,Ultramort,-4,2002,4,8
856,172060,Urús,7,2002,11,4
857,082917,Vacarisses,277,2002,492,215
858,170144,"Vajol, la",-3,2002,4,7
859,172076,"Vall d'en Bas, la",34,2002,107,73
860,172082,"Vall de Bianya, la",5,2002,75,70
861,250432,"Vall de Boí, la",40,2002,70,30
862,259010,Vall de Cardós,-6,2002,16,22
863,082922,Vallbona d'Anoia,41,2002,83,42
864,252385,Vallbona de les Monges,0,2002,8,8
865,082938,Vallcebre,12,2002,22,10
866,431589,Vallclara,1,2002,7,6
867,252402,Vallfogona de Balaguer,7,2002,51,44
868,171707,Vallfogona de Ripollès,0,2002,10,10
869,431592,Vallfogona de Riucorb,19,2002,29,10
870,082943,Vallgorguina,109,2002,191,82
871,082956,Vallirana,552,2002,1031,479
872,172095,Vall-llobrega,98,2002,126,28
873,431606,Vallmoll,37,2002,93,56
874,082969,Vallromanes,71,2002,144,73
875,431613,Valls,425,2002,1135,710
876,259062,"Valls d'Aguilar, les",15,2002,27,12
877,252398,"Valls de Valira, les",10,2002,47,37
878,431628,Vandellòs i l'Hospitalet de l'Infant,-42,2002,170,212
879,259097,"Vansa i Fórnols, la",15,2002,18,3
880,082975,Veciana,9,2002,15,6
881,431634,"Vendrell, el",1361,2002,2669,1308
882,172109,Ventalló,3,2002,46,43
883,252424,Verdú,71,2002,124,53
884,172116,Verges,-2,2002,36,38
885,431649,Vespella de Gaià,20,2002,46,26
886,082981,Vic,249,2002,1545,1296
887,172121,Vidrà,-6,2002,5,11
888,172137,Vidreres,258,2002,526,268
889,252430,Vielha e Mijaran,182,2002,499,317
890,431652,Vilabella,-9,2002,19,28
891,172142,Vilabertran,-9,2002,31,40
892,172155,Vilablareix,4,2002,92,88
893,082994,Vilada,-9,2002,4,13
894,172174,Viladamat,7,2002,22,15
895,172168,Viladasens,-4,2002,0,4
896,083015,Viladecans,1,2002,2688,2687
897,083008,Viladecavalls,148,2002,434,286
898,172180,Vilademuls,20,2002,57,37
899,172207,Viladrau,41,2002,86,45
900,172214,Vilafant,54,2002,291,237
901,083054,Vilafranca del Penedès,1174,2002,2419,1245
902,252445,Vilagrassa,12,2002,33,21
903,172235,Vilajuïga,13,2002,76,63
904,431750,Vilalba dels Arcs,5,2002,16,11
905,083067,Vilalba Sasserra,28,2002,74,46
906,252458,Vilaller,-4,2002,27,31
907,172240,Vilallonga de Ter,21,2002,31,10
908,431665,Vilallonga del Camp,40,2002,91,51
909,172253,Vilamacolum,8,2002,22,14
910,172266,Vilamalla,9,2002,69,60
911,172272,Vilamaniscle,8,2002,13,5
912,252477,Vilamòs,8,2002,19,11
913,172288,Vilanant,24,2002,35,11
914,431671,Vilanova d'Escornalbou,10,2002,20,10
915,252483,Vilanova de Bellpuig,15,2002,34,19
916,252496,Vilanova de l'Aguda,-5,2002,1,6
917,252542,Vilanova de la Barca,5,2002,32,27
918,252509,Vilanova de Meià,-8,2002,13,21
919,431687,Vilanova de Prades,7,2002,11,4
920,083036,Vilanova de Sau,7,2002,15,8
921,252516,Vilanova de Segrià,-16,2002,16,32
922,083020,Vilanova del Camí,124,2002,511,387
923,089024,Vilanova del Vallès,198,2002,333,135
924,083073,Vilanova i la Geltrú,632,2002,2628,1996
925,431690,Vilaplana,-17,2002,30,47
926,431704,Vila-rodona,27,2002,71,44
927,172305,Vila-sacra,26,2002,59,33
928,252521,Vila-sana,25,2002,42,17
929,431711,Vila-seca,653,2002,1298,645
930,082140,Vilassar de Dalt,75,2002,392,317
931,082191,Vilassar de Mar,168,2002,1150,982
932,172229,Vilaür,13,2002,19,6
933,431726,Vilaverd,17,2002,30,13
934,431732,"Vilella Alta, la",-2,2002,0,2
935,431747,"Vilella Baixa, la",22,2002,27,5
936,172333,Vilobí d'Onyar,107,2002,201,94
937,083041,Vilobí del Penedès,28,2002,57,29
938,172327,Vilopriu,1,2002,6,5
939,252537,"Vilosell, el",36,2002,49,13
940,431763,Vimbodí i Poblet,21,2002,43,22
941,252555,Vinaixa,2,2002,20,18
942,431779,Vinebre,25,2002,31,6
943,431785,Vinyols i els Arcs,21,2002,150,129
944,083089,Viver i Serrateix,-3,2002,9,12
945,430521,Xerta,28,2002,65,37
0,250019,Abella de la Conca,6,2003,15,9
1,080018,Abrera,240,2003,771,531
2,250024,Àger,14,2003,28,14
3,250030,Agramunt,105,2003,298,193
4,080023,Aguilar de Segarra,9,2003,19,10
5,170010,Agullana,29,2003,65,36
6,080142,Aiguafreda,41,2003,145,104
7,430017,Aiguamúrcia,28,2003,57,29
8,170025,Aiguaviva,6,2003,35,29
9,250387,Aitona,19,2003,107,88
10,250045,"Alamús, els",24,2003,46,22
11,250058,Alàs i Cerc,7,2003,21,14
12,250061,"Albagés, l'",-13,2003,14,27
13,170031,Albanyà,15,2003,21,6
14,250077,Albatàrrec,57,2003,103,46
15,250083,Albesa,22,2003,50,28
16,250096,"Albi, l'",15,2003,36,21
17,430022,Albinyana,127,2003,262,135
18,430038,"Albiol, l'",53,2003,63,10
19,170046,Albons,-18,2003,25,43
20,430043,Alcanar,91,2003,410,319
21,250100,Alcanó,-1,2003,4,5
22,250117,Alcarràs,60,2003,199,139
23,250122,Alcoletge,89,2003,169,80
24,430056,Alcover,128,2003,249,121
25,439044,"Aldea, l'",-90,2003,31,121
26,430069,Aldover,3,2003,28,25
27,430075,"Aleixar, l'",-6,2003,38,44
28,080039,Alella,0,2003,512,512
29,430081,Alfara de Carles,5,2003,11,6
30,250138,Alfarràs,92,2003,164,72
31,250143,Alfés,0,2003,9,9
32,430094,Alforja,68,2003,134,66
33,250156,Algerri,4,2003,23,19
34,250169,Alguaire,51,2003,149,98
35,250175,Alins,-10,2003,3,13
36,430108,Alió,13,2003,27,14
37,250194,Almacelles,128,2003,296,168
38,250208,Almatret,2,2003,14,12
39,250215,Almenar,10,2003,105,95
40,430115,Almoster,32,2003,87,55
41,250220,Alòs de Balaguer,-3,2003,15,18
42,170062,Alp,-3,2003,94,97
43,080044,Alpens,-3,2003,9,12
44,250236,Alpicat,159,2003,344,185
45,250241,Alt Àneu,15,2003,33,18
46,430120,Altafulla,136,2003,357,221
47,170078,Amer,0,2003,65,65
48,430136,"Ametlla de Mar, l'",22,2003,265,243
49,080057,"Ametlla del Vallès, l'",321,2003,688,367
50,439060,"Ampolla, l'",139,2003,202,63
51,430141,Amposta,172,2003,680,508
52,170084,Anglès,25,2003,222,197
53,250273,Anglesola,41,2003,87,46
54,250292,Arbeca,-93,2003,6,99
55,430167,"Arboç, l'",212,2003,384,172
56,430154,Arbolí,-2,2003,2,4
57,170097,Arbúcies,246,2003,457,211
58,080060,Arenys de Mar,101,2003,843,742
59,080076,Arenys de Munt,184,2003,505,321
60,170101,Argelaguer,-17,2003,7,24
61,080082,Argençola,10,2003,20,10
62,430173,"Argentera, l'",6,2003,14,8
63,080095,Argentona,60,2003,577,517
64,170118,"Armentera, l'",-2,2003,27,29
65,430189,Arnes,11,2003,18,7
66,250313,Arres,8,2003,10,2
67,250328,Arsèguel,-7,2003,2,9
68,080109,Artés,63,2003,189,126
69,250334,Artesa de Lleida,2,2003,41,39
70,250349,Artesa de Segre,123,2003,262,139
71,430192,Ascó,14,2003,52,38
72,250365,Aspa,4,2003,13,9
73,250371,"Avellanes i Santa Linya, les",12,2003,24,12
74,080116,Avià,24,2003,100,76
75,080121,Avinyó,28,2003,74,46
76,170123,Avinyonet de Puigventós,29,2003,73,44
77,080137,Avinyonet del Penedès,81,2003,125,44
78,080155,Badalona,-2447,2003,8134,10581
79,089045,Badia del Vallès,-322,2003,647,969
80,080168,Bagà,26,2003,88,62
81,250390,Baix Pallars,16,2003,26,10
82,250404,Balaguer,130,2003,575,445
83,080174,Balenyà,129,2003,233,104
84,080180,Balsareny,-3,2003,101,104
85,430206,Banyeres del Penedès,154,2003,249,95
86,170157,Banyoles,228,2003,883,655
87,250411,Barbens,44,2003,80,36
88,430213,Barberà de la Conca,12,2003,36,24
89,082520,Barberà del Vallès,-137,2003,1265,1402
90,080193,Barcelona,-31164,2003,36689,67853
91,250426,"Baronia de Rialb, la",-2,2003,13,15
92,170160,Bàscara,26,2003,62,36
93,250447,Bassella,0,2003,9,9
94,430228,Batea,26,2003,73,47
95,250450,Bausen,-3,2003,1,4
96,080207,Begues,217,2003,477,260
97,170139,Begur,110,2003,316,206
98,250463,Belianes,0,2003,29,29
99,251706,Bellaguarda,0,2003,4,4
100,170182,Bellcaire d'Empordà,20,2003,50,30
101,250479,Bellcaire d'Urgell,10,2003,40,30
102,250485,Bell-lloc d'Urgell,10,2003,65,55
103,250498,Bellmunt d'Urgell,0,2003,4,4
104,430234,Bellmunt del Priorat,7,2003,18,11
105,080214,Bellprat,-1,2003,5,6
106,250501,Bellpuig,39,2003,204,165
107,430249,Bellvei,-25,2003,99,124
108,250518,Bellver de Cerdanya,56,2003,155,99
109,250523,Bellvís,44,2003,135,91
110,250539,Benavent de Segrià,50,2003,89,39
111,430252,Benifallet,-24,2003,0,24
112,430265,Benissanet,17,2003,53,36
113,080229,Berga,405,2003,925,520
114,170195,Besalú,62,2003,144,82
115,170209,Bescanó,113,2003,234,121
116,170216,Beuda,3,2003,22,19
117,080235,Bigues i Riells del Fai,215,2003,601,386
118,250557,Biosca,5,2003,16,11
119,170221,"Bisbal d'Empordà, la",263,2003,630,367
120,430271,"Bisbal de Falset, la",0,2003,3,3
121,430287,"Bisbal del Penedès, la",154,2003,330,176
122,172348,Biure,6,2003,21,15
123,430290,Blancafort,1,2003,24,23
124,170237,Blanes,340,2003,1923,1583
125,170293,Boadella i les Escaules,2,2003,11,9
126,170242,Bolvir,6,2003,29,23
127,430304,Bonastre,-2,2003,41,43
128,250576,"Bòrdes, Es",11,2003,19,8
129,170255,Bordils,-5,2003,58,63
130,250582,"Borges Blanques, les",76,2003,222,146
131,430311,"Borges del Camp, les",73,2003,149,76
132,170268,Borrassà,38,2003,64,26
133,080240,Borredà,13,2003,42,29
134,250595,Bossòst,6,2003,66,60
135,430326,Bot,-7,2003,22,29
136,430332,Botarell,24,2003,94,70
137,250560,Bovera,6,2003,16,10
138,430347,Bràfim,14,2003,43,29
139,170274,Breda,22,2003,198,176
140,080253,"Bruc, el",57,2003,166,109
141,080266,"Brull, el",7,2003,18,11
142,170280,Brunyola i Sant Martí Sapresa,-1,2003,15,16
143,430350,Cabacés,-4,2003,3,7
144,250609,Cabanabona,24,2003,28,4
145,170314,Cabanelles,5,2003,15,10
146,170307,Cabanes,40,2003,78,38
147,080272,"Cabanyes, les",39,2003,76,37
148,250616,Cabó,0,2003,0,0
149,430363,Cabra del Camp,57,2003,129,72
150,080288,Cabrera d'Anoia,94,2003,163,69
151,080291,Cabrera de Mar,130,2003,316,186
152,080305,Cabrils,244,2003,558,314
153,170329,Cadaqués,133,2003,214,81
154,080312,Calaf,112,2003,231,119
155,430379,Calafell,1501,2003,2708,1207
156,080348,Calders,21,2003,49,28
157,080327,Caldes d'Estrac,162,2003,318,156
158,170335,Caldes de Malavella,291,2003,525,234
159,080333,Caldes de Montbui,364,2003,925,561
160,080351,Calella,780,2003,1764,984
161,080370,Calldetenes,47,2003,117,70
162,080386,Callús,21,2003,87,66
163,080364,Calonge de Segarra,9,2003,9,0
164,170340,Calonge i Sant Antoni,535,2003,982,447
165,250621,Camarasa,27,2003,47,20
166,439039,Camarles,13,2003,80,67
167,430385,Cambrils,1140,2003,2496,1356
168,170353,Camós,-1,2003,26,27
169,170366,Campdevànol,28,2003,136,108
170,170372,Campelles,-2,2003,1,3
171,080399,Campins,21,2003,36,15
172,170388,Campllong,10,2003,29,19
173,170391,Camprodon,54,2003,164,110
174,250637,Canejan,3,2003,3,0
175,170405,Canet d'Adri,22,2003,44,22
176,080403,Canet de Mar,403,2003,857,454
177,080410,Canovelles,351,2003,1176,825
178,080425,Cànoves i Samalús,140,2003,252,112
179,170412,Cantallops,3,2003,12,9
180,080431,Canyelles,306,2003,493,187
181,430398,Capafonts,-10,2003,3,13
182,430402,Capçanes,5,2003,10,5
183,080446,Capellades,64,2003,281,217
184,170427,Capmany,7,2003,39,32
185,080459,Capolat,8,2003,15,7
186,080462,Cardedeu,562,2003,1241,679
187,080478,Cardona,-9,2003,122,131
188,080484,Carme,4,2003,30,26
189,430419,Caseres,4,2003,7,3
190,170448,Cassà de la Selva,59,2003,390,331
191,080497,Casserres,3,2003,45,42
192,080575,Castell de l'Areny,-1,2003,1,2
193,259046,Castell de Mur,10,2003,12,2
194,250642,Castellar de la Ribera,-5,2003,4,9
195,080522,Castellar de n'Hug,0,2003,19,19
196,080500,Castellar del Riu,-2,2003,15,17
197,080517,Castellar del Vallès,471,2003,1216,745
198,080538,Castellbell i el Vilar,95,2003,250,155
199,080543,Castellbisbal,455,2003,989,534
200,080556,Castellcir,53,2003,84,31
201,250674,Castelldans,-13,2003,24,37
202,080569,Castelldefels,-11,2003,3800,3811
203,080581,Castellet i la Gornal,128,2003,217,89
204,170464,Castellfollit de la Roca,-3,2003,52,55
205,080608,Castellfollit de Riubregós,2,2003,15,13
206,080594,Castellfollit del Boix,14,2003,36,22
207,080615,Castellgalí,91,2003,151,60
208,080620,Castellnou de Bages,65,2003,113,48
209,250680,Castellnou de Seana,12,2003,37,25
210,170470,Castelló d'Empúries,577,2003,1070,493
211,250693,Castelló de Farfanya,23,2003,41,18
212,080636,Castellolí,19,2003,32,13
213,170486,Castell-Platja d'Aro,505,2003,1109,604
214,250707,Castellserà,-3,2003,40,43
215,080641,Castellterçol,25,2003,134,109
216,430424,Castellvell del Camp,239,2003,331,92
217,080654,Castellví de la Marca,29,2003,93,64
218,080667,Castellví de Rosanes,22,2003,95,73
219,430430,"Catllar, el",219,2003,333,114
220,250714,Cava,2,2003,5,3
221,171899,"Cellera de Ter, la",-3,2003,65,68
222,170499,Celrà,142,2003,285,143
223,080673,Centelles,133,2003,299,166
224,082687,Cercs,-24,2003,42,66
225,082665,Cerdanyola del Vallès,328,2003,3037,2709
226,080689,Cervelló,147,2003,591,444
227,250729,Cervera,188,2003,628,440
228,250735,Cervià de les Garrigues,14,2003,50,36
229,170502,Cervià de Ter,28,2003,56,28
230,170519,Cistella,3,2003,12,9
231,250740,Ciutadilla,18,2003,32,14
232,250753,Clariana de Cardener,0,2003,6,6
233,250766,"Cogul, el",-3,2003,8,11
234,170545,Colera,56,2003,163,107
235,250772,Coll de Nargó,14,2003,28,14
236,080692,Collbató,224,2003,385,161
237,430458,Colldejou,0,2003,6,6
238,080706,Collsuspina,10,2003,20,10
239,170558,Colomers,-4,2003,0,4
240,251636,"Coma i la Pedra, la",10,2003,27,17
241,251615,Conca de Dalt,12,2003,23,11
242,430461,Conesa,6,2003,20,14
243,430477,Constantí,25,2003,296,271
244,080713,Copons,-3,2003,9,12
245,430483,Corbera d'Ebre,33,2003,46,13
246,080728,Corbera de Llobregat,177,2003,830,653
247,250788,Corbins,20,2003,57,37
248,170577,Corçà,37,2003,90,53
249,080734,Cornellà de Llobregat,-886,2003,3630,4516
250,170561,Cornellà del Terri,61,2003,135,74
251,430496,Cornudella de Montsant,29,2003,53,24
252,430509,Creixell,102,2003,269,167
253,170583,Crespià,2,2003,22,20
254,179011,"Cruïlles, Monells i Sant Sadurní de l'Heura",54,2003,124,70
255,080749,Cubelles,866,2003,1446,580
256,250791,Cubells,10,2003,25,15
257,430516,Cunit,612,2003,1339,727
258,170600,Darnius,-1,2003,32,33
259,170617,Das,5,2003,13,8
260,439018,Deltebre,157,2003,359,202
261,080752,Dosrius,232,2003,449,217
262,430537,Duesaigües,4,2003,14,10
263,170622,"Escala, l'",457,2003,802,345
264,080765,Esparreguera,538,2003,1552,1014
265,170638,Espinelves,-6,2003,8,14
266,250812,"Espluga Calba, l'",-10,2003,20,30
267,430542,"Espluga de Francolí, l'",34,2003,173,139
268,080771,Esplugues de Llobregat,-452,2003,2494,2946
269,170643,Espolla,17,2003,24,7
270,170656,Esponellà,12,2003,21,9
271,250827,Espot,24,2003,45,21
272,080787,"Espunyola, l'",5,2003,15,10
273,082541,"Esquirol, l'",-15,2003,82,97
274,250886,Estamariu,-1,2003,0,1
275,080790,"Estany, l'",-3,2003,11,14
276,250851,Estaràs,-5,2003,6,11
277,250864,Esterri d'Àneu,45,2003,111,66
278,250870,Esterri de Cardós,-1,2003,2,3
279,430555,Falset,2,2003,62,60
280,170059,"Far d'Empordà, el",22,2003,35,13
281,250899,Farrera,3,2003,8,5
282,430568,"Fatarella, la",-3,2003,22,25
283,430574,"Febró, la",-2,2003,4,6
284,081347,Figaró-Montmany,56,2003,114,58
285,080804,Fígols,-3,2003,3,6
286,259084,Fígols i Alinyà,0,2003,7,7
287,430580,"Figuera, la",82,2003,147,65
288,170669,Figueres,840,2003,2636,1796
289,430593,Figuerola del Camp,4,2003,24,20
290,170675,Flaçà,18,2003,59,41
291,430607,Flix,-61,2003,88,149
292,250925,"Floresta, la",-2,2003,11,13
293,080826,Fogars de la Selva,132,2003,201,69
294,080811,Fogars de Montclús,17,2003,33,16
295,170681,Foixà,14,2003,20,6
296,080832,Folgueroles,32,2003,90,58
297,250931,Fondarella,16,2003,51,35
298,080847,Fonollosa,74,2003,114,40
299,170694,Fontanals de Cerdanya,12,2003,30,18
300,170708,Fontanilles,-3,2003,7,10
301,170715,Fontcoberta,-10,2003,50,60
302,080850,Font-rubí,44,2003,90,46
303,250946,Foradada,21,2003,35,14
304,179026,Forallac,29,2003,106,77
305,430614,Forès,-1,2003,3,4
306,170736,Fornells de la Selva,59,2003,99,40
307,170741,Fortià,14,2003,39,25
308,080863,"Franqueses del Vallès, les",577,2003,1363,786
309,430629,Freginals,7,2003,17,10
310,250962,"Fuliola, la",12,2003,44,32
311,250978,Fulleda,-1,2003,4,5
312,080902,Gaià,0,2003,12,12
313,430635,"Galera, la",-5,2003,21,26
314,080879,Gallifa,11,2003,27,16
315,430640,Gandesa,101,2003,175,74
316,430653,Garcia,-1,2003,19,20
317,430666,"Garidells, els",5,2003,14,9
318,080885,"Garriga, la",119,2003,634,515
319,170754,Garrigàs,6,2003,16,10
320,170767,Garrigoles,-2,2003,2,4
321,170773,Garriguella,20,2003,54,34
322,080898,Gavà,850,2003,3343,2493
323,250984,Gavet de la Conca,13,2003,19,6
324,080919,Gelida,421,2003,623,202
325,170789,Ger,19,2003,44,25
326,259123,Gimenells i el Pla de la Font,18,2003,46,28
327,430672,Ginestar,34,2003,65,31
328,170792,Girona,2201,2003,6150,3949
329,080924,Gironella,58,2003,166,108
330,080930,Gisclareny,3,2003,4,1
331,430688,Godall,1,2003,24,23
332,250997,Golmés,9,2003,77,68
333,170806,Gombrèn,-2,2003,8,10
334,251001,Gósol,-2,2003,8,10
335,080945,"Granada, la",45,2003,105,60
336,251018,"Granadella, la",8,2003,29,21
337,080958,Granera,2,2003,12,10
338,251023,"Granja d'Escarp, la",-4,2003,36,40
339,080961,Granollers,541,2003,3870,3329
340,251039,Granyanella,-8,2003,0,8
341,251057,Granyena de les Garrigues,5,2003,16,11
342,251044,Granyena de Segarra,-3,2003,0,3
343,430691,Gratallops,6,2003,14,8
344,080977,Gualba,35,2003,119,84
345,170813,Gualta,-1,2003,15,16
346,080996,Guardiola de Berguedà,20,2003,59,39
347,430705,"Guiamets, els",10,2003,15,5
348,170828,Guils de Cerdanya,22,2003,41,19
349,251095,Guimerà,10,2003,29,19
350,259031,"Guingueta d'Àneu, la",3,2003,27,24
351,251109,Guissona,290,2003,573,283
352,251116,Guixers,-17,2003,2,19
353,081000,Gurb,63,2003,132,69
354,430712,Horta de Sant Joan,25,2003,46,21
355,081017,"Hospitalet de Llobregat, l'",4314,2003,20368,16054
356,081629,"Hostalets de Pierola, els",88,2003,212,124
357,170834,Hostalric,175,2003,292,117
358,081022,Igualada,528,2003,1861,1333
359,251155,Isona i Conca Dellà,7,2003,50,43
360,170849,Isòvol,0,2003,10,10
361,251137,Ivars d'Urgell,7,2003,77,70
362,251121,Ivars de Noguera,9,2003,16,7
363,251142,Ivorra,-1,2003,1,2
364,170852,Jafre,12,2003,29,17
365,170865,"Jonquera, la",111,2003,301,190
366,081038,Jorba,38,2003,73,35
367,259101,Josa i Tuixén,-8,2003,7,15
368,170871,Juià,24,2003,32,8
369,251180,Juncosa,14,2003,30,16
370,251193,Juneda,70,2003,170,100
371,251214,Les,34,2003,74,40
372,251229,Linyola,27,2003,113,86
373,081043,"Llacuna, la",7,2003,41,34
374,170887,Lladó,21,2003,37,16
375,251235,Lladorre,-1,2003,2,3
376,251240,Lladurs,3,2003,11,8
377,081056,"Llagosta, la",247,2003,980,733
378,170890,Llagostera,258,2003,497,239
379,170904,Llambilles,17,2003,47,30
380,170911,Llanars,23,2003,40,17
381,170926,Llançà,140,2003,288,148
382,251253,Llardecans,-5,2003,4,9
383,251266,Llavorsí,43,2003,63,20
384,251207,Lleida,2157,2003,6074,3917
385,170932,Llers,31,2003,74,43
386,251272,Lles de Cerdanya,-13,2003,0,13
387,081075,Lliçà d'Amunt,528,2003,1175,647
388,081081,Lliçà de Vall,150,2003,422,272
389,251288,Llimiana,12,2003,29,17
390,081069,Llinars del Vallès,149,2003,627,478
391,170947,Llívia,34,2003,119,85
392,430727,"Lloar, el",9,2003,14,5
393,251291,Llobera,2,2003,6,4
394,430733,Llorac,1,2003,13,12
395,430748,Llorenç del Penedès,65,2003,146,81
396,170950,Lloret de Mar,1785,2003,3053,1268
397,170963,"Llosses, les",1,2003,16,15
398,081094,Lluçà,3,2003,9,6
399,171024,Maçanet de Cabrenys,30,2003,67,37
400,171030,Maçanet de la Selva,367,2003,604,237
401,170979,Madremanya,10,2003,19,9
402,170985,Maià de Montcal,22,2003,61,39
403,251333,Maials,14,2003,29,15
404,251305,Maldà,3,2003,14,11
405,081108,Malgrat de Mar,708,2003,1456,748
406,081115,Malla,11,2003,11,0
407,081120,Manlleu,305,2003,929,624
408,081136,Manresa,1187,2003,3465,2278
409,430764,Marçà,-3,2003,15,18
410,430751,Margalef,5,2003,6,1
411,082423,Marganell,-2,2003,21,23
412,081141,Martorell,64,2003,1355,1291
413,081154,Martorelles,-26,2003,275,301
414,430770,Mas de Barberans,7,2003,18,11
415,171002,Masarac,3,2003,15,12
416,430786,Masdenverge,21,2003,59,38
417,081167,"Masies de Roda, les",6,2003,38,32
418,081173,"Masies de Voltregà, les",70,2003,162,92
419,430799,Masllorenç,12,2003,35,23
420,081189,"Masnou, el",-127,2003,974,1101
421,430803,"Masó, la",0,2003,15,15
422,430810,Maspujols,17,2003,37,20
423,081192,Masquefa,424,2003,811,387
424,430825,"Masroig, el",9,2003,25,16
425,251312,Massalcoreig,8,2003,19,11
426,171019,Massanes,11,2003,52,41
427,251327,Massoteres,-9,2003,29,38
428,081206,Matadepera,114,2003,420,306
429,081213,Mataró,2205,2003,5905,3700
430,081228,Mediona,121,2003,228,107
431,251348,Menàrguens,14,2003,46,32
432,170998,Meranges,4,2003,5,1
433,171058,Mieres,10,2003,23,13
434,430831,"Milà, el",17,2003,25,8
435,251351,Miralcamp,21,2003,63,42
436,430846,Miravet,5,2003,28,23
437,081385,Moià,227,2003,384,157
438,430859,"Molar, el",0,2003,9,9
439,081234,Molins de Rei,486,2003,1254,768
440,251370,Mollerussa,453,2003,902,449
441,171061,Mollet de Peralada,3,2003,13,10
442,081249,Mollet del Vallès,-394,2003,2434,2828
443,171077,Molló,9,2003,19,10
444,251364,"Molsosa, la",3,2003,3,0
445,081287,Monistrol de Calders,37,2003,55,18
446,081271,Monistrol de Montserrat,42,2003,148,106
447,171096,Montagut i Oix,20,2003,64,44
448,430862,Montblanc,108,2003,315,207
449,430884,Montbrió del Camp,37,2003,97,60
450,081252,Montcada i Reixac,535,2003,2060,1525
451,081304,Montclar,4,2003,7,3
452,251399,Montellà i Martinet,10,2003,41,31
453,081311,Montesquiu,18,2003,53,35
454,251403,Montferrer i Castellbò,54,2003,95,41
455,430897,Montferri,26,2003,44,18
456,251386,Montgai,-18,2003,12,30
457,081265,Montgat,64,2003,566,502
458,081326,Montmajor,3,2003,22,19
459,081332,Montmaneu,3,2003,13,10
460,430901,"Montmell, el",109,2003,177,68
461,081350,Montmeló,-115,2003,329,444
462,251425,Montoliu de Lleida,15,2003,24,9
463,251410,Montoliu de Segarra,1,2003,10,9
464,251431,Montornès de Segarra,1,2003,3,2
465,081363,Montornès del Vallès,154,2003,818,664
466,430918,Mont-ral,12,2003,19,7
467,171100,Mont-ras,-50,2003,40,90
468,430923,Mont-roig del Camp,199,2003,633,434
469,081379,Montseny,-2,2003,11,13
470,430939,Móra d'Ebre,65,2003,227,162
471,430944,Móra la Nova,-23,2003,131,154
472,430957,"Morell, el",82,2003,213,131
473,430960,"Morera de Montsant, la",8,2003,21,13
474,081290,Muntanyola,33,2003,52,19
475,081398,Mura,-13,2003,4,17
476,251459,Nalec,0,2003,6,6
477,250254,Naut Aran,79,2003,154,75
478,081402,Navarcles,87,2003,253,166
479,081419,Navàs,52,2003,182,130
480,171117,Navata,35,2003,74,39
481,251462,Navès,-1,2003,9,10
482,081424,"Nou de Berguedà, la",4,2003,7,3
483,430976,"Nou de Gaià, la",4,2003,24,20
484,430982,Nulles,-14,2003,12,26
485,251484,Odèn,1,2003,5,4
486,081430,Òdena,74,2003,172,98
487,171122,Ogassa,3,2003,16,13
488,081458,Olèrdola,56,2003,200,144
489,081461,Olesa de Bonesvalls,97,2003,165,68
490,081477,Olesa de Montserrat,454,2003,1223,769
491,251497,Oliana,32,2003,76,44
492,251500,Oliola,-15,2003,6,21
493,251517,Olius,22,2003,45,23
494,081483,Olivella,275,2003,398,123
495,081496,Olost,-5,2003,33,38
496,171143,Olot,792,2003,1680,888
497,251522,"Oluges, les",3,2003,6,3
498,081445,Olvan,11,2003,50,39
499,251538,"Omellons, els",6,2003,10,4
500,251543,"Omells de na Gaia, els",2,2003,11,9
501,171156,Ordis,-7,2003,3,10
502,251556,Organyà,-12,2003,43,55
503,081509,Orís,8,2003,15,7
504,081516,Oristà,-15,2003,10,25
505,081521,Orpí,30,2003,50,20
506,081537,Òrrius,-25,2003,0,25
507,251569,Os de Balaguer,-13,2003,23,36
508,171169,Osor,-17,2003,4,21
509,251575,Ossó de Sió,-13,2003,3,16
510,081542,Pacs del Penedès,40,2003,68,28
511,081555,Palafolls,276,2003,588,312
512,171175,Palafrugell,491,2003,1231,740
513,171181,Palamós,315,2003,1014,699
514,251581,"Palau d'Anglesola, el",38,2003,86,48
515,171194,Palau de Santa Eulàlia,-2,2003,5,7
516,171215,Palau-sator,-3,2003,18,21
517,171208,Palau-saverdera,53,2003,105,52
518,081568,Palau-solità i Plegamans,396,2003,960,564
519,431009,"Pallaresos, els",154,2003,324,170
520,081574,Pallejà,229,2003,667,438
521,430995,"Palma d'Ebre, la",-1,2003,3,4
522,089058,"Palma de Cervelló, la",18,2003,184,166
523,171236,Palol de Revardit,8,2003,20,12
524,171241,Pals,74,2003,181,107
525,081580,"Papiol, el",20,2003,173,153
526,171254,Pardines,7,2003,9,2
527,081593,Parets del Vallès,57,2003,990,933
528,171267,Parlavà,2,2003,14,12
529,431016,Passanant i Belltall,-4,2003,23,27
530,171289,Pau,4,2003,24,20
531,431021,Paüls,-2,2003,7,9
532,171292,Pedret i Marzà,4,2003,12,8
533,251641,Penelles,-14,2003,15,29
534,171306,"Pera, la",7,2003,25,18
535,081607,Perafita,12,2003,22,10
536,431037,Perafort,36,2003,76,40
537,171328,Peralada,83,2003,138,55
538,251654,Peramola,2,2003,15,13
539,431042,"Perelló, el",5,2003,69,64
540,081614,Piera,781,2003,1341,560
541,431055,"Piles, les",4,2003,15,11
542,081635,Pineda de Mar,757,2003,2217,1460
543,431068,"Pinell de Brai, el",16,2003,37,21
544,251667,Pinell de Solsonès,2,2003,5,3
545,251673,Pinós,10,2003,16,6
546,431074,Pira,12,2003,20,8
547,431080,"Pla de Santa Maria, el",93,2003,162,69
548,081640,"Pla del Penedès, el",-2,2003,44,46
549,171334,"Planes d'Hostoles, les",11,2003,50,39
550,171349,Planoles,12,2003,30,18
551,259118,"Plans de Sió, els",-7,2003,2,9
552,251689,"Poal, el",-6,2003,14,20
553,251692,"Pobla de Cérvoles, la",6,2003,11,5
554,081653,"Pobla de Claramunt, la",74,2003,160,86
555,081666,"Pobla de Lillet, la",26,2003,65,39
556,431093,"Pobla de Mafumet, la",47,2003,82,35
557,431107,"Pobla de Massaluca, la",12,2003,29,17
558,431114,"Pobla de Montornès, la",174,2003,273,99
559,251713,"Pobla de Segur, la",80,2003,194,114
560,431129,Poboleda,14,2003,23,9
561,081672,Polinyà,282,2003,569,287
562,431135,"Pont d'Armentera, el",19,2003,48,29
563,250306,"Pont de Bar, el",1,2003,3,2
564,171352,Pont de Molins,-4,2003,34,38
565,251734,"Pont de Suert, el",75,2003,180,105
566,081825,"Pont de Vilomara i Rocafort, el",151,2003,247,96
567,431418,Pontils,6,2003,14,8
568,081688,Pontons,23,2003,72,49
569,171365,Pontós,-8,2003,3,11
570,251728,Ponts,20,2003,108,88
571,171371,Porqueres,70,2003,211,141
572,431140,Porrera,27,2003,36,9
573,171404,"Port de la Selva, el",3,2003,65,62
574,171387,Portbou,-5,2003,48,53
575,251749,"Portella, la",48,2003,91,43
576,431153,Pradell de la Teixeta,6,2003,11,5
577,431166,Prades,21,2003,47,26
578,431172,Prat de Comte,4,2003,5,1
579,081691,"Prat de Llobregat, el",-736,2003,1889,2625
580,431188,Pratdip,22,2003,74,52
581,081712,Prats de Lluçanès,-11,2003,73,84
582,081705,"Prats de Rei, els",15,2003,38,23
583,251752,Prats i Sansor,5,2003,14,9
584,251765,Preixana,-11,2003,6,17
585,251771,Preixens,-10,2003,21,31
586,082303,Premià de Dalt,171,2003,663,492
587,081727,Premià de Mar,250,2003,1942,1692
588,171390,"Preses, les",76,2003,123,47
589,251790,Prullans,21,2003,37,16
590,171411,Puigcerdà,399,2003,818,419
591,081748,Puigdàlber,12,2003,32,20
592,251804,Puiggròs,-3,2003,10,13
593,431191,Puigpelat,22,2003,68,46
594,081751,Puig-reig,1,2003,142,141
595,251811,Puigverd d'Agramunt,-17,2003,10,27
596,251826,Puigverd de Lleida,49,2003,76,27
597,081764,Pujalt,9,2003,12,3
598,081770,"Quar, la",3,2003,4,1
599,171426,Quart,21,2003,150,129
600,170433,Queralbs,6,2003,7,1
601,431205,Querol,7,2003,40,33
602,171432,Rabós,9,2003,18,9
603,081786,Rajadell,45,2003,91,46
604,431212,Rasquera,16,2003,29,13
605,171447,Regencós,16,2003,39,23
606,081799,Rellinars,24,2003,44,20
607,431227,Renau,9,2003,10,1
608,431233,Reus,665,2003,4118,3453
609,251832,Rialp,16,2003,54,38
610,431248,"Riba, la",-2,2003,31,33
611,431251,Riba-roja d'Ebre,29,2003,82,53
612,259059,Ribera d'Ondara,-4,2003,11,15
613,251850,Ribera d'Urgellet,30,2003,92,62
614,171450,Ribes de Freser,23,2003,105,82
615,171463,Riells i Viabrea,270,2003,454,184
616,431264,"Riera de Gaià, la",64,2003,120,56
617,251863,Riner,-3,2003,7,10
618,171479,Ripoll,31,2003,348,317
619,081803,Ripollet,229,2003,1882,1653
620,259139,Riu de Cerdanya,14,2003,24,10
621,171485,Riudarenes,151,2003,240,89
622,171498,Riudaura,-7,2003,17,24
623,431270,Riudecanyes,18,2003,51,33
624,431286,Riudecols,43,2003,79,36
625,171501,Riudellots de la Selva,12,2003,78,66
626,431299,Riudoms,89,2003,323,234
627,171518,Riumors,-10,2003,0,10
628,081810,"Roca del Vallès, la",286,2003,693,407
629,431303,Rocafort de Queralt,-12,2003,7,19
630,431310,Roda de Berà,217,2003,543,326
631,081831,Roda de Ter,46,2003,235,189
632,431325,Rodonyà,31,2003,54,23
633,431331,Roquetes,189,2003,466,277
634,171523,Roses,736,2003,1295,559
635,251898,Rosselló,105,2003,190,85
636,431346,"Rourell, el",1,2003,23,22
637,081846,Rubí,365,2003,3004,2639
638,081859,Rubió,3,2003,9,6
639,171539,Rupià,14,2003,19,5
640,089019,Rupit i Pruit,-10,2003,8,18
641,081878,Sabadell,2421,2003,8648,6227
642,081884,Sagàs,-6,2003,2,8
643,251902,Salàs de Pallars,16,2003,28,12
644,081901,Saldes,13,2003,30,17
645,171544,Sales de Llierca,1,2003,3,2
646,081918,Sallent,11,2003,203,192
647,431359,Salomó,-12,2003,4,16
648,439057,Salou,1431,2003,2808,1377
649,171557,Salt,1519,2003,3188,1669
650,251919,Sanaüja,10,2003,23,13
651,081944,Sant Adrià de Besòs,2,2003,1870,1868
652,081957,Sant Agustí de Lluçanès,1,2003,11,10
653,081960,Sant Andreu de la Barca,183,2003,1568,1385
654,081976,Sant Andreu de Llavaneres,294,2003,771,477
655,171576,Sant Andreu Salou,7,2003,9,2
656,171833,Sant Aniol de Finestres,2,2003,19,17
657,081982,Sant Antoni de Vilamajor,252,2003,447,195
658,081995,Sant Bartomeu del Grau,-53,2003,31,84
659,082009,Sant Boi de Llobregat,-397,2003,3076,3473
660,082016,Sant Boi de Lluçanès,3,2003,29,26
661,431362,Sant Carles de la Ràpita,288,2003,646,358
662,082037,Sant Cebrià de Vallalta,128,2003,295,167
663,082021,Sant Celoni,524,2003,1065,541
664,082042,Sant Climent de Llobregat,76,2003,251,175
665,171582,Sant Climent Sescebes,25,2003,47,22
666,082055,Sant Cugat del Vallès,2029,2003,4866,2837
667,082068,Sant Cugat Sesgarrigues,39,2003,72,33
668,251961,Sant Esteve de la Sarga,9,2003,18,9
669,082074,Sant Esteve de Palautordera,123,2003,228,105
670,082080,Sant Esteve Sesrovires,145,2003,439,294
671,171595,Sant Feliu de Buixalleu,30,2003,58,28
672,082107,Sant Feliu de Codines,140,2003,428,288
673,171609,Sant Feliu de Guíxols,481,2003,1108,627
674,082114,Sant Feliu de Llobregat,251,2003,2176,1925
675,171616,Sant Feliu de Pallerols,1,2003,32,31
676,082129,Sant Feliu Sasserra,6,2003,22,16
677,171621,Sant Ferriol,-8,2003,16,24
678,082093,Sant Fost de Campsentelles,185,2003,617,432
679,082135,Sant Fruitós de Bages,245,2003,508,263
680,171637,Sant Gregori,95,2003,194,99
681,251924,Sant Guim de Freixenet,43,2003,99,56
682,251977,Sant Guim de la Plana,10,2003,18,8
683,171642,Sant Hilari Sacalm,125,2003,274,149
684,082153,Sant Hipòlit de Voltregà,35,2003,154,119
685,081939,Sant Iscle de Vallalta,11,2003,78,67
686,439023,Sant Jaume d'Enveja,10,2003,81,71
687,082166,Sant Jaume de Frontanyà,-1,2003,3,4
688,171655,Sant Jaume de Llierca,16,2003,43,27
689,431378,Sant Jaume dels Domenys,70,2003,193,123
690,171674,Sant Joan de les Abadesses,31,2003,138,107
691,171680,Sant Joan de Mollet,15,2003,26,11
692,082188,Sant Joan de Vilatorrada,118,2003,454,336
693,082172,Sant Joan Despí,180,2003,1840,1660
694,171851,Sant Joan les Fonts,-17,2003,101,118
695,171668,Sant Jordi Desvalls,6,2003,36,30
696,089030,Sant Julià de Cerdanyola,20,2003,24,4
697,171693,Sant Julià de Ramis,110,2003,225,115
698,082205,Sant Julià de Vilatorta,48,2003,154,106
699,179032,Sant Julià del Llor i Bonmatí,-9,2003,72,81
700,082212,Sant Just Desvern,389,2003,1103,714
701,082227,Sant Llorenç d'Hortons,94,2003,184,90
702,171714,Sant Llorenç de la Muga,15,2003,20,5
703,251930,Sant Llorenç de Morunys,22,2003,70,48
704,082233,Sant Llorenç Savall,77,2003,173,96
705,082251,Sant Martí d'Albars,-3,2003,3,6
706,082248,Sant Martí de Centelles,21,2003,76,55
707,171729,Sant Martí de Llémena,21,2003,45,24
708,259025,Sant Martí de Riucorb,14,2003,29,15
709,082264,Sant Martí de Tous,13,2003,51,38
710,082270,Sant Martí Sarroca,75,2003,195,120
711,082286,Sant Martí Sesgueioles,-11,2003,3,14
712,171735,Sant Martí Vell,-4,2003,8,12
713,082299,Sant Mateu de Bages,-5,2003,13,18
714,171740,Sant Miquel de Campmajor,1,2003,12,11
715,171753,Sant Miquel de Fluvià,48,2003,77,29
716,171766,Sant Mori,3,2003,9,6
717,171772,Sant Pau de Segúries,-1,2003,33,34
718,082310,Sant Pere de Ribes,592,2003,2043,1451
719,082325,Sant Pere de Riudebitlles,-1,2003,93,94
720,082331,Sant Pere de Torelló,21,2003,88,67
721,082346,Sant Pere de Vilamajor,203,2003,394,191
722,171788,Sant Pere Pescador,3,2003,99,96
723,081897,Sant Pere Sallavinera,5,2003,8,3
724,082359,Sant Pol de Mar,190,2003,422,232
725,082362,Sant Quintí de Mediona,65,2003,148,83
726,082378,Sant Quirze de Besora,29,2003,89,60
727,082384,Sant Quirze del Vallès,871,2003,1526,655
728,082397,Sant Quirze Safaja,72,2003,114,42
729,251945,Sant Ramon,1,2003,11,10
730,082401,Sant Sadurní d'Anoia,323,2003,656,333
731,082418,Sant Sadurní d'Osormort,6,2003,10,4
732,080983,Sant Salvador de Guardiola,223,2003,361,138
733,082628,Sant Vicenç de Castellet,66,2003,354,288
734,082649,Sant Vicenç de Montalt,212,2003,507,295
735,082652,Sant Vicenç de Torelló,18,2003,97,79
736,082634,Sant Vicenç dels Horts,375,2003,1486,1111
737,431384,Santa Bàrbara,20,2003,133,113
738,082439,Santa Cecília de Voltregà,5,2003,10,5
739,082444,Santa Coloma de Cervelló,352,2003,624,272
740,171805,Santa Coloma de Farners,125,2003,464,339
741,082457,Santa Coloma de Gramenet,-1695,2003,5205,6900
742,431397,Santa Coloma de Queralt,5,2003,101,96
743,171812,Santa Cristina d'Aro,222,2003,425,203
744,082460,Santa Eugènia de Berga,11,2003,85,74
745,082476,Santa Eulàlia de Riuprimer,4,2003,27,23
746,082482,Santa Eulàlia de Ronçana,293,2003,594,301
747,082495,Santa Fe del Penedès,4,2003,8,4
748,171827,Santa Llogaia d'Àlguema,-4,2003,13,17
749,082508,Santa Margarida de Montbui,53,2003,471,418
750,082515,Santa Margarida i els Monjos,68,2003,404,336
751,082589,Santa Maria d'Oló,27,2003,49,22
752,082536,Santa Maria de Besora,-7,2003,17,24
753,082567,Santa Maria de Martorelles,18,2003,80,62
754,082554,Santa Maria de Merlès,-1,2003,6,7
755,082573,Santa Maria de Miralles,16,2003,21,5
756,082592,Santa Maria de Palautordera,139,2003,557,418
757,431401,Santa Oliva,181,2003,341,160
758,171848,Santa Pau,31,2003,86,55
759,082606,Santa Perpètua de Mogoda,148,2003,1263,1115
760,082613,Santa Susanna,291,2003,459,168
761,081923,Santpedor,163,2003,317,154
762,431423,Sarral,29,2003,90,61
763,171864,Sarrià de Ter,87,2003,274,187
764,252017,Sarroca de Bellera,-2,2003,3,5
765,252000,Sarroca de Lleida,-6,2003,6,12
766,171870,"Saus, Camallera i Llampaies",16,2003,32,16
767,431439,Savallà del Comtat,0,2003,2,2
768,431444,"Secuita, la",17,2003,73,56
769,171886,"Selva de Mar, la",6,2003,13,7
770,431457,"Selva del Camp, la",88,2003,202,114
771,431460,Senan,-3,2003,1,4
772,430445,"Sénia, la",-78,2003,167,245
773,252022,Senterada,-4,2003,1,5
774,250352,"Sentiu de Sió, la",3,2003,23,20
775,082671,Sentmenat,199,2003,505,306
776,171903,Serinyà,66,2003,96,30
777,252043,Seròs,63,2003,111,48
778,171910,Serra de Daró,3,2003,10,7
779,171925,Setcases,-5,2003,7,12
780,252038,"Seu d'Urgell, la",135,2003,734,599
781,082690,Seva,88,2003,214,126
782,252056,Sidamon,-21,2003,67,88
783,171931,Sils,177,2003,353,176
784,082704,Sitges,240,2003,1595,1355
785,170524,Siurana,-2,2003,16,18
786,082711,Sobremunt,0,2003,2,2
787,252069,"Soleràs, el",-8,2003,25,33
788,431476,Solivella,11,2003,24,13
789,252075,Solsona,293,2003,546,253
790,082726,Sora,3,2003,14,11
791,252081,Soriguera,0,2003,29,29
792,252094,Sort,100,2003,196,96
793,252108,Soses,36,2003,115,79
794,082732,Subirats,86,2003,201,115
795,252115,Sudanell,39,2003,58,19
796,252120,Sunyer,-11,2003,5,16
797,082747,Súria,56,2003,194,138
798,171946,Susqueda,5,2003,14,9
799,082763,Tagamanent,7,2003,23,16
800,082779,Talamanca,-2,2003,11,13
801,252154,Talarn,-5,2003,28,33
802,252167,Talavera,6,2003,14,8
803,171959,"Tallada d'Empordà, la",11,2003,18,7
804,082785,Taradell,53,2003,234,181
805,431482,Tarragona,134,2003,4065,3931
806,252173,Tàrrega,440,2003,1047,607
807,252189,Tarrés,2,2003,6,4
808,252192,Tarroja de Segarra,4,2003,7,3
809,082750,Tavèrnoles,6,2003,18,12
810,082802,Tavertet,5,2003,9,4
811,082819,Teià,14,2003,278,264
812,252206,Térmens,70,2003,112,42
813,171962,Terrades,-6,2003,0,6
814,082798,Terrassa,1278,2003,6768,5490
815,082824,Tiana,246,2003,460,214
816,252213,Tírvia,5,2003,7,2
817,252228,Tiurana,7,2003,7,0
818,431495,Tivenys,-10,2003,16,26
819,431508,Tivissa,23,2003,61,38
820,082830,Tona,221,2003,441,220
821,252234,Torà,12,2003,79,67
822,082845,Tordera,640,2003,1186,546
823,082858,Torelló,230,2003,580,350
824,252249,"Torms, els",1,2003,1,0
825,252252,Tornabous,1,2003,50,49
826,252271,"Torre de Cabdella, la",19,2003,33,14
827,082861,"Torre de Claramunt, la",134,2003,290,156
828,431515,"Torre de Fontaubella, la",-10,2003,8,18
829,431520,"Torre de l'Espanyol, la",-3,2003,28,31
830,252265,Torrebesses,1,2003,10,9
831,431536,Torredembarra,264,2003,1053,789
832,252287,Torrefarrera,68,2003,139,71
833,259078,Torrefeta i Florejacs,-7,2003,32,39
834,252304,Torregrossa,103,2003,160,57
835,252311,Torrelameu,6,2003,20,14
836,082877,Torrelavit,24,2003,64,40
837,082883,Torrelles de Foix,133,2003,278,145
838,082896,Torrelles de Llobregat,191,2003,417,226
839,171978,Torrent,8,2003,16,8
840,252326,Torres de Segre,5,2003,64,59
841,252332,Torre-serona,-9,2003,16,25
842,171984,Torroella de Fluvià,35,2003,55,20
843,171997,Torroella de Montgrí,286,2003,705,419
844,431541,Torroja del Priorat,5,2003,23,18
845,172001,Tortellà,23,2003,40,17
846,431554,Tortosa,1117,2003,2050,933
847,172018,Toses,0,2003,7,7
848,172023,Tossa de Mar,126,2003,319,193
849,252347,Tremp,128,2003,384,256
850,172044,Ullà,27,2003,123,96
851,082900,Ullastrell,58,2003,125,67
852,172057,Ullastret,-3,2003,8,11
853,431567,Ulldecona,-28,2003,253,281
854,431573,Ulldemolins,-15,2003,12,27
855,172039,Ultramort,-2,2003,3,5
856,172060,Urús,-1,2003,7,8
857,082917,Vacarisses,424,2003,624,200
858,170144,"Vajol, la",-1,2003,5,6
859,172076,"Vall d'en Bas, la",29,2003,125,96
860,172082,"Vall de Bianya, la",39,2003,90,51
861,250432,"Vall de Boí, la",39,2003,84,45
862,259010,Vall de Cardós,20,2003,42,22
863,082922,Vallbona d'Anoia,81,2003,125,44
864,252385,Vallbona de les Monges,-2,2003,12,14
865,082938,Vallcebre,12,2003,18,6
866,431589,Vallclara,5,2003,11,6
867,252402,Vallfogona de Balaguer,25,2003,85,60
868,171707,Vallfogona de Ripollès,12,2003,18,6
869,431592,Vallfogona de Riucorb,0,2003,12,12
870,082943,Vallgorguina,104,2003,203,99
871,082956,Vallirana,500,2003,1042,542
872,172095,Vall-llobrega,40,2003,68,28
873,431606,Vallmoll,48,2003,106,58
874,082969,Vallromanes,87,2003,189,102
875,431613,Valls,581,2003,1300,719
876,259062,"Valls d'Aguilar, les",-2,2003,18,20
877,252398,"Valls de Valira, les",24,2003,63,39
878,431628,Vandellòs i l'Hospitalet de l'Infant,94,2003,291,197
879,259097,"Vansa i Fórnols, la",-4,2003,5,9
880,082975,Veciana,3,2003,4,1
881,431634,"Vendrell, el",1362,2003,3037,1675
882,172109,Ventalló,-1,2003,52,53
883,252424,Verdú,4,2003,73,69
884,172116,Verges,3,2003,44,41
885,431649,Vespella de Gaià,9,2003,38,29
886,082981,Vic,435,2003,1872,1437
887,172121,Vidrà,5,2003,10,5
888,172137,Vidreres,207,2003,509,302
889,252430,Vielha e Mijaran,237,2003,552,315
890,431652,Vilabella,-1,2003,25,26
891,172142,Vilabertran,31,2003,63,32
892,172155,Vilablareix,43,2003,129,86
893,082994,Vilada,5,2003,28,23
894,172174,Viladamat,17,2003,29,12
895,172168,Viladasens,0,2003,7,7
896,083015,Viladecans,-27,2003,3102,3129
897,083008,Viladecavalls,188,2003,534,346
898,172180,Vilademuls,-5,2003,44,49
899,172207,Viladrau,51,2003,87,36
900,172214,Vilafant,158,2003,318,160
901,083054,Vilafranca del Penedès,1156,2003,2632,1476
902,252445,Vilagrassa,30,2003,55,25
903,172235,Vilajuïga,25,2003,79,54
904,431750,Vilalba dels Arcs,3,2003,10,7
905,083067,Vilalba Sasserra,16,2003,69,53
906,252458,Vilaller,15,2003,52,37
907,172240,Vilallonga de Ter,-5,2003,12,17
908,431665,Vilallonga del Camp,69,2003,120,51
909,172253,Vilamacolum,7,2003,20,13
910,172266,Vilamalla,-5,2003,40,45
911,172272,Vilamaniscle,15,2003,22,7
912,252477,Vilamòs,4,2003,17,13
913,172288,Vilanant,3,2003,29,26
914,431671,Vilanova d'Escornalbou,7,2003,22,15
915,252483,Vilanova de Bellpuig,12,2003,26,14
916,252496,Vilanova de l'Aguda,-2,2003,2,4
917,252542,Vilanova de la Barca,2,2003,42,40
918,252509,Vilanova de Meià,15,2003,33,18
919,431687,Vilanova de Prades,7,2003,19,12
920,083036,Vilanova de Sau,6,2003,17,11
921,252516,Vilanova de Segrià,-17,2003,18,35
922,083020,Vilanova del Camí,236,2003,672,436
923,089024,Vilanova del Vallès,103,2003,276,173
924,083073,Vilanova i la Geltrú,730,2003,3030,2300
925,431690,Vilaplana,27,2003,42,15
926,431704,Vila-rodona,37,2003,80,43
927,172305,Vila-sacra,14,2003,35,21
928,252521,Vila-sana,-15,2003,15,30
929,431711,Vila-seca,540,2003,1264,724
930,082140,Vilassar de Dalt,91,2003,400,309
931,082191,Vilassar de Mar,108,2003,1138,1030
932,172229,Vilaür,6,2003,11,5
933,431726,Vilaverd,18,2003,33,15
934,431732,"Vilella Alta, la",7,2003,7,0
935,431747,"Vilella Baixa, la",-2,2003,6,8
936,172333,Vilobí d'Onyar,78,2003,180,102
937,083041,Vilobí del Penedès,25,2003,67,42
938,172327,Vilopriu,-2,2003,1,3
939,252537,"Vilosell, el",4,2003,20,16
940,431763,Vimbodí i Poblet,1,2003,41,40
941,252555,Vinaixa,-10,2003,18,28
942,431779,Vinebre,-10,2003,20,30
943,431785,Vinyols i els Arcs,73,2003,177,104
944,083089,Viver i Serrateix,4,2003,6,2
945,430521,Xerta,18,2003,48,30
0,250019,Abella de la Conca,-7,2004,2,9
1,080018,Abrera,306,2004,976,670
2,250024,Àger,-5,2004,19,24
3,250030,Agramunt,125,2004,365,240
4,080023,Aguilar de Segarra,8,2004,18,10
5,170010,Agullana,22,2004,67,45
6,080142,Aiguafreda,58,2004,151,93
7,430017,Aiguamúrcia,32,2004,60,28
8,170025,Aiguaviva,7,2004,35,28
9,250387,Aitona,51,2004,181,130
10,250045,"Alamús, els",8,2004,42,34
11,250058,Alàs i Cerc,9,2004,29,20
12,250061,"Albagés, l'",-2,2004,19,21
13,170031,Albanyà,-3,2004,7,10
14,250077,Albatàrrec,19,2004,99,80
15,250083,Albesa,30,2004,74,44
16,250096,"Albi, l'",-5,2004,19,24
17,430022,Albinyana,115,2004,228,113
18,430038,"Albiol, l'",34,2004,55,21
19,170046,Albons,6,2004,39,33
20,430043,Alcanar,435,2004,745,310
21,250100,Alcanó,0,2004,4,4
22,250117,Alcarràs,83,2004,298,215
23,250122,Alcoletge,116,2004,195,79
24,430056,Alcover,77,2004,247,170
25,439044,"Aldea, l'",141,2004,244,103
26,430069,Aldover,26,2004,45,19
27,430075,"Aleixar, l'",5,2004,27,22
28,080039,Alella,77,2004,560,483
29,430081,Alfara de Carles,-18,2004,0,18
30,250138,Alfarràs,103,2004,245,142
31,250143,Alfés,-1,2004,7,8
32,430094,Alforja,62,2004,129,67
33,250156,Algerri,-15,2004,10,25
34,250169,Alguaire,83,2004,201,118
35,250175,Alins,-4,2004,0,4
36,430108,Alió,1,2004,25,24
37,250194,Almacelles,172,2004,414,242
38,250208,Almatret,1,2004,24,23
39,250215,Almenar,84,2004,205,121
40,430115,Almoster,83,2004,141,58
41,250220,Alòs de Balaguer,10,2004,24,14
42,170062,Alp,48,2004,137,89
43,080044,Alpens,-1,2004,7,8
44,250236,Alpicat,256,2004,431,175
45,250241,Alt Àneu,27,2004,46,19
46,430120,Altafulla,144,2004,380,236
47,170078,Amer,59,2004,110,51
48,430136,"Ametlla de Mar, l'",343,2004,563,220
49,080057,"Ametlla del Vallès, l'",174,2004,632,458
50,439060,"Ampolla, l'",234,2004,347,113
51,430141,Amposta,434,2004,1038,604
52,170084,Anglès,87,2004,335,248
53,250273,Anglesola,-2,2004,61,63
54,250292,Arbeca,78,2004,161,83
55,430167,"Arboç, l'",202,2004,416,214
56,430154,Arbolí,-6,2004,5,11
57,170097,Arbúcies,217,2004,477,260
58,080060,Arenys de Mar,429,2004,1156,727
59,080076,Arenys de Munt,92,2004,447,355
60,170101,Argelaguer,21,2004,40,19
61,080082,Argençola,-2,2004,12,14
62,430173,"Argentera, l'",2,2004,8,6
63,080095,Argentona,369,2004,876,507
64,170118,"Armentera, l'",26,2004,49,23
65,430189,Arnes,-2,2004,11,13
66,250313,Arres,1,2004,4,3
67,250328,Arsèguel,2,2004,7,5
68,080109,Artés,112,2004,288,176
69,250334,Artesa de Lleida,23,2004,95,72
70,250349,Artesa de Segre,159,2004,325,166
71,430192,Ascó,-24,2004,37,61
72,250365,Aspa,-7,2004,3,10
73,250371,"Avellanes i Santa Linya, les",4,2004,18,14
74,080116,Avià,68,2004,125,57
75,080121,Avinyó,-4,2004,80,84
76,170123,Avinyonet de Puigventós,101,2004,145,44
77,080137,Avinyonet del Penedès,107,2004,167,60
78,080155,Badalona,1946,2004,14367,12421
79,089045,Badia del Vallès,-248,2004,748,996
80,080168,Bagà,40,2004,114,74
81,250390,Baix Pallars,12,2004,32,20
82,250404,Balaguer,591,2004,1248,657
83,080174,Balenyà,1,2004,171,170
84,080180,Balsareny,43,2004,128,85
85,430206,Banyeres del Penedès,227,2004,386,159
86,170157,Banyoles,379,2004,987,608
87,250411,Barbens,28,2004,64,36
88,430213,Barberà de la Conca,42,2004,66,24
89,082520,Barberà del Vallès,460,2004,2019,1559
90,080193,Barcelona,6181,2004,87351,81170
91,250426,"Baronia de Rialb, la",-3,2004,8,11
92,170160,Bàscara,4,2004,47,43
93,250447,Bassella,-1,2004,13,14
94,430228,Batea,36,2004,73,37
95,250450,Bausen,3,2004,3,0
96,080207,Begues,136,2004,376,240
97,170139,Begur,123,2004,331,208
98,250463,Belianes,11,2004,33,22
99,251706,Bellaguarda,9,2004,14,5
100,170182,Bellcaire d'Empordà,16,2004,58,42
101,250479,Bellcaire d'Urgell,59,2004,89,30
102,250485,Bell-lloc d'Urgell,91,2004,168,77
103,250498,Bellmunt d'Urgell,3,2004,5,2
104,430234,Bellmunt del Priorat,14,2004,21,7
105,080214,Bellprat,3,2004,7,4
106,250501,Bellpuig,111,2004,289,178
107,430249,Bellvei,84,2004,198,114
108,250518,Bellver de Cerdanya,74,2004,152,78
109,250523,Bellvís,81,2004,194,113
110,250539,Benavent de Segrià,33,2004,84,51
111,430252,Benifallet,-9,2004,0,9
112,430265,Benissanet,51,2004,107,56
113,080229,Berga,434,2004,943,509
114,170195,Besalú,62,2004,127,65
115,170209,Bescanó,96,2004,197,101
116,170216,Beuda,1,2004,14,13
117,080235,Bigues i Riells del Fai,411,2004,813,402
118,250557,Biosca,-2,2004,7,9
119,170221,"Bisbal d'Empordà, la",223,2004,596,373
120,430271,"Bisbal de Falset, la",14,2004,19,5
121,430287,"Bisbal del Penedès, la",202,2004,341,139
122,172348,Biure,6,2004,11,5
123,430290,Blancafort,20,2004,33,13
124,170237,Blanes,958,2004,2804,1846
125,170293,Boadella i les Escaules,5,2004,14,9
126,170242,Bolvir,10,2004,23,13
127,430304,Bonastre,45,2004,86,41
128,250576,"Bòrdes, Es",21,2004,30,9
129,170255,Bordils,31,2004,124,93
130,250582,"Borges Blanques, les",121,2004,273,152
131,430311,"Borges del Camp, les",42,2004,126,84
132,170268,Borrassà,10,2004,37,27
133,080240,Borredà,7,2004,33,26
134,250595,Bossòst,-3,2004,77,80
135,430326,Bot,10,2004,25,15
136,430332,Botarell,25,2004,70,45
137,250560,Bovera,-3,2004,4,7
138,430347,Bràfim,25,2004,50,25
139,170274,Breda,49,2004,194,145
140,080253,"Bruc, el",77,2004,192,115
141,080266,"Brull, el",2,2004,6,4
142,170280,Brunyola i Sant Martí Sapresa,4,2004,16,12
143,430350,Cabacés,0,2004,7,7
144,250609,Cabanabona,7,2004,8,1
145,170314,Cabanelles,-3,2004,13,16
146,170307,Cabanes,30,2004,67,37
147,080272,"Cabanyes, les",37,2004,63,26
148,250616,Cabó,0,2004,0,0
149,430363,Cabra del Camp,62,2004,117,55
150,080288,Cabrera d'Anoia,115,2004,172,57
151,080291,Cabrera de Mar,86,2004,287,201
152,080305,Cabrils,162,2004,555,393
153,170329,Cadaqués,104,2004,208,104
154,080312,Calaf,52,2004,206,154
155,430379,Calafell,1543,2004,2909,1366
156,080348,Calders,7,2004,56,49
157,080327,Caldes d'Estrac,68,2004,308,240
158,170335,Caldes de Malavella,331,2004,567,236
159,080333,Caldes de Montbui,373,2004,1020,647
160,080351,Calella,714,2004,1771,1057
161,080370,Calldetenes,43,2004,161,118
162,080386,Callús,41,2004,111,70
163,080364,Calonge de Segarra,9,2004,12,3
164,170340,Calonge i Sant Antoni,365,2004,1006,641
165,250621,Camarasa,32,2004,57,25
166,439039,Camarles,138,2004,257,119
167,430385,Cambrils,1374,2004,2730,1356
168,170353,Camós,8,2004,22,14
169,170366,Campdevànol,81,2004,162,81
170,170372,Campelles,-2,2004,11,13
171,080399,Campins,18,2004,34,16
172,170388,Campllong,14,2004,31,17
173,170391,Camprodon,51,2004,158,107
174,250637,Canejan,0,2004,1,1
175,170405,Canet d'Adri,26,2004,38,12
176,080403,Canet de Mar,346,2004,856,510
177,080410,Canovelles,557,2004,1506,949
178,080425,Cànoves i Samalús,63,2004,199,136
179,170412,Cantallops,8,2004,14,6
180,080431,Canyelles,282,2004,495,213
181,430398,Capafonts,4,2004,6,2
182,430402,Capçanes,4,2004,11,7
183,080446,Capellades,120,2004,352,232
184,170427,Capmany,7,2004,38,31
185,080459,Capolat,-1,2004,9,10
186,080462,Cardedeu,360,2004,989,629
187,080478,Cardona,-15,2004,115,130
188,080484,Carme,2,2004,39,37
189,430419,Caseres,1,2004,14,13
190,170448,Cassà de la Selva,237,2004,515,278
191,080497,Casserres,28,2004,68,40
192,080575,Castell de l'Areny,-5,2004,0,5
193,259046,Castell de Mur,3,2004,14,11
194,250642,Castellar de la Ribera,1,2004,3,2
195,080522,Castellar de n'Hug,-4,2004,10,14
196,080500,Castellar del Riu,16,2004,19,3
197,080517,Castellar del Vallès,761,2004,1515,754
198,080538,Castellbell i el Vilar,111,2004,306,195
199,080543,Castellbisbal,361,2004,862,501
200,080556,Castellcir,32,2004,51,19
201,250674,Castelldans,36,2004,70,34
202,080569,Castelldefels,2090,2004,5753,3663
203,080581,Castellet i la Gornal,124,2004,222,98
204,170464,Castellfollit de la Roca,-12,2004,59,71
205,080608,Castellfollit de Riubregós,-16,2004,4,20
206,080594,Castellfollit del Boix,1,2004,10,9
207,080615,Castellgalí,132,2004,192,60
208,080620,Castellnou de Bages,44,2004,91,47
209,250680,Castellnou de Seana,18,2004,36,18
210,170470,Castelló d'Empúries,936,2004,1344,408
211,250693,Castelló de Farfanya,2,2004,27,25
212,080636,Castellolí,1,2004,11,10
213,170486,Castell-Platja d'Aro,640,2004,1316,676
214,250707,Castellserà,13,2004,48,35
215,080641,Castellterçol,30,2004,132,102
216,430424,Castellvell del Camp,77,2004,168,91
217,080654,Castellví de la Marca,41,2004,105,64
218,080667,Castellví de Rosanes,57,2004,131,74
219,430430,"Catllar, el",105,2004,285,180
220,250714,Cava,2,2004,3,1
221,171899,"Cellera de Ter, la",15,2004,79,64
222,170499,Celrà,242,2004,405,163
223,080673,Centelles,163,2004,355,192
224,082687,Cercs,8,2004,63,55
225,082665,Cerdanyola del Vallès,399,2004,3230,2831
226,080689,Cervelló,336,2004,700,364
227,250729,Cervera,374,2004,878,504
228,250735,Cervià de les Garrigues,13,2004,37,24
229,170502,Cervià de Ter,52,2004,79,27
230,170519,Cistella,7,2004,16,9
231,250740,Ciutadilla,-6,2004,7,13
232,250753,Clariana de Cardener,-6,2004,8,14
233,250766,"Cogul, el",4,2004,6,2
234,170545,Colera,-46,2004,21,67
235,250772,Coll de Nargó,11,2004,34,23
236,080692,Collbató,275,2004,455,180
237,430458,Colldejou,-2,2004,10,12
238,080706,Collsuspina,12,2004,24,12
239,170558,Colomers,2,2004,6,4
240,251636,"Coma i la Pedra, la",18,2004,22,4
241,251615,Conca de Dalt,11,2004,20,9
242,430461,Conesa,3,2004,13,10
243,430477,Constantí,141,2004,446,305
244,080713,Copons,4,2004,26,22
245,430483,Corbera d'Ebre,46,2004,69,23
246,080728,Corbera de Llobregat,641,2004,1244,603
247,250788,Corbins,144,2004,186,42
248,170577,Corçà,33,2004,87,54
249,080734,Cornellà de Llobregat,95,2004,4814,4719
250,170561,Cornellà del Terri,26,2004,107,81
251,430496,Cornudella de Montsant,40,2004,72,32
252,430509,Creixell,37,2004,213,176
253,170583,Crespià,21,2004,30,9
254,179011,"Cruïlles, Monells i Sant Sadurní de l'Heura",21,2004,88,67
255,080749,Cubelles,902,2004,1607,705
256,250791,Cubells,19,2004,30,11
257,430516,Cunit,944,2004,1710,766
258,170600,Darnius,30,2004,54,24
259,170617,Das,2,2004,11,9
260,439018,Deltebre,211,2004,396,185
261,080752,Dosrius,273,2004,502,229
262,430537,Duesaigües,8,2004,15,7
263,170622,"Escala, l'",465,2004,844,379
264,080765,Esparreguera,428,2004,1544,1116
265,170638,Espinelves,4,2004,13,9
266,250812,"Espluga Calba, l'",14,2004,35,21
267,430542,"Espluga de Francolí, l'",142,2004,269,127
268,080771,Esplugues de Llobregat,161,2004,3130,2969
269,170643,Espolla,19,2004,25,6
270,170656,Esponellà,13,2004,31,18
271,250827,Espot,6,2004,27,21
272,080787,"Espunyola, l'",0,2004,6,6
273,082541,"Esquirol, l'",25,2004,113,88
274,250886,Estamariu,-2,2004,0,2
275,080790,"Estany, l'",-6,2004,17,23
276,250851,Estaràs,-7,2004,0,7
277,250864,Esterri d'Àneu,16,2004,90,74
278,250870,Esterri de Cardós,-1,2004,2,3
279,430555,Falset,32,2004,113,81
280,170059,"Far d'Empordà, el",-8,2004,6,14
281,250899,Farrera,2,2004,6,4
282,430568,"Fatarella, la",12,2004,31,19
283,430574,"Febró, la",1,2004,3,2
284,081347,Figaró-Montmany,34,2004,104,70
285,080804,Fígols,2,2004,3,1
286,259084,Fígols i Alinyà,0,2004,9,9
287,430580,"Figuera, la",-29,2004,12,41
288,170669,Figueres,1415,2004,3225,1810
289,430593,Figuerola del Camp,13,2004,24,11
290,170675,Flaçà,40,2004,87,47
291,430607,Flix,42,2004,176,134
292,250925,"Floresta, la",4,2004,12,8
293,080826,Fogars de la Selva,123,2004,199,76
294,080811,Fogars de Montclús,19,2004,34,15
295,170681,Foixà,8,2004,30,22
296,080832,Folgueroles,49,2004,110,61
297,250931,Fondarella,46,2004,72,26
298,080847,Fonollosa,26,2004,65,39
299,170694,Fontanals de Cerdanya,5,2004,33,28
300,170708,Fontanilles,4,2004,11,7
301,170715,Fontcoberta,-1,2004,44,45
302,080850,Font-rubí,41,2004,101,60
303,250946,Foradada,-23,2004,15,38
304,179026,Forallac,-1,2004,84,85
305,430614,Forès,4,2004,4,0
306,170736,Fornells de la Selva,88,2004,153,65
307,170741,Fortià,15,2004,39,24
308,080863,"Franqueses del Vallès, les",250,2004,1187,937
309,430629,Freginals,12,2004,26,14
310,250962,"Fuliola, la",-23,2004,23,46
311,250978,Fulleda,8,2004,12,4
312,080902,Gaià,3,2004,11,8
313,430635,"Galera, la",40,2004,63,23
314,080879,Gallifa,0,2004,13,13
315,430640,Gandesa,95,2004,174,79
316,430653,Garcia,-3,2004,15,18
317,430666,"Garidells, els",-1,2004,18,19
318,080885,"Garriga, la",395,2004,867,472
319,170754,Garrigàs,16,2004,31,15
320,170767,Garrigoles,1,2004,4,3
321,170773,Garriguella,13,2004,50,37
322,080898,Gavà,629,2004,3045,2416
323,250984,Gavet de la Conca,10,2004,13,3
324,080919,Gelida,210,2004,453,243
325,170789,Ger,10,2004,31,21
326,259123,Gimenells i el Pla de la Font,17,2004,55,38
327,430672,Ginestar,39,2004,63,24
328,170792,Girona,2188,2004,6802,4614
329,080924,Gironella,17,2004,184,167
330,080930,Gisclareny,3,2004,4,1
331,430688,Godall,18,2004,29,11
332,250997,Golmés,60,2004,114,54
333,170806,Gombrèn,-9,2004,8,17
334,251001,Gósol,0,2004,14,14
335,080945,"Granada, la",55,2004,135,80
336,251018,"Granadella, la",3,2004,30,27
337,080958,Granera,1,2004,6,5
338,251023,"Granja d'Escarp, la",-1,2004,46,47
339,080961,Granollers,842,2004,4319,3477
340,251039,Granyanella,0,2004,0,0
341,251057,Granyena de les Garrigues,3,2004,8,5
342,251044,Granyena de Segarra,-3,2004,0,3
343,430691,Gratallops,-2,2004,3,5
344,080977,Gualba,31,2004,124,93
345,170813,Gualta,23,2004,46,23
346,080996,Guardiola de Berguedà,-17,2004,35,52
347,430705,"Guiamets, els",14,2004,23,9
348,170828,Guils de Cerdanya,23,2004,35,12
349,251095,Guimerà,6,2004,23,17
350,259031,"Guingueta d'Àneu, la",4,2004,21,17
351,251109,Guissona,376,2004,736,360
352,251116,Guixers,0,2004,4,4
353,081000,Gurb,45,2004,124,79
354,430712,Horta de Sant Joan,39,2004,77,38
355,081017,"Hospitalet de Llobregat, l'",1508,2004,18590,17082
356,081629,"Hostalets de Pierola, els",108,2004,212,104
357,170834,Hostalric,171,2004,362,191
358,081022,Igualada,752,2004,2191,1439
359,251155,Isona i Conca Dellà,-17,2004,19,36
360,170849,Isòvol,30,2004,36,6
361,251137,Ivars d'Urgell,44,2004,159,115
362,251121,Ivars de Noguera,7,2004,25,18
363,251142,Ivorra,-4,2004,5,9
364,170852,Jafre,16,2004,38,22
365,170865,"Jonquera, la",57,2004,306,249
366,081038,Jorba,24,2004,47,23
367,259101,Josa i Tuixén,-5,2004,8,13
368,170871,Juià,1,2004,30,29
369,251180,Juncosa,12,2004,45,33
370,251193,Juneda,85,2004,200,115
371,251214,Les,64,2004,112,48
372,251229,Linyola,60,2004,184,124
373,081043,"Llacuna, la",3,2004,54,51
374,170887,Lladó,6,2004,30,24
375,251235,Lladorre,1,2004,9,8
376,251240,Lladurs,-6,2004,7,13
377,081056,"Llagosta, la",379,2004,1117,738
378,170890,Llagostera,265,2004,545,280
379,170904,Llambilles,60,2004,74,14
380,170911,Llanars,15,2004,30,15
381,170926,Llançà,139,2004,309,170
382,251253,Llardecans,-5,2004,5,10
383,251266,Llavorsí,4,2004,23,19
384,251207,Lleida,3665,2004,8735,5070
385,170932,Llers,46,2004,86,40
386,251272,Lles de Cerdanya,-8,2004,0,8
387,081075,Lliçà d'Amunt,323,2004,1021,698
388,081081,Lliçà de Vall,77,2004,415,338
389,251288,Llimiana,3,2004,12,9
390,081069,Llinars del Vallès,236,2004,703,467
391,170947,Llívia,78,2004,166,88
392,430727,"Lloar, el",5,2004,13,8
393,251291,Llobera,-5,2004,3,8
394,430733,Llorac,-5,2004,4,9
395,430748,Llorenç del Penedès,90,2004,177,87
396,170950,Lloret de Mar,2580,2004,3982,1402
397,170963,"Llosses, les",4,2004,17,13
398,081094,Lluçà,-8,2004,5,13
399,171024,Maçanet de Cabrenys,22,2004,40,18
400,171030,Maçanet de la Selva,406,2004,695,289
401,170979,Madremanya,13,2004,17,4
402,170985,Maià de Montcal,12,2004,25,13
403,251333,Maials,8,2004,27,19
404,251305,Maldà,12,2004,23,11
405,081108,Malgrat de Mar,598,2004,1454,856
406,081115,Malla,-2,2004,6,8
407,081120,Manlleu,571,2004,1234,663
408,081136,Manresa,1670,2004,4057,2387
409,430764,Marçà,19,2004,34,15
410,430751,Margalef,-4,2004,1,5
411,082423,Marganell,24,2004,38,14
412,081141,Martorell,426,2004,1957,1531
413,081154,Martorelles,-35,2004,266,301
414,430770,Mas de Barberans,-10,2004,0,10
415,171002,Masarac,6,2004,11,5
416,430786,Masdenverge,21,2004,56,35
417,081167,"Masies de Roda, les",15,2004,41,26
418,081173,"Masies de Voltregà, les",45,2004,165,120
419,430799,Masllorenç,2,2004,35,33
420,081189,"Masnou, el",134,2004,1183,1049
421,430803,"Masó, la",3,2004,6,3
422,430810,Maspujols,9,2004,20,11
423,081192,Masquefa,308,2004,695,387
424,430825,"Masroig, el",23,2004,36,13
425,251312,Massalcoreig,29,2004,60,31
426,171019,Massanes,33,2004,66,33
427,251327,Massoteres,4,2004,27,23
428,081206,Matadepera,137,2004,476,339
429,081213,Mataró,1920,2004,6328,4408
430,081228,Mediona,177,2004,342,165
431,251348,Menàrguens,16,2004,39,23
432,170998,Meranges,1,2004,5,4
433,171058,Mieres,-11,2004,9,20
434,430831,"Milà, el",0,2004,9,9
435,251351,Miralcamp,-1,2004,47,48
436,430846,Miravet,11,2004,35,24
437,081385,Moià,254,2004,431,177
438,430859,"Molar, el",-1,2004,11,12
439,081234,Molins de Rei,396,2004,1399,1003
440,251370,Mollerussa,627,2004,1216,589
441,171061,Mollet de Peralada,4,2004,7,3
442,081249,Mollet del Vallès,80,2004,3210,3130
443,171077,Molló,-3,2004,10,13
444,251364,"Molsosa, la",0,2004,4,4
445,081287,Monistrol de Calders,4,2004,23,19
446,081271,Monistrol de Montserrat,66,2004,236,170
447,171096,Montagut i Oix,15,2004,61,46
448,430862,Montblanc,140,2004,355,215
449,430884,Montbrió del Camp,102,2004,169,67
450,081252,Montcada i Reixac,442,2004,2095,1653
451,081304,Montclar,-7,2004,1,8
452,251399,Montellà i Martinet,31,2004,57,26
453,081311,Montesquiu,-3,2004,54,57
454,251403,Montferrer i Castellbò,33,2004,81,48
455,430897,Montferri,21,2004,41,20
456,251386,Montgai,-5,2004,25,30
457,081265,Montgat,217,2004,714,497
458,081326,Montmajor,3,2004,11,8
459,081332,Montmaneu,9,2004,15,6
460,430901,"Montmell, el",136,2004,236,100
461,081350,Montmeló,-4,2004,437,441
462,251425,Montoliu de Lleida,-1,2004,19,20
463,251410,Montoliu de Segarra,4,2004,10,6
464,251431,Montornès de Segarra,5,2004,8,3
465,081363,Montornès del Vallès,-19,2004,908,927
466,430918,Mont-ral,5,2004,8,3
467,171100,Mont-ras,41,2004,145,104
468,430923,Mont-roig del Camp,544,2004,1100,556
469,081379,Montseny,-7,2004,17,24
470,430939,Móra d'Ebre,45,2004,247,202
471,430944,Móra la Nova,104,2004,245,141
472,430957,"Morell, el",75,2004,199,124
473,430960,"Morera de Montsant, la",-4,2004,9,13
474,081290,Muntanyola,25,2004,49,24
475,081398,Mura,4,2004,14,10
476,251459,Nalec,-3,2004,0,3
477,250254,Naut Aran,27,2004,130,103
478,081402,Navarcles,117,2004,239,122
479,081419,Navàs,87,2004,220,133
480,171117,Navata,60,2004,104,44
481,251462,Navès,-7,2004,9,16
482,081424,"Nou de Berguedà, la",-2,2004,3,5
483,430976,"Nou de Gaià, la",12,2004,26,14
484,430982,Nulles,-7,2004,17,24
485,251484,Odèn,-2,2004,3,5
486,081430,Òdena,87,2004,215,128
487,171122,Ogassa,3,2004,11,8
488,081458,Olèrdola,207,2004,330,123
489,081461,Olesa de Bonesvalls,88,2004,160,72
490,081477,Olesa de Montserrat,656,2004,1553,897
491,251497,Oliana,78,2004,143,65
492,251500,Oliola,-16,2004,1,17
493,251517,Olius,5,2004,40,35
494,081483,Olivella,153,2004,344,191
495,081496,Olost,24,2004,41,17
496,171143,Olot,877,2004,1764,887
497,251522,"Oluges, les",-1,2004,8,9
498,081445,Olvan,14,2004,49,35
499,251538,"Omellons, els",8,2004,13,5
500,251543,"Omells de na Gaia, els",5,2004,15,10
501,171156,Ordis,6,2004,18,12
502,251556,Organyà,5,2004,46,41
503,081509,Orís,27,2004,37,10
504,081516,Oristà,6,2004,17,11
505,081521,Orpí,10,2004,17,7
506,081537,Òrrius,-21,2004,0,21
507,251569,Os de Balaguer,62,2004,81,19
508,171169,Osor,-17,2004,0,17
509,251575,Ossó de Sió,-4,2004,0,4
510,081542,Pacs del Penedès,9,2004,53,44
511,081555,Palafolls,397,2004,760,363
512,171175,Palafrugell,470,2004,1275,805
513,171181,Palamós,489,2004,1193,704
514,251581,"Palau d'Anglesola, el",25,2004,90,65
515,171194,Palau de Santa Eulàlia,4,2004,5,1
516,171215,Palau-sator,4,2004,18,14
517,171208,Palau-saverdera,67,2004,135,68
518,081568,Palau-solità i Plegamans,268,2004,941,673
519,431009,"Pallaresos, els",99,2004,259,160
520,081574,Pallejà,274,2004,756,482
521,430995,"Palma d'Ebre, la",4,2004,7,3
522,089058,"Palma de Cervelló, la",56,2004,247,191
523,171236,Palol de Revardit,4,2004,14,10
524,171241,Pals,54,2004,164,110
525,081580,"Papiol, el",34,2004,192,158
526,171254,Pardines,7,2004,10,3
527,081593,Parets del Vallès,125,2004,997,872
528,171267,Parlavà,-3,2004,14,17
529,431016,Passanant i Belltall,2,2004,17,15
530,171289,Pau,18,2004,48,30
531,431021,Paüls,-4,2004,3,7
532,171292,Pedret i Marzà,15,2004,20,5
533,251641,Penelles,1,2004,25,24
534,171306,"Pera, la",6,2004,15,9
535,081607,Perafita,9,2004,18,9
536,431037,Perafort,55,2004,90,35
537,171328,Peralada,66,2004,137,71
538,251654,Peramola,-5,2004,20,25
539,431042,"Perelló, el",78,2004,151,73
540,081614,Piera,708,2004,1345,637
541,431055,"Piles, les",2,2004,12,10
542,081635,Pineda de Mar,979,2004,2544,1565
543,431068,"Pinell de Brai, el",9,2004,21,12
544,251667,Pinell de Solsonès,-7,2004,6,13
545,251673,Pinós,6,2004,11,5
546,431074,Pira,23,2004,32,9
547,431080,"Pla de Santa Maria, el",86,2004,195,109
548,081640,"Pla del Penedès, el",22,2004,57,35
549,171334,"Planes d'Hostoles, les",39,2004,78,39
550,171349,Planoles,12,2004,32,20
551,259118,"Plans de Sió, els",-20,2004,0,20
552,251689,"Poal, el",14,2004,26,12
553,251692,"Pobla de Cérvoles, la",11,2004,17,6
554,081653,"Pobla de Claramunt, la",81,2004,217,136
555,081666,"Pobla de Lillet, la",23,2004,54,31
556,431093,"Pobla de Mafumet, la",58,2004,115,57
557,431107,"Pobla de Massaluca, la",7,2004,28,21
558,431114,"Pobla de Montornès, la",223,2004,345,122
559,251713,"Pobla de Segur, la",121,2004,249,128
560,431129,Poboleda,9,2004,25,16
561,081672,Polinyà,463,2004,829,366
562,431135,"Pont d'Armentera, el",22,2004,57,35
563,250306,"Pont de Bar, el",-5,2004,5,10
564,171352,Pont de Molins,4,2004,23,19
565,251734,"Pont de Suert, el",92,2004,183,91
566,081825,"Pont de Vilomara i Rocafort, el",163,2004,243,80
567,431418,Pontils,2,2004,4,2
568,081688,Pontons,12,2004,62,50
569,171365,Pontós,10,2004,21,11
570,251728,Ponts,-13,2004,93,106
571,171371,Porqueres,131,2004,278,147
572,431140,Porrera,14,2004,30,16
573,171404,"Port de la Selva, el",9,2004,65,56
574,171387,Portbou,16,2004,69,53
575,251749,"Portella, la",75,2004,150,75
576,431153,Pradell de la Teixeta,-2,2004,4,6
577,431166,Prades,20,2004,49,29
578,431172,Prat de Comte,6,2004,7,1
579,081691,"Prat de Llobregat, el",-210,2004,2395,2605
580,431188,Pratdip,19,2004,65,46
581,081712,Prats de Lluçanès,-4,2004,75,79
582,081705,"Prats de Rei, els",-4,2004,20,24
583,251752,Prats i Sansor,3,2004,15,12
584,251765,Preixana,16,2004,23,7
585,251771,Preixens,-7,2004,22,29
586,082303,Premià de Dalt,-7,2004,608,615
587,081727,Premià de Mar,1,2004,1788,1787
588,171390,"Preses, les",12,2004,66,54
589,251790,Prullans,-4,2004,14,18
590,171411,Puigcerdà,418,2004,890,472
591,081748,Puigdàlber,2,2004,25,23
592,251804,Puiggròs,23,2004,30,7
593,431191,Puigpelat,49,2004,84,35
594,081751,Puig-reig,72,2004,216,144
595,251811,Puigverd d'Agramunt,16,2004,21,5
596,251826,Puigverd de Lleida,29,2004,76,47
597,081764,Pujalt,4,2004,10,6
598,081770,"Quar, la",-3,2004,1,4
599,171426,Quart,4,2004,144,140
600,170433,Queralbs,4,2004,7,3
601,431205,Querol,30,2004,65,35
602,171432,Rabós,10,2004,18,8
603,081786,Rajadell,-3,2004,36,39
604,431212,Rasquera,23,2004,45,22
605,171447,Regencós,-8,2004,13,21
606,081799,Rellinars,33,2004,73,40
607,431227,Renau,1,2004,7,6
608,431233,Reus,2286,2004,5980,3694
609,251832,Rialp,17,2004,81,64
610,431248,"Riba, la",-3,2004,25,28
611,431251,Riba-roja d'Ebre,18,2004,59,41
612,259059,Ribera d'Ondara,-5,2004,21,26
613,251850,Ribera d'Urgellet,61,2004,125,64
614,171450,Ribes de Freser,31,2004,113,82
615,171463,Riells i Viabrea,171,2004,353,182
616,431264,"Riera de Gaià, la",44,2004,125,81
617,251863,Riner,1,2004,6,5
618,171479,Ripoll,-6,2004,348,354
619,081803,Ripollet,642,2004,2523,1881
620,259139,Riu de Cerdanya,-5,2004,6,11
621,171485,Riudarenes,99,2004,198,99
622,171498,Riudaura,23,2004,37,14
623,431270,Riudecanyes,71,2004,111,40
624,431286,Riudecols,32,2004,79,47
625,171501,Riudellots de la Selva,46,2004,110,64
626,431299,Riudoms,150,2004,358,208
627,171518,Riumors,-13,2004,0,13
628,081810,"Roca del Vallès, la",211,2004,662,451
629,431303,Rocafort de Queralt,8,2004,12,4
630,431310,Roda de Berà,264,2004,573,309
631,081831,Roda de Ter,47,2004,229,182
632,431325,Rodonyà,6,2004,41,35
633,431331,Roquetes,168,2004,419,251
634,171523,Roses,718,2004,1268,550
635,251898,Rosselló,146,2004,234,88
636,431346,"Rourell, el",7,2004,26,19
637,081846,Rubí,1174,2004,4145,2971
638,081859,Rubió,1,2004,10,9
639,171539,Rupià,1,2004,19,18
640,089019,Rupit i Pruit,-1,2004,10,11
641,081878,Sabadell,2623,2004,9996,7373
642,081884,Sagàs,-1,2004,5,6
643,251902,Salàs de Pallars,3,2004,31,28
644,081901,Saldes,11,2004,18,7
645,171544,Sales de Llierca,9,2004,12,3
646,081918,Sallent,1,2004,268,267
647,431359,Salomó,19,2004,33,14
648,439057,Salou,1713,2004,3244,1531
649,171557,Salt,1309,2004,3368,2059
650,251919,Sanaüja,-10,2004,14,24
651,081944,Sant Adrià de Besòs,76,2004,1986,1910
652,081957,Sant Agustí de Lluçanès,9,2004,11,2
653,081960,Sant Andreu de la Barca,215,2004,1701,1486
654,081976,Sant Andreu de Llavaneres,292,2004,776,484
655,171576,Sant Andreu Salou,1,2004,4,3
656,171833,Sant Aniol de Finestres,-6,2004,15,21
657,081982,Sant Antoni de Vilamajor,170,2004,411,241
658,081995,Sant Bartomeu del Grau,-52,2004,40,92
659,082009,Sant Boi de Llobregat,-45,2004,3721,3766
660,082016,Sant Boi de Lluçanès,24,2004,42,18
661,431362,Sant Carles de la Ràpita,542,2004,946,404
662,082037,Sant Cebrià de Vallalta,185,2004,361,176
663,082021,Sant Celoni,745,2004,1365,620
664,082042,Sant Climent de Llobregat,60,2004,228,168
665,171582,Sant Climent Sescebes,27,2004,50,23
666,082055,Sant Cugat del Vallès,1042,2004,3995,2953
667,082068,Sant Cugat Sesgarrigues,24,2004,58,34
668,251961,Sant Esteve de la Sarga,5,2004,7,2
669,082074,Sant Esteve de Palautordera,147,2004,253,106
670,082080,Sant Esteve Sesrovires,288,2004,574,286
671,171595,Sant Feliu de Buixalleu,19,2004,49,30
672,082107,Sant Feliu de Codines,215,2004,537,322
673,171609,Sant Feliu de Guíxols,539,2004,1341,802
674,082114,Sant Feliu de Llobregat,-25,2004,1994,2019
675,171616,Sant Feliu de Pallerols,20,2004,39,19
676,082129,Sant Feliu Sasserra,-7,2004,11,18
677,171621,Sant Ferriol,7,2004,25,18
678,082093,Sant Fost de Campsentelles,141,2004,559,418
679,082135,Sant Fruitós de Bages,82,2004,365,283
680,171637,Sant Gregori,125,2004,197,72
681,251924,Sant Guim de Freixenet,-13,2004,49,62
682,251977,Sant Guim de la Plana,15,2004,24,9
683,171642,Sant Hilari Sacalm,10,2004,188,178
684,082153,Sant Hipòlit de Voltregà,62,2004,222,160
685,081939,Sant Iscle de Vallalta,60,2004,123,63
686,439023,Sant Jaume d'Enveja,63,2004,108,45
687,082166,Sant Jaume de Frontanyà,1,2004,1,0
688,171655,Sant Jaume de Llierca,10,2004,51,41
689,431378,Sant Jaume dels Domenys,130,2004,234,104
690,171674,Sant Joan de les Abadesses,54,2004,151,97
691,171680,Sant Joan de Mollet,37,2004,50,13
692,082188,Sant Joan de Vilatorrada,153,2004,523,370
693,082172,Sant Joan Despí,136,2004,1898,1762
694,171851,Sant Joan les Fonts,-26,2004,86,112
695,171668,Sant Jordi Desvalls,-8,2004,32,40
696,089030,Sant Julià de Cerdanyola,-2,2004,10,12
697,171693,Sant Julià de Ramis,130,2004,263,133
698,082205,Sant Julià de Vilatorta,90,2004,173,83
699,179032,Sant Julià del Llor i Bonmatí,10,2004,73,63
700,082212,Sant Just Desvern,193,2004,936,743
701,082227,Sant Llorenç d'Hortons,71,2004,166,95
702,171714,Sant Llorenç de la Muga,4,2004,12,8
703,251930,Sant Llorenç de Morunys,38,2004,70,32
704,082233,Sant Llorenç Savall,42,2004,144,102
705,082251,Sant Martí d'Albars,-3,2004,2,5
706,082248,Sant Martí de Centelles,48,2004,103,55
707,171729,Sant Martí de Llémena,19,2004,50,31
708,259025,Sant Martí de Riucorb,6,2004,21,15
709,082264,Sant Martí de Tous,36,2004,70,34
710,082270,Sant Martí Sarroca,56,2004,215,159
711,082286,Sant Martí Sesgueioles,0,2004,13,13
712,171735,Sant Martí Vell,0,2004,12,12
713,082299,Sant Mateu de Bages,7,2004,28,21
714,171740,Sant Miquel de Campmajor,-4,2004,5,9
715,171753,Sant Miquel de Fluvià,16,2004,59,43
716,171766,Sant Mori,9,2004,13,4
717,171772,Sant Pau de Segúries,12,2004,41,29
718,082310,Sant Pere de Ribes,578,2004,2302,1724
719,082325,Sant Pere de Riudebitlles,53,2004,138,85
720,082331,Sant Pere de Torelló,12,2004,89,77
721,082346,Sant Pere de Vilamajor,155,2004,355,200
722,171788,Sant Pere Pescador,109,2004,221,112
723,081897,Sant Pere Sallavinera,6,2004,6,0
724,082359,Sant Pol de Mar,51,2004,330,279
725,082362,Sant Quintí de Mediona,34,2004,146,112
726,082378,Sant Quirze de Besora,23,2004,84,61
727,082384,Sant Quirze del Vallès,669,2004,1416,747
728,082397,Sant Quirze Safaja,13,2004,66,53
729,251945,Sant Ramon,-2,2004,22,24
730,082401,Sant Sadurní d'Anoia,268,2004,705,437
731,082418,Sant Sadurní d'Osormort,-9,2004,1,10
732,080983,Sant Salvador de Guardiola,134,2004,294,160
733,082628,Sant Vicenç de Castellet,187,2004,496,309
734,082649,Sant Vicenç de Montalt,178,2004,470,292
735,082652,Sant Vicenç de Torelló,32,2004,112,80
736,082634,Sant Vicenç dels Horts,27,2004,1377,1350
737,431384,Santa Bàrbara,4,2004,206,202
738,082439,Santa Cecília de Voltregà,-1,2004,10,11
739,082444,Santa Coloma de Cervelló,221,2004,608,387
740,171805,Santa Coloma de Farners,401,2004,727,326
741,082457,Santa Coloma de Gramenet,534,2004,8555,8021
742,431397,Santa Coloma de Queralt,46,2004,147,101
743,171812,Santa Cristina d'Aro,219,2004,444,225
744,082460,Santa Eugènia de Berga,14,2004,97,83
745,082476,Santa Eulàlia de Riuprimer,17,2004,43,26
746,082482,Santa Eulàlia de Ronçana,259,2004,569,310
747,082495,Santa Fe del Penedès,5,2004,21,16
748,171827,Santa Llogaia d'Àlguema,16,2004,23,7
749,082508,Santa Margarida de Montbui,95,2004,568,473
750,082515,Santa Margarida i els Monjos,172,2004,530,358
751,082589,Santa Maria d'Oló,0,2004,35,35
752,082536,Santa Maria de Besora,14,2004,22,8
753,082567,Santa Maria de Martorelles,25,2004,72,47
754,082554,Santa Maria de Merlès,-1,2004,5,6
755,082573,Santa Maria de Miralles,4,2004,7,3
756,082592,Santa Maria de Palautordera,211,2004,605,394
757,431401,Santa Oliva,111,2004,316,205
758,171848,Santa Pau,24,2004,88,64
759,082606,Santa Perpètua de Mogoda,380,2004,1580,1200
760,082613,Santa Susanna,169,2004,401,232
761,081923,Santpedor,173,2004,344,171
762,431423,Sarral,10,2004,79,69
763,171864,Sarrià de Ter,96,2004,276,180
764,252017,Sarroca de Bellera,1,2004,5,4
765,252000,Sarroca de Lleida,-8,2004,4,12
766,171870,"Saus, Camallera i Llampaies",26,2004,60,34
767,431439,Savallà del Comtat,4,2004,6,2
768,431444,"Secuita, la",80,2004,100,20
769,171886,"Selva de Mar, la",7,2004,13,6
770,431457,"Selva del Camp, la",187,2004,304,117
771,431460,Senan,2,2004,2,0
772,430445,"Sénia, la",194,2004,506,312
773,252022,Senterada,12,2004,15,3
774,250352,"Sentiu de Sió, la",21,2004,31,10
775,082671,Sentmenat,322,2004,646,324
776,171903,Serinyà,39,2004,92,53
777,252043,Seròs,66,2004,139,73
778,171910,Serra de Daró,-1,2004,7,8
779,171925,Setcases,-4,2004,6,10
780,252038,"Seu d'Urgell, la",350,2004,936,586
781,082690,Seva,101,2004,225,124
782,252056,Sidamon,34,2004,76,42
783,171931,Sils,245,2004,404,159
784,082704,Sitges,1146,2004,2520,1374
785,170524,Siurana,-8,2004,10,18
786,082711,Sobremunt,5,2004,11,6
787,252069,"Soleràs, el",-4,2004,17,21
788,431476,Solivella,-12,2004,0,12
789,252075,Solsona,396,2004,654,258
790,082726,Sora,13,2004,22,9
791,252081,Soriguera,14,2004,21,7
792,252094,Sort,90,2004,204,114
793,252108,Soses,61,2004,146,85
794,082732,Subirats,75,2004,184,109
795,252115,Sudanell,13,2004,37,24
796,252120,Sunyer,2,2004,5,3
797,082747,Súria,44,2004,237,193
798,171946,Susqueda,1,2004,14,13
799,082763,Tagamanent,14,2004,30,16
800,082779,Talamanca,6,2004,10,4
801,252154,Talarn,10,2004,31,21
802,252167,Talavera,-10,2004,4,14
803,171959,"Tallada d'Empordà, la",8,2004,22,14
804,082785,Taradell,75,2004,274,199
805,431482,Tarragona,3476,2004,7430,3954
806,252173,Tàrrega,572,2004,1299,727
807,252189,Tarrés,-6,2004,2,8
808,252192,Tarroja de Segarra,3,2004,7,4
809,082750,Tavèrnoles,15,2004,22,7
810,082802,Tavertet,1,2004,4,3
811,082819,Teià,54,2004,295,241
812,252206,Térmens,39,2004,124,85
813,171962,Terrades,-10,2004,0,10
814,082798,Terrassa,3749,2004,10217,6468
815,082824,Tiana,235,2004,520,285
816,252213,Tírvia,-7,2004,0,7
817,252228,Tiurana,11,2004,11,0
818,431495,Tivenys,0,2004,32,32
819,431508,Tivissa,20,2004,71,51
820,082830,Tona,270,2004,539,269
821,252234,Torà,61,2004,105,44
822,082845,Tordera,766,2004,1381,615
823,082858,Torelló,167,2004,580,413
824,252249,"Torms, els",7,2004,12,5
825,252252,Tornabous,-40,2004,24,64
826,252271,"Torre de Cabdella, la",28,2004,45,17
827,082861,"Torre de Claramunt, la",111,2004,362,251
828,431515,"Torre de Fontaubella, la",3,2004,12,9
829,431520,"Torre de l'Espanyol, la",-6,2004,25,31
830,252265,Torrebesses,0,2004,4,4
831,431536,Torredembarra,724,2004,1432,708
832,252287,Torrefarrera,254,2004,376,122
833,259078,Torrefeta i Florejacs,6,2004,37,31
834,252304,Torregrossa,24,2004,114,90
835,252311,Torrelameu,6,2004,29,23
836,082877,Torrelavit,62,2004,103,41
837,082883,Torrelles de Foix,216,2004,367,151
838,082896,Torrelles de Llobregat,239,2004,424,185
839,171978,Torrent,6,2004,13,7
840,252326,Torres de Segre,50,2004,162,112
841,252332,Torre-serona,14,2004,24,10
842,171984,Torroella de Fluvià,27,2004,63,36
843,171997,Torroella de Montgrí,443,2004,887,444
844,431541,Torroja del Priorat,1,2004,5,4
845,172001,Tortellà,-3,2004,26,29
846,431554,Tortosa,1539,2004,2684,1145
847,172018,Toses,1,2004,10,9
848,172023,Tossa de Mar,224,2004,455,231
849,252347,Tremp,-237,2004,0,237
850,172044,Ullà,-10,2004,89,99
851,082900,Ullastrell,40,2004,110,70
852,172057,Ullastret,6,2004,12,6
853,431567,Ulldecona,269,2004,505,236
854,431573,Ulldemolins,3,2004,15,12
855,172039,Ultramort,6,2004,8,2
856,172060,Urús,0,2004,8,8
857,082917,Vacarisses,517,2004,758,241
858,170144,"Vajol, la",-10,2004,11,21
859,172076,"Vall d'en Bas, la",34,2004,96,62
860,172082,"Vall de Bianya, la",20,2004,77,57
861,250432,"Vall de Boí, la",35,2004,81,46
862,259010,Vall de Cardós,11,2004,45,34
863,082922,Vallbona d'Anoia,64,2004,114,50
864,252385,Vallbona de les Monges,-4,2004,6,10
865,082938,Vallcebre,6,2004,20,14
866,431589,Vallclara,-3,2004,5,8
867,252402,Vallfogona de Balaguer,48,2004,89,41
868,171707,Vallfogona de Ripollès,-4,2004,9,13
869,431592,Vallfogona de Riucorb,28,2004,43,15
870,082943,Vallgorguina,163,2004,266,103
871,082956,Vallirana,546,2004,1070,524
872,172095,Vall-llobrega,7,2004,53,46
873,431606,Vallmoll,40,2004,104,64
874,082969,Vallromanes,77,2004,193,116
875,431613,Valls,566,2004,1302,736
876,259062,"Valls d'Aguilar, les",-7,2004,7,14
877,252398,"Valls de Valira, les",24,2004,77,53
878,431628,Vandellòs i l'Hospitalet de l'Infant,167,2004,392,225
879,259097,"Vansa i Fórnols, la",2,2004,5,3
880,082975,Veciana,-1,2004,5,6
881,431634,"Vendrell, el",1848,2004,3488,1640
882,172109,Ventalló,33,2004,78,45
883,252424,Verdú,-11,2004,72,83
884,172116,Verges,9,2004,47,38
885,431649,Vespella de Gaià,52,2004,61,9
886,082981,Vic,1137,2004,2773,1636
887,172121,Vidrà,15,2004,16,1
888,172137,Vidreres,408,2004,711,303
889,252430,Vielha e Mijaran,135,2004,496,361
890,431652,Vilabella,3,2004,33,30
891,172142,Vilabertran,14,2004,61,47
892,172155,Vilablareix,36,2004,107,71
893,082994,Vilada,-2,2004,15,17
894,172174,Viladamat,16,2004,34,18
895,172168,Viladasens,10,2004,14,4
896,083015,Viladecans,411,2004,3452,3041
897,083008,Viladecavalls,2,2004,437,435
898,172180,Vilademuls,16,2004,48,32
899,172207,Viladrau,29,2004,65,36
900,172214,Vilafant,160,2004,333,173
901,083054,Vilafranca del Penedès,1062,2004,2725,1663
902,252445,Vilagrassa,8,2004,27,19
903,172235,Vilajuïga,19,2004,64,45
904,431750,Vilalba dels Arcs,8,2004,18,10
905,083067,Vilalba Sasserra,3,2004,70,67
906,252458,Vilaller,61,2004,112,51
907,172240,Vilallonga de Ter,18,2004,40,22
908,431665,Vilallonga del Camp,60,2004,121,61
909,172253,Vilamacolum,-7,2004,16,23
910,172266,Vilamalla,2,2004,52,50
911,172272,Vilamaniscle,8,2004,11,3
912,252477,Vilamòs,17,2004,26,9
913,172288,Vilanant,3,2004,24,21
914,431671,Vilanova d'Escornalbou,7,2004,30,23
915,252483,Vilanova de Bellpuig,10,2004,37,27
916,252496,Vilanova de l'Aguda,-3,2004,0,3
917,252542,Vilanova de la Barca,45,2004,109,64
918,252509,Vilanova de Meià,3,2004,26,23
919,431687,Vilanova de Prades,-3,2004,12,15
920,083036,Vilanova de Sau,-5,2004,7,12
921,252516,Vilanova de Segrià,35,2004,70,35
922,083020,Vilanova del Camí,306,2004,755,449
923,089024,Vilanova del Vallès,319,2004,471,152
924,083073,Vilanova i la Geltrú,1543,2004,4177,2634
925,431690,Vilaplana,11,2004,32,21
926,431704,Vila-rodona,57,2004,107,50
927,172305,Vila-sacra,14,2004,49,35
928,252521,Vila-sana,15,2004,41,26
929,431711,Vila-seca,754,2004,1528,774
930,082140,Vilassar de Dalt,43,2004,386,343
931,082191,Vilassar de Mar,76,2004,1284,1208
932,172229,Vilaür,6,2004,10,4
933,431726,Vilaverd,16,2004,41,25
934,431732,"Vilella Alta, la",-7,2004,1,8
935,431747,"Vilella Baixa, la",2,2004,8,6
936,172333,Vilobí d'Onyar,150,2004,259,109
937,083041,Vilobí del Penedès,37,2004,88,51
938,172327,Vilopriu,-7,2004,6,13
939,252537,"Vilosell, el",-21,2004,7,28
940,431763,Vimbodí i Poblet,22,2004,62,40
941,252555,Vinaixa,-12,2004,25,37
942,431779,Vinebre,5,2004,27,22
943,431785,Vinyols i els Arcs,49,2004,162,113
944,083089,Viver i Serrateix,2,2004,10,8
945,430521,Xerta,27,2004,60,33
0,250019,Abella de la Conca,0,2005,9,9
1,080018,Abrera,367,2005,943,576
2,250024,Àger,-4,2005,18,22
3,250030,Agramunt,60,2005,363,303
4,080023,Aguilar de Segarra,14,2005,14,0
5,170010,Agullana,-10,2005,47,57
6,080142,Aiguafreda,74,2005,200,126
7,430017,Aiguamúrcia,44,2005,78,34
8,170025,Aiguaviva,-2,2005,25,27
9,250387,Aitona,28,2005,170,142
10,250045,"Alamús, els",-14,2005,31,45
11,250058,Alàs i Cerc,5,2005,23,18
12,250061,"Albagés, l'",1,2005,15,14
13,170031,Albanyà,7,2005,15,8
14,250077,Albatàrrec,49,2005,129,80
15,250083,Albesa,17,2005,70,53
16,250096,"Albi, l'",-25,2005,21,46
17,430022,Albinyana,88,2005,224,136
18,430038,"Albiol, l'",10,2005,39,29
19,170046,Albons,17,2005,47,30
20,430043,Alcanar,385,2005,764,379
21,250100,Alcanó,7,2005,10,3
22,250117,Alcarràs,545,2005,782,237
23,250122,Alcoletge,143,2005,223,80
24,430056,Alcover,119,2005,275,156
25,439044,"Aldea, l'",188,2005,293,105
26,430069,Aldover,42,2005,68,26
27,430075,"Aleixar, l'",22,2005,63,41
28,080039,Alella,67,2005,523,456
29,430081,Alfara de Carles,-7,2005,0,7
30,250138,Alfarràs,36,2005,202,166
31,250143,Alfés,2,2005,17,15
32,430094,Alforja,81,2005,153,72
33,250156,Algerri,-15,2005,9,24
34,250169,Alguaire,72,2005,191,119
35,250175,Alins,-2,2005,4,6
36,430108,Alió,-1,2005,23,24
37,250194,Almacelles,89,2005,339,250
38,250208,Almatret,-5,2005,13,18
39,250215,Almenar,6,2005,142,136
40,430115,Almoster,106,2005,145,39
41,250220,Alòs de Balaguer,-4,2005,9,13
42,170062,Alp,63,2005,172,109
43,080044,Alpens,16,2005,26,10
44,250236,Alpicat,164,2005,387,223
45,250241,Alt Àneu,5,2005,24,19
46,430120,Altafulla,224,2005,442,218
47,170078,Amer,29,2005,118,89
48,430136,"Ametlla de Mar, l'",361,2005,582,221
49,080057,"Ametlla del Vallès, l'",146,2005,614,468
50,439060,"Ampolla, l'",167,2005,298,131
51,430141,Amposta,398,2005,1133,735
52,170084,Anglès,23,2005,257,234
53,250273,Anglesola,10,2005,59,49
54,250292,Arbeca,9,2005,95,86
55,430167,"Arboç, l'",248,2005,470,222
56,430154,Arbolí,-4,2005,6,10
57,170097,Arbúcies,208,2005,479,271
58,080060,Arenys de Mar,154,2005,971,817
59,080076,Arenys de Munt,293,2005,698,405
60,170101,Argelaguer,7,2005,17,10
61,080082,Argençola,1,2005,9,8
62,430173,"Argentera, l'",-8,2005,7,15
63,080095,Argentona,242,2005,772,530
64,170118,"Armentera, l'",-5,2005,26,31
65,430189,Arnes,1,2005,19,18
66,250313,Arres,-6,2005,0,6
67,250328,Arsèguel,0,2005,7,7
68,080109,Artés,92,2005,258,166
69,250334,Artesa de Lleida,13,2005,77,64
70,250349,Artesa de Segre,-10,2005,195,205
71,430192,Ascó,14,2005,56,42
72,250365,Aspa,6,2005,14,8
73,250371,"Avellanes i Santa Linya, les",4,2005,20,16
74,080116,Avià,53,2005,134,81
75,080121,Avinyó,47,2005,116,69
76,170123,Avinyonet de Puigventós,133,2005,184,51
77,080137,Avinyonet del Penedès,43,2005,131,88
78,080155,Badalona,212,2005,15256,15044
79,089045,Badia del Vallès,-236,2005,759,995
80,080168,Bagà,27,2005,102,75
81,250390,Baix Pallars,-8,2005,12,20
82,250404,Balaguer,445,2005,1164,719
83,080174,Balenyà,35,2005,182,147
84,080180,Balsareny,44,2005,148,104
85,430206,Banyeres del Penedès,216,2005,334,118
86,170157,Banyoles,342,2005,1026,684
87,250411,Barbens,6,2005,39,33
88,430213,Barberà de la Conca,17,2005,38,21
89,082520,Barberà del Vallès,617,2005,2107,1490
90,080193,Barcelona,12047,2005,97133,85086
91,250426,"Baronia de Rialb, la",4,2005,21,17
92,170160,Bàscara,25,2005,66,41
93,250447,Bassella,0,2005,12,12
94,430228,Batea,18,2005,58,40
95,250450,Bausen,0,2005,1,1
96,080207,Begues,176,2005,444,268
97,170139,Begur,30,2005,259,229
98,250463,Belianes,-26,2005,17,43
99,251706,Bellaguarda,3,2005,11,8
100,170182,Bellcaire d'Empordà,5,2005,55,50
101,250479,Bellcaire d'Urgell,20,2005,74,54
102,250485,Bell-lloc d'Urgell,48,2005,125,77
103,250498,Bellmunt d'Urgell,-3,2005,0,3
104,430234,Bellmunt del Priorat,13,2005,25,12
105,080214,Bellprat,10,2005,13,3
106,250501,Bellpuig,99,2005,291,192
107,430249,Bellvei,59,2005,195,136
108,250518,Bellver de Cerdanya,101,2005,201,100
109,250523,Bellvís,39,2005,157,118
110,250539,Benavent de Segrià,39,2005,101,62
111,430252,Benifallet,-15,2005,0,15
112,430265,Benissanet,67,2005,112,45
113,080229,Berga,339,2005,941,602
114,170195,Besalú,49,2005,146,97
115,170209,Bescanó,85,2005,179,94
116,170216,Beuda,16,2005,25,9
117,080235,Bigues i Riells del Fai,267,2005,741,474
118,250557,Biosca,-11,2005,8,19
119,170221,"Bisbal d'Empordà, la",181,2005,642,461
120,430271,"Bisbal de Falset, la",12,2005,13,1
121,430287,"Bisbal del Penedès, la",173,2005,386,213
122,172348,Biure,-6,2005,6,12
123,430290,Blancafort,9,2005,13,4
124,170237,Blanes,870,2005,2861,1991
125,170293,Boadella i les Escaules,-9,2005,1,10
126,170242,Bolvir,3,2005,35,32
127,430304,Bonastre,39,2005,83,44
128,250576,"Bòrdes, Es",4,2005,14,10
129,170255,Bordils,43,2005,134,91
130,250582,"Borges Blanques, les",111,2005,265,154
131,430311,"Borges del Camp, les",53,2005,146,93
132,170268,Borrassà,31,2005,56,25
133,080240,Borredà,16,2005,51,35
134,250595,Bossòst,54,2005,104,50
135,430326,Bot,-15,2005,16,31
136,430332,Botarell,31,2005,107,76
137,250560,Bovera,-2,2005,3,5
138,430347,Bràfim,13,2005,40,27
139,170274,Breda,41,2005,178,137
140,080253,"Bruc, el",102,2005,195,93
141,080266,"Brull, el",9,2005,24,15
142,170280,Brunyola i Sant Martí Sapresa,11,2005,23,12
143,430350,Cabacés,2,2005,7,5
144,250609,Cabanabona,-5,2005,6,11
145,170314,Cabanelles,6,2005,20,14
146,170307,Cabanes,19,2005,62,43
147,080272,"Cabanyes, les",96,2005,121,25
148,250616,Cabó,-1,2005,0,1
149,430363,Cabra del Camp,78,2005,143,65
150,080288,Cabrera d'Anoia,109,2005,185,76
151,080291,Cabrera de Mar,-11,2005,236,247
152,080305,Cabrils,234,2005,644,410
153,170329,Cadaqués,94,2005,206,112
154,080312,Calaf,67,2005,224,157
155,430379,Calafell,1577,2005,3185,1608
156,080348,Calders,25,2005,64,39
157,080327,Caldes d'Estrac,103,2005,312,209
158,170335,Caldes de Malavella,258,2005,543,285
159,080333,Caldes de Montbui,335,2005,1007,672
160,080351,Calella,756,2005,1849,1093
161,080370,Calldetenes,33,2005,153,120
162,080386,Callús,92,2005,144,52
163,080364,Calonge de Segarra,0,2005,1,1
164,170340,Calonge i Sant Antoni,372,2005,981,609
165,250621,Camarasa,13,2005,44,31
166,439039,Camarles,111,2005,211,100
167,430385,Cambrils,1407,2005,2874,1467
168,170353,Camós,4,2005,32,28
169,170366,Campdevànol,76,2005,158,82
170,170372,Campelles,-3,2005,5,8
171,080399,Campins,1,2005,25,24
172,170388,Campllong,9,2005,14,5
173,170391,Camprodon,18,2005,153,135
174,250637,Canejan,-3,2005,1,4
175,170405,Canet d'Adri,13,2005,30,17
176,080403,Canet de Mar,239,2005,773,534
177,080410,Canovelles,298,2005,1362,1064
178,080425,Cànoves i Samalús,114,2005,232,118
179,170412,Cantallops,14,2005,28,14
180,080431,Canyelles,260,2005,471,211
181,430398,Capafonts,6,2005,9,3
182,430402,Capçanes,14,2005,21,7
183,080446,Capellades,101,2005,331,230
184,170427,Capmany,14,2005,37,23
185,080459,Capolat,-7,2005,4,11
186,080462,Cardedeu,404,2005,1089,685
187,080478,Cardona,24,2005,171,147
188,080484,Carme,44,2005,81,37
189,430419,Caseres,0,2005,3,3
190,170448,Cassà de la Selva,231,2005,529,298
191,080497,Casserres,55,2005,115,60
192,080575,Castell de l'Areny,7,2005,9,2
193,259046,Castell de Mur,-9,2005,0,9
194,250642,Castellar de la Ribera,1,2005,2,1
195,080522,Castellar de n'Hug,19,2005,28,9
196,080500,Castellar del Riu,-3,2005,6,9
197,080517,Castellar del Vallès,493,2005,1328,835
198,080538,Castellbell i el Vilar,72,2005,250,178
199,080543,Castellbisbal,299,2005,817,518
200,080556,Castellcir,43,2005,74,31
201,250674,Castelldans,24,2005,67,43
202,080569,Castelldefels,1447,2005,5537,4090
203,080581,Castellet i la Gornal,120,2005,232,112
204,170464,Castellfollit de la Roca,12,2005,76,64
205,080608,Castellfollit de Riubregós,-1,2005,11,12
206,080594,Castellfollit del Boix,5,2005,20,15
207,080615,Castellgalí,143,2005,218,75
208,080620,Castellnou de Bages,46,2005,93,47
209,250680,Castellnou de Seana,14,2005,33,19
210,170470,Castelló d'Empúries,707,2005,1280,573
211,250693,Castelló de Farfanya,-14,2005,24,38
212,080636,Castellolí,3,2005,21,18
213,170486,Castell-Platja d'Aro,376,2005,1092,716
214,250707,Castellserà,-5,2005,62,67
215,080641,Castellterçol,19,2005,139,120
216,430424,Castellvell del Camp,16,2005,123,107
217,080654,Castellví de la Marca,35,2005,116,81
218,080667,Castellví de Rosanes,123,2005,202,79
219,430430,"Catllar, el",300,2005,442,142
220,250714,Cava,-2,2005,2,4
221,171899,"Cellera de Ter, la",20,2005,94,74
222,170499,Celrà,254,2005,472,218
223,080673,Centelles,164,2005,406,242
224,082687,Cercs,8,2005,66,58
225,082665,Cerdanyola del Vallès,199,2005,3369,3170
226,080689,Cervelló,230,2005,742,512
227,250729,Cervera,75,2005,604,529
228,250735,Cervià de les Garrigues,5,2005,43,38
229,170502,Cervià de Ter,36,2005,59,23
230,170519,Cistella,2,2005,13,11
231,250740,Ciutadilla,-6,2005,13,19
232,250753,Clariana de Cardener,-9,2005,0,9
233,250766,"Cogul, el",0,2005,8,8
234,170545,Colera,8,2005,44,36
235,250772,Coll de Nargó,25,2005,47,22
236,080692,Collbató,208,2005,438,230
237,430458,Colldejou,0,2005,10,10
238,080706,Collsuspina,16,2005,24,8
239,170558,Colomers,2,2005,7,5
240,251636,"Coma i la Pedra, la",-21,2005,0,21
241,251615,Conca de Dalt,-9,2005,8,17
242,430461,Conesa,8,2005,19,11
243,430477,Constantí,193,2005,532,339
244,080713,Copons,5,2005,18,13
245,430483,Corbera d'Ebre,12,2005,45,33
246,080728,Corbera de Llobregat,649,2005,1325,676
247,250788,Corbins,31,2005,92,61
248,170577,Corçà,41,2005,99,58
249,080734,Cornellà de Llobregat,836,2005,5712,4876
250,170561,Cornellà del Terri,50,2005,132,82
251,430496,Cornudella de Montsant,43,2005,82,39
252,430509,Creixell,287,2005,468,181
253,170583,Crespià,4,2005,14,10
254,179011,"Cruïlles, Monells i Sant Sadurní de l'Heura",23,2005,91,68
255,080749,Cubelles,1151,2005,1915,764
256,250791,Cubells,11,2005,21,10
257,430516,Cunit,1076,2005,1985,909
258,170600,Darnius,21,2005,37,16
259,170617,Das,8,2005,17,9
260,439018,Deltebre,150,2005,333,183
261,080752,Dosrius,336,2005,564,228
262,430537,Duesaigües,8,2005,15,7
263,170622,"Escala, l'",408,2005,765,357
264,080765,Esparreguera,299,2005,1475,1176
265,170638,Espinelves,1,2005,9,8
266,250812,"Espluga Calba, l'",-5,2005,26,31
267,430542,"Espluga de Francolí, l'",73,2005,207,134
268,080771,Esplugues de Llobregat,175,2005,3362,3187
269,170643,Espolla,-18,2005,0,18
270,170656,Esponellà,-2,2005,22,24
271,250827,Espot,-1,2005,25,26
272,080787,"Espunyola, l'",1,2005,9,8
273,082541,"Esquirol, l'",49,2005,114,65
274,250886,Estamariu,-1,2005,3,4
275,080790,"Estany, l'",-10,2005,8,18
276,250851,Estaràs,-1,2005,4,5
277,250864,Esterri d'Àneu,31,2005,99,68
278,250870,Esterri de Cardós,0,2005,1,1
279,430555,Falset,67,2005,152,85
280,170059,"Far d'Empordà, el",15,2005,24,9
281,250899,Farrera,-2,2005,1,3
282,430568,"Fatarella, la",-14,2005,14,28
283,430574,"Febró, la",1,2005,1,0
284,081347,Figaró-Montmany,9,2005,91,82
285,080804,Fígols,-6,2005,0,6
286,259084,Fígols i Alinyà,-6,2005,3,9
287,430580,"Figuera, la",-23,2005,3,26
288,170669,Figueres,807,2005,2899,2092
289,430593,Figuerola del Camp,4,2005,19,15
290,170675,Flaçà,21,2005,68,47
291,430607,Flix,-27,2005,116,143
292,250925,"Floresta, la",2,2005,13,11
293,080826,Fogars de la Selva,159,2005,241,82
294,080811,Fogars de Montclús,20,2005,30,10
295,170681,Foixà,-4,2005,12,16
296,080832,Folgueroles,56,2005,120,64
297,250931,Fondarella,-6,2005,33,39
298,080847,Fonollosa,65,2005,106,41
299,170694,Fontanals de Cerdanya,-10,2005,19,29
300,170708,Fontanilles,8,2005,18,10
301,170715,Fontcoberta,32,2005,81,49
302,080850,Font-rubí,28,2005,83,55
303,250946,Foradada,-8,2005,13,21
304,179026,Forallac,9,2005,95,86
305,430614,Forès,-4,2005,2,6
306,170736,Fornells de la Selva,-16,2005,49,65
307,170741,Fortià,3,2005,33,30
308,080863,"Franqueses del Vallès, les",489,2005,1453,964
309,430629,Freginals,39,2005,55,16
310,250962,"Fuliola, la",33,2005,66,33
311,250978,Fulleda,-3,2005,1,4
312,080902,Gaià,-4,2005,5,9
313,430635,"Galera, la",27,2005,52,25
314,080879,Gallifa,3,2005,15,12
315,430640,Gandesa,62,2005,155,93
316,430653,Garcia,31,2005,45,14
317,430666,"Garidells, els",11,2005,18,7
318,080885,"Garriga, la",380,2005,887,507
319,170754,Garrigàs,16,2005,21,5
320,170767,Garrigoles,-3,2005,6,9
321,170773,Garriguella,11,2005,62,51
322,080898,Gavà,530,2005,3061,2531
323,250984,Gavet de la Conca,3,2005,13,10
324,080919,Gelida,259,2005,570,311
325,170789,Ger,12,2005,57,45
326,259123,Gimenells i el Pla de la Font,14,2005,38,24
327,430672,Ginestar,29,2005,66,37
328,170792,Girona,2530,2005,7636,5106
329,080924,Gironella,-14,2005,164,178
330,080930,Gisclareny,-2,2005,1,3
331,430688,Godall,35,2005,61,26
332,250997,Golmés,47,2005,122,75
333,170806,Gombrèn,-6,2005,7,13
334,251001,Gósol,-5,2005,19,24
335,080945,"Granada, la",163,2005,209,46
336,251018,"Granadella, la",-8,2005,22,30
337,080958,Granera,-2,2005,4,6
338,251023,"Granja d'Escarp, la",0,2005,41,41
339,080961,Granollers,783,2005,4407,3624
340,251039,Granyanella,1,2005,4,3
341,251057,Granyena de les Garrigues,11,2005,17,6
342,251044,Granyena de Segarra,-2,2005,0,2
343,430691,Gratallops,1,2005,13,12
344,080977,Gualba,46,2005,110,64
345,170813,Gualta,5,2005,44,39
346,080996,Guardiola de Berguedà,15,2005,61,46
347,430705,"Guiamets, els",6,2005,13,7
348,170828,Guils de Cerdanya,30,2005,54,24
349,251095,Guimerà,-17,2005,23,40
350,259031,"Guingueta d'Àneu, la",4,2005,30,26
351,251109,Guissona,263,2005,614,351
352,251116,Guixers,-5,2005,3,8
353,081000,Gurb,105,2005,142,37
354,430712,Horta de Sant Joan,3,2005,38,35
355,081017,"Hospitalet de Llobregat, l'",2731,2005,20667,17936
356,081629,"Hostalets de Pierola, els",120,2005,241,121
357,170834,Hostalric,138,2005,337,199
358,081022,Igualada,740,2005,2460,1720
359,251155,Isona i Conca Dellà,12,2005,66,54
360,170849,Isòvol,34,2005,40,6
361,251137,Ivars d'Urgell,11,2005,95,84
362,251121,Ivars de Noguera,6,2005,20,14
363,251142,Ivorra,0,2005,4,4
364,170852,Jafre,10,2005,27,17
365,170865,"Jonquera, la",47,2005,299,252
366,081038,Jorba,56,2005,80,24
367,259101,Josa i Tuixén,6,2005,16,10
368,170871,Juià,14,2005,34,20
369,251180,Juncosa,-10,2005,18,28
370,251193,Juneda,50,2005,181,131
371,251214,Les,68,2005,118,50
372,251229,Linyola,-1,2005,123,124
373,081043,"Llacuna, la",-7,2005,51,58
374,170887,Lladó,17,2005,35,18
375,251235,Lladorre,-4,2005,8,12
376,251240,Lladurs,-10,2005,4,14
377,081056,"Llagosta, la",109,2005,987,878
378,170890,Llagostera,339,2005,589,250
379,170904,Llambilles,27,2005,60,33
380,170911,Llanars,8,2005,43,35
381,170926,Llançà,177,2005,350,173
382,251253,Llardecans,6,2005,16,10
383,251266,Llavorsí,-1,2005,31,32
384,251207,Lleida,2201,2005,8063,5862
385,170932,Llers,23,2005,70,47
386,251272,Lles de Cerdanya,-5,2005,0,5
387,081075,Lliçà d'Amunt,415,2005,1083,668
388,081081,Lliçà de Vall,135,2005,453,318
389,251288,Llimiana,-6,2005,1,7
390,081069,Llinars del Vallès,224,2005,782,558
391,170947,Llívia,33,2005,127,94
392,430727,"Lloar, el",-7,2005,1,8
393,251291,Llobera,0,2005,2,2
394,430733,Llorac,3,2005,9,6
395,430748,Llorenç del Penedès,61,2005,137,76
396,170950,Lloret de Mar,3053,2005,4647,1594
397,170963,"Llosses, les",-18,2005,13,31
398,081094,Lluçà,1,2005,13,12
399,171024,Maçanet de Cabrenys,-15,2005,18,33
400,171030,Maçanet de la Selva,311,2005,629,318
401,170979,Madremanya,-1,2005,13,14
402,170985,Maià de Montcal,9,2005,24,15
403,251333,Maials,14,2005,35,21
404,251305,Maldà,-2,2005,19,21
405,081108,Malgrat de Mar,609,2005,1545,936
406,081115,Malla,-3,2005,16,19
407,081120,Manlleu,380,2005,1238,858
408,081136,Manresa,1819,2005,4648,2829
409,430764,Marçà,29,2005,54,25
410,430751,Margalef,-1,2005,2,3
411,082423,Marganell,10,2005,26,16
412,081141,Martorell,190,2005,1841,1651
413,081154,Martorelles,16,2005,305,289
414,430770,Mas de Barberans,-17,2005,16,33
415,171002,Masarac,10,2005,16,6
416,430786,Masdenverge,11,2005,55,44
417,081167,"Masies de Roda, les",26,2005,49,23
418,081173,"Masies de Voltregà, les",42,2005,165,123
419,430799,Masllorenç,40,2005,64,24
420,081189,"Masnou, el",220,2005,1335,1115
421,430803,"Masó, la",-1,2005,7,8
422,430810,Maspujols,9,2005,30,21
423,081192,Masquefa,279,2005,687,408
424,430825,"Masroig, el",14,2005,30,16
425,251312,Massalcoreig,13,2005,42,29
426,171019,Massanes,37,2005,78,41
427,251327,Massoteres,16,2005,38,22
428,081206,Matadepera,149,2005,495,346
429,081213,Mataró,1489,2005,6378,4889
430,081228,Mediona,131,2005,269,138
431,251348,Menàrguens,14,2005,46,32
432,170998,Meranges,-7,2005,2,9
433,171058,Mieres,-15,2005,8,23
434,430831,"Milà, el",1,2005,2,1
435,251351,Miralcamp,24,2005,74,50
436,430846,Miravet,-1,2005,35,36
437,081385,Moià,219,2005,448,229
438,430859,"Molar, el",16,2005,30,14
439,081234,Molins de Rei,258,2005,1290,1032
440,251370,Mollerussa,604,2005,1270,666
441,171061,Mollet de Peralada,-1,2005,8,9
442,081249,Mollet del Vallès,71,2005,3285,3214
443,171077,Molló,-7,2005,16,23
444,251364,"Molsosa, la",-4,2005,0,4
445,081287,Monistrol de Calders,26,2005,47,21
446,081271,Monistrol de Montserrat,70,2005,248,178
447,171096,Montagut i Oix,24,2005,69,45
448,430862,Montblanc,77,2005,313,236
449,430884,Montbrió del Camp,94,2005,209,115
450,081252,Montcada i Reixac,171,2005,2230,2059
451,081304,Montclar,-1,2005,2,3
452,251399,Montellà i Martinet,30,2005,57,27
453,081311,Montesquiu,15,2005,74,59
454,251403,Montferrer i Castellbò,83,2005,128,45
455,430897,Montferri,29,2005,41,12
456,251386,Montgai,-6,2005,17,23
457,081265,Montgat,262,2005,838,576
458,081326,Montmajor,7,2005,23,16
459,081332,Montmaneu,-3,2005,16,19
460,430901,"Montmell, el",107,2005,207,100
461,081350,Montmeló,67,2005,467,400
462,251425,Montoliu de Lleida,0,2005,27,27
463,251410,Montoliu de Segarra,-2,2005,11,13
464,251431,Montornès de Segarra,1,2005,4,3
465,081363,Montornès del Vallès,188,2005,1076,888
466,430918,Mont-ral,-2,2005,5,7
467,171100,Mont-ras,12,2005,115,103
468,430923,Mont-roig del Camp,747,2005,1297,550
469,081379,Montseny,-8,2005,11,19
470,430939,Móra d'Ebre,112,2005,275,163
471,430944,Móra la Nova,-51,2005,137,188
472,430957,"Morell, el",99,2005,237,138
473,430960,"Morera de Montsant, la",-2,2005,14,16
474,081290,Muntanyola,32,2005,56,24
475,081398,Mura,15,2005,19,4
476,251459,Nalec,10,2005,14,4
477,250254,Naut Aran,0,2005,116,116
478,081402,Navarcles,92,2005,283,191
479,081419,Navàs,91,2005,259,168
480,171117,Navata,101,2005,122,21
481,251462,Navès,-5,2005,4,9
482,081424,"Nou de Berguedà, la",1,2005,4,3
483,430976,"Nou de Gaià, la",3,2005,42,39
484,430982,Nulles,3,2005,18,15
485,251484,Odèn,12,2005,14,2
486,081430,Òdena,154,2005,305,151
487,171122,Ogassa,9,2005,16,7
488,081458,Olèrdola,202,2005,345,143
489,081461,Olesa de Bonesvalls,119,2005,190,71
490,081477,Olesa de Montserrat,389,2005,1542,1153
491,251497,Oliana,43,2005,130,87
492,251500,Oliola,-22,2005,4,26
493,251517,Olius,60,2005,71,11
494,081483,Olivella,244,2005,451,207
495,081496,Olost,-12,2005,28,40
496,171143,Olot,809,2005,2001,1192
497,251522,"Oluges, les",-3,2005,2,5
498,081445,Olvan,32,2005,57,25
499,251538,"Omellons, els",-9,2005,7,16
500,251543,"Omells de na Gaia, els",2,2005,9,7
501,171156,Ordis,1,2005,15,14
502,251556,Organyà,11,2005,58,47
503,081509,Orís,8,2005,27,19
504,081516,Oristà,-4,2005,20,24
505,081521,Orpí,1,2005,13,12
506,081537,Òrrius,-18,2005,0,18
507,251569,Os de Balaguer,35,2005,60,25
508,171169,Osor,-16,2005,0,16
509,251575,Ossó de Sió,-9,2005,0,9
510,081542,Pacs del Penedès,34,2005,70,36
511,081555,Palafolls,414,2005,803,389
512,171175,Palafrugell,631,2005,1467,836
513,171181,Palamós,262,2005,1100,838
514,251581,"Palau d'Anglesola, el",52,2005,111,59
515,171194,Palau de Santa Eulàlia,4,2005,4,0
516,171215,Palau-sator,-5,2005,15,20
517,171208,Palau-saverdera,42,2005,118,76
518,081568,Palau-solità i Plegamans,310,2005,964,654
519,431009,"Pallaresos, els",134,2005,286,152
520,081574,Pallejà,206,2005,775,569
521,430995,"Palma d'Ebre, la",1,2005,3,2
522,089058,"Palma de Cervelló, la",51,2005,256,205
523,171236,Palol de Revardit,0,2005,18,18
524,171241,Pals,57,2005,184,127
525,081580,"Papiol, el",31,2005,205,174
526,171254,Pardines,-14,2005,1,15
527,081593,Parets del Vallès,193,2005,1115,922
528,171267,Parlavà,11,2005,25,14
529,431016,Passanant i Belltall,-17,2005,4,21
530,171289,Pau,24,2005,56,32
531,431021,Paüls,-1,2005,9,10
532,171292,Pedret i Marzà,-5,2005,13,18
533,251641,Penelles,-1,2005,21,22
534,171306,"Pera, la",8,2005,24,16
535,081607,Perafita,2,2005,19,17
536,431037,Perafort,103,2005,144,41
537,171328,Peralada,75,2005,139,64
538,251654,Peramola,6,2005,30,24
539,431042,"Perelló, el",201,2005,283,82
540,081614,Piera,663,2005,1318,655
541,431055,"Piles, les",5,2005,13,8
542,081635,Pineda de Mar,770,2005,2487,1717
543,431068,"Pinell de Brai, el",20,2005,44,24
544,251667,Pinell de Solsonès,1,2005,7,6
545,251673,Pinós,9,2005,22,13
546,431074,Pira,1,2005,17,16
547,431080,"Pla de Santa Maria, el",102,2005,192,90
548,081640,"Pla del Penedès, el",30,2005,57,27
549,171334,"Planes d'Hostoles, les",33,2005,83,50
550,171349,Planoles,-23,2005,15,38
551,259118,"Plans de Sió, els",-8,2005,9,17
552,251689,"Poal, el",1,2005,17,16
553,251692,"Pobla de Cérvoles, la",-2,2005,8,10
554,081653,"Pobla de Claramunt, la",34,2005,180,146
555,081666,"Pobla de Lillet, la",8,2005,52,44
556,431093,"Pobla de Mafumet, la",67,2005,134,67
557,431107,"Pobla de Massaluca, la",-1,2005,17,18
558,431114,"Pobla de Montornès, la",194,2005,366,172
559,251713,"Pobla de Segur, la",70,2005,183,113
560,431129,Poboleda,8,2005,38,30
561,081672,Polinyà,210,2005,615,405
562,431135,"Pont d'Armentera, el",-7,2005,28,35
563,250306,"Pont de Bar, el",19,2005,29,10
564,171352,Pont de Molins,8,2005,25,17
565,251734,"Pont de Suert, el",27,2005,143,116
566,081825,"Pont de Vilomara i Rocafort, el",152,2005,332,180
567,431418,Pontils,0,2005,17,17
568,081688,Pontons,23,2005,78,55
569,171365,Pontós,-8,2005,3,11
570,251728,Ponts,38,2005,158,120
571,171371,Porqueres,103,2005,272,169
572,431140,Porrera,-2,2005,16,18
573,171404,"Port de la Selva, el",7,2005,74,67
574,171387,Portbou,2,2005,67,65
575,251749,"Portella, la",-44,2005,100,144
576,431153,Pradell de la Teixeta,-12,2005,0,12
577,431166,Prades,12,2005,53,41
578,431172,Prat de Comte,7,2005,9,2
579,081691,"Prat de Llobregat, el",-300,2005,2424,2724
580,431188,Pratdip,37,2005,73,36
581,081712,Prats de Lluçanès,60,2005,135,75
582,081705,"Prats de Rei, els",5,2005,30,25
583,251752,Prats i Sansor,2,2005,18,16
584,251765,Preixana,1,2005,15,14
585,251771,Preixens,16,2005,41,25
586,082303,Premià de Dalt,28,2005,664,636
587,081727,Premià de Mar,-25,2005,1787,1812
588,171390,"Preses, les",28,2005,83,55
589,251790,Prullans,-8,2005,11,19
590,171411,Puigcerdà,142,2005,650,508
591,081748,Puigdàlber,-8,2005,17,25
592,251804,Puiggròs,-3,2005,8,11
593,431191,Puigpelat,29,2005,76,47
594,081751,Puig-reig,43,2005,215,172
595,251811,Puigverd d'Agramunt,3,2005,29,26
596,251826,Puigverd de Lleida,54,2005,106,52
597,081764,Pujalt,3,2005,8,5
598,081770,"Quar, la",-7,2005,0,7
599,171426,Quart,3,2005,103,100
600,170433,Queralbs,-4,2005,4,8
601,431205,Querol,43,2005,83,40
602,171432,Rabós,13,2005,17,4
603,081786,Rajadell,16,2005,47,31
604,431212,Rasquera,16,2005,49,33
605,171447,Regencós,1,2005,14,13
606,081799,Rellinars,42,2005,106,64
607,431227,Renau,4,2005,7,3
608,431233,Reus,3265,2005,7206,3941
609,251832,Rialp,20,2005,76,56
610,431248,"Riba, la",13,2005,50,37
611,431251,Riba-roja d'Ebre,-5,2005,65,70
612,259059,Ribera d'Ondara,-5,2005,22,27
613,251850,Ribera d'Urgellet,49,2005,133,84
614,171450,Ribes de Freser,2,2005,90,88
615,171463,Riells i Viabrea,191,2005,407,216
616,431264,"Riera de Gaià, la",42,2005,109,67
617,251863,Riner,-6,2005,7,13
618,171479,Ripoll,135,2005,525,390
619,081803,Ripollet,399,2005,2375,1976
620,259139,Riu de Cerdanya,-8,2005,0,8
621,171485,Riudarenes,79,2005,194,115
622,171498,Riudaura,-3,2005,17,20
623,431270,Riudecanyes,43,2005,76,33
624,431286,Riudecols,56,2005,97,41
625,171501,Riudellots de la Selva,82,2005,145,63
626,431299,Riudoms,178,2005,436,258
627,171518,Riumors,1,2005,7,6
628,081810,"Roca del Vallès, la",387,2005,857,470
629,431303,Rocafort de Queralt,5,2005,15,10
630,431310,Roda de Berà,255,2005,553,298
631,081831,Roda de Ter,72,2005,293,221
632,431325,Rodonyà,16,2005,44,28
633,431331,Roquetes,214,2005,565,351
634,171523,Roses,1202,2005,1821,619
635,251898,Rosselló,185,2005,289,104
636,431346,"Rourell, el",36,2005,51,15
637,081846,Rubí,1033,2005,4066,3033
638,081859,Rubió,10,2005,19,9
639,171539,Rupià,14,2005,21,7
640,089019,Rupit i Pruit,-1,2005,19,20
641,081878,Sabadell,3008,2005,10363,7355
642,081884,Sagàs,0,2005,10,10
643,251902,Salàs de Pallars,2,2005,31,29
644,081901,Saldes,-14,2005,15,29
645,171544,Sales de Llierca,10,2005,11,1
646,081918,Sallent,72,2005,286,214
647,431359,Salomó,7,2005,23,16
648,439057,Salou,1802,2005,3611,1809
649,171557,Salt,488,2005,2933,2445
650,251919,Sanaüja,-17,2005,10,27
651,081944,Sant Adrià de Besòs,-51,2005,1923,1974
652,081957,Sant Agustí de Lluçanès,-3,2005,2,5
653,081960,Sant Andreu de la Barca,90,2005,1754,1664
654,081976,Sant Andreu de Llavaneres,80,2005,589,509
655,171576,Sant Andreu Salou,0,2005,3,3
656,171833,Sant Aniol de Finestres,3,2005,20,17
657,081982,Sant Antoni de Vilamajor,229,2005,488,259
658,081995,Sant Bartomeu del Grau,-32,2005,43,75
659,082009,Sant Boi de Llobregat,-84,2005,3784,3868
660,082016,Sant Boi de Lluçanès,15,2005,35,20
661,431362,Sant Carles de la Ràpita,486,2005,994,508
662,082037,Sant Cebrià de Vallalta,275,2005,454,179
663,082021,Sant Celoni,411,2005,1161,750
664,082042,Sant Climent de Llobregat,22,2005,194,172
665,171582,Sant Climent Sescebes,5,2005,50,45
666,082055,Sant Cugat del Vallès,1562,2005,4786,3224
667,082068,Sant Cugat Sesgarrigues,36,2005,78,42
668,251961,Sant Esteve de la Sarga,8,2005,11,3
669,082074,Sant Esteve de Palautordera,109,2005,247,138
670,082080,Sant Esteve Sesrovires,245,2005,544,299
671,171595,Sant Feliu de Buixalleu,-8,2005,22,30
672,082107,Sant Feliu de Codines,123,2005,453,330
673,171609,Sant Feliu de Guíxols,518,2005,1389,871
674,082114,Sant Feliu de Llobregat,-11,2005,2075,2086
675,171616,Sant Feliu de Pallerols,51,2005,96,45
676,082129,Sant Feliu Sasserra,-18,2005,12,30
677,171621,Sant Ferriol,-7,2005,6,13
678,082093,Sant Fost de Campsentelles,155,2005,518,363
679,082135,Sant Fruitós de Bages,348,2005,677,329
680,171637,Sant Gregori,70,2005,177,107
681,251924,Sant Guim de Freixenet,10,2005,72,62
682,251977,Sant Guim de la Plana,-4,2005,13,17
683,171642,Sant Hilari Sacalm,86,2005,229,143
684,082153,Sant Hipòlit de Voltregà,84,2005,227,143
685,081939,Sant Iscle de Vallalta,46,2005,109,63
686,439023,Sant Jaume d'Enveja,12,2005,91,79
687,082166,Sant Jaume de Frontanyà,3,2005,6,3
688,171655,Sant Jaume de Llierca,41,2005,69,28
689,431378,Sant Jaume dels Domenys,129,2005,215,86
690,171674,Sant Joan de les Abadesses,-6,2005,137,143
691,171680,Sant Joan de Mollet,9,2005,28,19
692,082188,Sant Joan de Vilatorrada,67,2005,478,411
693,082172,Sant Joan Despí,-84,2005,1711,1795
694,171851,Sant Joan les Fonts,44,2005,151,107
695,171668,Sant Jordi Desvalls,7,2005,36,29
696,089030,Sant Julià de Cerdanyola,1,2005,13,12
697,171693,Sant Julià de Ramis,136,2005,271,135
698,082205,Sant Julià de Vilatorta,67,2005,141,74
699,179032,Sant Julià del Llor i Bonmatí,66,2005,117,51
700,082212,Sant Just Desvern,-10,2005,786,796
701,082227,Sant Llorenç d'Hortons,91,2005,198,107
702,171714,Sant Llorenç de la Muga,-3,2005,11,14
703,251930,Sant Llorenç de Morunys,3,2005,48,45
704,082233,Sant Llorenç Savall,61,2005,164,103
705,082251,Sant Martí d'Albars,-1,2005,2,3
706,082248,Sant Martí de Centelles,17,2005,99,82
707,171729,Sant Martí de Llémena,-4,2005,17,21
708,259025,Sant Martí de Riucorb,4,2005,26,22
709,082264,Sant Martí de Tous,13,2005,46,33
710,082270,Sant Martí Sarroca,123,2005,266,143
711,082286,Sant Martí Sesgueioles,23,2005,37,14
712,171735,Sant Martí Vell,19,2005,29,10
713,082299,Sant Mateu de Bages,-3,2005,19,22
714,171740,Sant Miquel de Campmajor,3,2005,22,19
715,171753,Sant Miquel de Fluvià,7,2005,42,35
716,171766,Sant Mori,-1,2005,6,7
717,171772,Sant Pau de Segúries,1,2005,30,29
718,082310,Sant Pere de Ribes,915,2005,2444,1529
719,082325,Sant Pere de Riudebitlles,59,2005,152,93
720,082331,Sant Pere de Torelló,18,2005,109,91
721,082346,Sant Pere de Vilamajor,108,2005,352,244
722,171788,Sant Pere Pescador,101,2005,230,129
723,081897,Sant Pere Sallavinera,8,2005,10,2
724,082359,Sant Pol de Mar,179,2005,460,281
725,082362,Sant Quintí de Mediona,36,2005,176,140
726,082378,Sant Quirze de Besora,71,2005,122,51
727,082384,Sant Quirze del Vallès,404,2005,1129,725
728,082397,Sant Quirze Safaja,33,2005,77,44
729,251945,Sant Ramon,8,2005,26,18
730,082401,Sant Sadurní d'Anoia,237,2005,727,490
731,082418,Sant Sadurní d'Osormort,7,2005,9,2
732,080983,Sant Salvador de Guardiola,100,2005,293,193
733,082628,Sant Vicenç de Castellet,221,2005,604,383
734,082649,Sant Vicenç de Montalt,212,2005,523,311
735,082652,Sant Vicenç de Torelló,-12,2005,83,95
736,082634,Sant Vicenç dels Horts,190,2005,1500,1310
737,431384,Santa Bàrbara,112,2005,235,123
738,082439,Santa Cecília de Voltregà,-8,2005,4,12
739,082444,Santa Coloma de Cervelló,252,2005,642,390
740,171805,Santa Coloma de Farners,279,2005,712,433
741,082457,Santa Coloma de Gramenet,298,2005,9328,9030
742,431397,Santa Coloma de Queralt,38,2005,157,119
743,171812,Santa Cristina d'Aro,209,2005,468,259
744,082460,Santa Eugènia de Berga,127,2005,214,87
745,082476,Santa Eulàlia de Riuprimer,39,2005,63,24
746,082482,Santa Eulàlia de Ronçana,252,2005,608,356
747,082495,Santa Fe del Penedès,9,2005,31,22
748,171827,Santa Llogaia d'Àlguema,2,2005,24,22
749,082508,Santa Margarida de Montbui,191,2005,727,536
750,082515,Santa Margarida i els Monjos,227,2005,586,359
751,082589,Santa Maria d'Oló,29,2005,73,44
752,082536,Santa Maria de Besora,-2,2005,7,9
753,082567,Santa Maria de Martorelles,21,2005,71,50
754,082554,Santa Maria de Merlès,-4,2005,10,14
755,082573,Santa Maria de Miralles,9,2005,17,8
756,082592,Santa Maria de Palautordera,279,2005,735,456
757,431401,Santa Oliva,211,2005,399,188
758,171848,Santa Pau,33,2005,85,52
759,082606,Santa Perpètua de Mogoda,101,2005,1482,1381
760,082613,Santa Susanna,67,2005,335,268
761,081923,Santpedor,213,2005,401,188
762,431423,Sarral,77,2005,130,53
763,171864,Sarrià de Ter,2,2005,275,273
764,252017,Sarroca de Bellera,0,2005,6,6
765,252000,Sarroca de Lleida,7,2005,19,12
766,171870,"Saus, Camallera i Llampaies",14,2005,58,44
767,431439,Savallà del Comtat,0,2005,2,2
768,431444,"Secuita, la",35,2005,91,56
769,171886,"Selva de Mar, la",7,2005,15,8
770,431457,"Selva del Camp, la",128,2005,297,169
771,431460,Senan,5,2005,6,1
772,430445,"Sénia, la",130,2005,420,290
773,252022,Senterada,4,2005,9,5
774,250352,"Sentiu de Sió, la",-2,2005,22,24
775,082671,Sentmenat,182,2005,491,309
776,171903,Serinyà,46,2005,92,46
777,252043,Seròs,11,2005,89,78
778,171910,Serra de Daró,11,2005,16,5
779,171925,Setcases,1,2005,12,11
780,252038,"Seu d'Urgell, la",241,2005,906,665
781,082690,Seva,143,2005,269,126
782,252056,Sidamon,-21,2005,13,34
783,171931,Sils,200,2005,406,206
784,082704,Sitges,761,2005,2241,1480
785,170524,Siurana,5,2005,21,16
786,082711,Sobremunt,10,2005,16,6
787,252069,"Soleràs, el",-3,2005,17,20
788,431476,Solivella,6,2005,25,19
789,252075,Solsona,263,2005,606,343
790,082726,Sora,-11,2005,11,22
791,252081,Soriguera,-1,2005,31,32
792,252094,Sort,116,2005,237,121
793,252108,Soses,9,2005,109,100
794,082732,Subirats,134,2005,228,94
795,252115,Sudanell,27,2005,54,27
796,252120,Sunyer,4,2005,15,11
797,082747,Súria,107,2005,265,158
798,171946,Susqueda,-2,2005,4,6
799,082763,Tagamanent,17,2005,43,26
800,082779,Talamanca,18,2005,26,8
801,252154,Talarn,5,2005,19,14
802,252167,Talavera,-5,2005,9,14
803,171959,"Tallada d'Empordà, la",23,2005,41,18
804,082785,Taradell,63,2005,241,178
805,431482,Tarragona,3720,2005,8611,4891
806,252173,Tàrrega,463,2005,1246,783
807,252189,Tarrés,-5,2005,0,5
808,252192,Tarroja de Segarra,6,2005,14,8
809,082750,Tavèrnoles,0,2005,11,11
810,082802,Tavertet,8,2005,24,16
811,082819,Teià,0,2005,308,308
812,252206,Térmens,27,2005,99,72
813,171962,Terrades,-4,2005,0,4
814,082798,Terrassa,3226,2005,9807,6581
815,082824,Tiana,191,2005,491,300
816,252213,Tírvia,-6,2005,2,8
817,252228,Tiurana,2,2005,3,1
818,431495,Tivenys,13,2005,36,23
819,431508,Tivissa,19,2005,66,47
820,082830,Tona,276,2005,559,283
821,252234,Torà,44,2005,96,52
822,082845,Tordera,755,2005,1435,680
823,082858,Torelló,218,2005,671,453
824,252249,"Torms, els",0,2005,4,4
825,252252,Tornabous,2,2005,50,48
826,252271,"Torre de Cabdella, la",-1,2005,24,25
827,082861,"Torre de Claramunt, la",205,2005,398,193
828,431515,"Torre de Fontaubella, la",1,2005,9,8
829,431520,"Torre de l'Espanyol, la",-12,2005,41,53
830,252265,Torrebesses,5,2005,10,5
831,431536,Torredembarra,457,2005,1303,846
832,252287,Torrefarrera,308,2005,413,105
833,259078,Torrefeta i Florejacs,16,2005,40,24
834,252304,Torregrossa,19,2005,83,64
835,252311,Torrelameu,18,2005,52,34
836,082877,Torrelavit,23,2005,90,67
837,082883,Torrelles de Foix,86,2005,276,190
838,082896,Torrelles de Llobregat,225,2005,452,227
839,171978,Torrent,-6,2005,16,22
840,252326,Torres de Segre,43,2005,155,112
841,252332,Torre-serona,-15,2005,0,15
842,171984,Torroella de Fluvià,37,2005,83,46
843,171997,Torroella de Montgrí,261,2005,778,517
844,431541,Torroja del Priorat,-6,2005,2,8
845,172001,Tortellà,20,2005,44,24
846,431554,Tortosa,1252,2005,2907,1655
847,172018,Toses,1,2005,21,20
848,172023,Tossa de Mar,205,2005,489,284
849,252347,Tremp,-167,2005,80,247
850,172044,Ullà,65,2005,165,100
851,082900,Ullastrell,73,2005,142,69
852,172057,Ullastret,4,2005,13,9
853,431567,Ulldecona,109,2005,411,302
854,431573,Ulldemolins,20,2005,35,15
855,172039,Ultramort,-4,2005,9,13
856,172060,Urús,-2,2005,8,10
857,082917,Vacarisses,377,2005,665,288
858,170144,"Vajol, la",6,2005,9,3
859,172076,"Vall d'en Bas, la",44,2005,117,73
860,172082,"Vall de Bianya, la",12,2005,70,58
861,250432,"Vall de Boí, la",18,2005,92,74
862,259010,Vall de Cardós,24,2005,44,20
863,082922,Vallbona d'Anoia,74,2005,115,41
864,252385,Vallbona de les Monges,-5,2005,11,16
865,082938,Vallcebre,-3,2005,14,17
866,431589,Vallclara,-7,2005,11,18
867,252402,Vallfogona de Balaguer,18,2005,85,67
868,171707,Vallfogona de Ripollès,-10,2005,3,13
869,431592,Vallfogona de Riucorb,-5,2005,16,21
870,082943,Vallgorguina,125,2005,262,137
871,082956,Vallirana,440,2005,1109,669
872,172095,Vall-llobrega,58,2005,83,25
873,431606,Vallmoll,60,2005,133,73
874,082969,Vallromanes,154,2005,242,88
875,431613,Valls,772,2005,1539,767
876,259062,"Valls d'Aguilar, les",6,2005,21,15
877,252398,"Valls de Valira, les",-47,2005,7,54
878,431628,Vandellòs i l'Hospitalet de l'Infant,155,2005,415,260
879,259097,"Vansa i Fórnols, la",7,2005,13,6
880,082975,Veciana,5,2005,13,8
881,431634,"Vendrell, el",1350,2005,3260,1910
882,172109,Ventalló,17,2005,59,42
883,252424,Verdú,-19,2005,33,52
884,172116,Verges,-4,2005,52,56
885,431649,Vespella de Gaià,45,2005,68,23
886,082981,Vic,786,2005,2726,1940
887,172121,Vidrà,-6,2005,6,12
888,172137,Vidreres,431,2005,835,404
889,252430,Vielha e Mijaran,172,2005,595,423
890,431652,Vilabella,4,2005,32,28
891,172142,Vilabertran,22,2005,55,33
892,172155,Vilablareix,26,2005,124,98
893,082994,Vilada,13,2005,34,21
894,172174,Viladamat,3,2005,38,35
895,172168,Viladasens,3,2005,13,10
896,083015,Viladecans,218,2005,3497,3279
897,083008,Viladecavalls,129,2005,481,352
898,172180,Vilademuls,7,2005,65,58
899,172207,Viladrau,16,2005,68,52
900,172214,Vilafant,177,2005,367,190
901,083054,Vilafranca del Penedès,606,2005,2571,1965
902,252445,Vilagrassa,1,2005,14,13
903,172235,Vilajuïga,17,2005,88,71
904,431750,Vilalba dels Arcs,-2,2005,6,8
905,083067,Vilalba Sasserra,9,2005,54,45
906,252458,Vilaller,38,2005,69,31
907,172240,Vilallonga de Ter,13,2005,24,11
908,431665,Vilallonga del Camp,110,2005,168,58
909,172253,Vilamacolum,2,2005,24,22
910,172266,Vilamalla,-25,2005,17,42
911,172272,Vilamaniscle,19,2005,27,8
912,252477,Vilamòs,2,2005,22,20
913,172288,Vilanant,7,2005,26,19
914,431671,Vilanova d'Escornalbou,4,2005,30,26
915,252483,Vilanova de Bellpuig,-1,2005,30,31
916,252496,Vilanova de l'Aguda,-7,2005,2,9
917,252542,Vilanova de la Barca,52,2005,147,95
918,252509,Vilanova de Meià,-3,2005,19,22
919,431687,Vilanova de Prades,-1,2005,7,8
920,083036,Vilanova de Sau,-5,2005,17,22
921,252516,Vilanova de Segrià,7,2005,56,49
922,083020,Vilanova del Camí,292,2005,823,531
923,089024,Vilanova del Vallès,450,2005,608,158
924,083073,Vilanova i la Geltrú,1120,2005,3986,2866
925,431690,Vilaplana,20,2005,40,20
926,431704,Vila-rodona,15,2005,78,63
927,172305,Vila-sacra,-29,2005,24,53
928,252521,Vila-sana,37,2005,62,25
929,431711,Vila-seca,1256,2005,2134,878
930,082140,Vilassar de Dalt,34,2005,436,402
931,082191,Vilassar de Mar,-23,2005,1116,1139
932,172229,Vilaür,1,2005,14,13
933,431726,Vilaverd,9,2005,42,33
934,431732,"Vilella Alta, la",-4,2005,0,4
935,431747,"Vilella Baixa, la",8,2005,18,10
936,172333,Vilobí d'Onyar,30,2005,194,164
937,083041,Vilobí del Penedès,23,2005,68,45
938,172327,Vilopriu,-12,2005,8,20
939,252537,"Vilosell, el",-11,2005,8,19
940,431763,Vimbodí i Poblet,12,2005,44,32
941,252555,Vinaixa,-6,2005,38,44
942,431779,Vinebre,23,2005,46,23
943,431785,Vinyols i els Arcs,58,2005,175,117
944,083089,Viver i Serrateix,0,2005,8,8
945,430521,Xerta,0,2005,51,51
0,250019,Abella de la Conca,3,2006,9,6
1,080018,Abrera,507,2006,1087,580
2,250024,Àger,21,2006,45,24
3,250030,Agramunt,64,2006,353,289
4,080023,Aguilar de Segarra,5,2006,16,11
5,170010,Agullana,-6,2006,58,64
6,080142,Aiguafreda,36,2006,180,144
7,430017,Aiguamúrcia,39,2006,83,44
8,170025,Aiguaviva,13,2006,45,32
9,250387,Aitona,54,2006,208,154
10,250045,"Alamús, els",18,2006,52,34
11,250058,Alàs i Cerc,-7,2006,10,17
12,250061,"Albagés, l'",-6,2006,16,22
13,170031,Albanyà,1,2006,11,10
14,250077,Albatàrrec,126,2006,211,85
15,250083,Albesa,2,2006,68,66
16,250096,"Albi, l'",24,2006,55,31
17,430022,Albinyana,72,2006,231,159
18,430038,"Albiol, l'",26,2006,42,16
19,170046,Albons,21,2006,73,52
20,430043,Alcanar,428,2006,822,394
21,250100,Alcanó,-1,2006,4,5
22,250117,Alcarràs,543,2006,803,260
23,250122,Alcoletge,51,2006,199,148
24,430056,Alcover,195,2006,346,151
25,439044,"Aldea, l'",126,2006,285,159
26,430069,Aldover,65,2006,93,28
27,430075,"Aleixar, l'",57,2006,72,15
28,080039,Alella,119,2006,646,527
29,430081,Alfara de Carles,2,2006,17,15
30,250138,Alfarràs,-4,2006,189,193
31,250143,Alfés,7,2006,15,8
32,430094,Alforja,143,2006,208,65
33,250156,Algerri,-6,2006,17,23
34,250169,Alguaire,-1,2006,158,159
35,250175,Alins,15,2006,21,6
36,430108,Alió,-2,2006,19,21
37,250194,Almacelles,35,2006,282,247
38,250208,Almatret,-6,2006,8,14
39,250215,Almenar,43,2006,212,169
40,430115,Almoster,34,2006,79,45
41,250220,Alòs de Balaguer,-10,2006,8,18
42,170062,Alp,105,2006,229,124
43,080044,Alpens,-2,2006,10,12
44,250236,Alpicat,294,2006,559,265
45,250241,Alt Àneu,2,2006,22,20
46,430120,Altafulla,169,2006,384,215
47,170078,Amer,40,2006,117,77
48,430136,"Ametlla de Mar, l'",338,2006,611,273
49,080057,"Ametlla del Vallès, l'",106,2006,573,467
50,439060,"Ampolla, l'",66,2006,214,148
51,430141,Amposta,578,2006,1510,932
52,170084,Anglès,50,2006,322,272
53,250273,Anglesola,15,2006,74,59
54,250292,Arbeca,12,2006,133,121
55,430167,"Arboç, l'",217,2006,489,272
56,430154,Arbolí,11,2006,17,6
57,170097,Arbúcies,149,2006,443,294
58,080060,Arenys de Mar,235,2006,1057,822
59,080076,Arenys de Munt,132,2006,582,450
60,170101,Argelaguer,15,2006,27,12
61,080082,Argençola,19,2006,27,8
62,430173,"Argentera, l'",-15,2006,7,22
63,080095,Argentona,187,2006,730,543
64,170118,"Armentera, l'",8,2006,48,40
65,430189,Arnes,2,2006,18,16
66,250313,Arres,7,2006,9,2
67,250328,Arsèguel,-2,2006,3,5
68,080109,Artés,125,2006,349,224
69,250334,Artesa de Lleida,32,2006,82,50
70,250349,Artesa de Segre,109,2006,302,193
71,430192,Ascó,25,2006,92,67
72,250365,Aspa,0,2006,7,7
73,250371,"Avellanes i Santa Linya, les",13,2006,32,19
74,080116,Avià,57,2006,153,96
75,080121,Avinyó,71,2006,136,65
76,170123,Avinyonet de Puigventós,96,2006,187,91
77,080137,Avinyonet del Penedès,13,2006,99,86
78,080155,Badalona,-2868,2006,15959,18827
79,089045,Badia del Vallès,-106,2006,867,973
80,080168,Bagà,86,2006,161,75
81,250390,Baix Pallars,9,2006,31,22
82,250404,Balaguer,172,2006,1199,1027
83,080174,Balenyà,125,2006,299,174
84,080180,Balsareny,92,2006,198,106
85,430206,Banyeres del Penedès,144,2006,311,167
86,170157,Banyoles,272,2006,983,711
87,250411,Barbens,4,2006,59,55
88,430213,Barberà de la Conca,16,2006,61,45
89,082520,Barberà del Vallès,449,2006,2097,1648
90,080193,Barcelona,11953,2006,105266,93313
91,250426,"Baronia de Rialb, la",4,2006,15,11
92,170160,Bàscara,25,2006,64,39
93,250447,Bassella,0,2006,10,10
94,430228,Batea,5,2006,77,72
95,250450,Bausen,10,2006,10,0
96,080207,Begues,160,2006,427,267
97,170139,Begur,73,2006,320,247
98,250463,Belianes,-4,2006,28,32
99,251706,Bellaguarda,2,2006,18,16
100,170182,Bellcaire d'Empordà,-2,2006,49,51
101,250479,Bellcaire d'Urgell,2,2006,53,51
102,250485,Bell-lloc d'Urgell,61,2006,158,97
103,250498,Bellmunt d'Urgell,-4,2006,6,10
104,430234,Bellmunt del Priorat,16,2006,25,9
105,080214,Bellprat,-3,2006,5,8
106,250501,Bellpuig,148,2006,329,181
107,430249,Bellvei,115,2006,245,130
108,250518,Bellver de Cerdanya,57,2006,189,132
109,250523,Bellvís,156,2006,250,94
110,250539,Benavent de Segrià,121,2006,181,60
111,430252,Benifallet,-24,2006,0,24
112,430265,Benissanet,48,2006,115,67
113,080229,Berga,334,2006,1040,706
114,170195,Besalú,27,2006,126,99
115,170209,Bescanó,230,2006,377,147
116,170216,Beuda,-9,2006,18,27
117,080235,Bigues i Riells del Fai,198,2006,647,449
118,250557,Biosca,-3,2006,11,14
119,170221,"Bisbal d'Empordà, la",326,2006,761,435
120,430271,"Bisbal de Falset, la",-18,2006,5,23
121,430287,"Bisbal del Penedès, la",325,2006,506,181
122,172348,Biure,11,2006,15,4
123,430290,Blancafort,1,2006,24,23
124,170237,Blanes,1177,2006,3366,2189
125,170293,Boadella i les Escaules,-4,2006,6,10
126,170242,Bolvir,33,2006,59,26
127,430304,Bonastre,61,2006,91,30
128,250576,"Bòrdes, Es",-6,2006,16,22
129,170255,Bordils,81,2006,191,110
130,250582,"Borges Blanques, les",195,2006,394,199
131,430311,"Borges del Camp, les",57,2006,154,97
132,170268,Borrassà,17,2006,47,30
133,080240,Borredà,38,2006,71,33
134,250595,Bossòst,36,2006,135,99
135,430326,Bot,-1,2006,15,16
136,430332,Botarell,23,2006,100,77
137,250560,Bovera,-4,2006,12,16
138,430347,Bràfim,26,2006,65,39
139,170274,Breda,38,2006,194,156
140,080253,"Bruc, el",90,2006,204,114
141,080266,"Brull, el",7,2006,14,7
142,170280,Brunyola i Sant Martí Sapresa,8,2006,27,19
143,430350,Cabacés,0,2006,12,12
144,250609,Cabanabona,-10,2006,0,10
145,170314,Cabanelles,-3,2006,19,22
146,170307,Cabanes,0,2006,72,72
147,080272,"Cabanyes, les",39,2006,78,39
148,250616,Cabó,0,2006,1,1
149,430363,Cabra del Camp,67,2006,153,86
150,080288,Cabrera d'Anoia,123,2006,223,100
151,080291,Cabrera de Mar,99,2006,323,224
152,080305,Cabrils,164,2006,565,401
153,170329,Cadaqués,104,2006,253,149
154,080312,Calaf,127,2006,303,176
155,430379,Calafell,1500,2006,3292,1792
156,080348,Calders,37,2006,74,37
157,080327,Caldes d'Estrac,116,2006,351,235
158,170335,Caldes de Malavella,390,2006,682,292
159,080333,Caldes de Montbui,315,2006,1080,765
160,080351,Calella,701,2006,2014,1313
161,080370,Calldetenes,49,2006,172,123
162,080386,Callús,42,2006,110,68
163,080364,Calonge de Segarra,1,2006,6,5
164,170340,Calonge i Sant Antoni,523,2006,1179,656
165,250621,Camarasa,12,2006,45,33
166,439039,Camarles,121,2006,244,123
167,430385,Cambrils,1449,2006,3196,1747
168,170353,Camós,12,2006,34,22
169,170366,Campdevànol,47,2006,165,118
170,170372,Campelles,3,2006,3,0
171,080399,Campins,17,2006,38,21
172,170388,Campllong,15,2006,38,23
173,170391,Camprodon,110,2006,249,139
174,250637,Canejan,0,2006,3,3
175,170405,Canet d'Adri,38,2006,58,20
176,080403,Canet de Mar,510,2006,1051,541
177,080410,Canovelles,456,2006,1633,1177
178,080425,Cànoves i Samalús,142,2006,271,129
179,170412,Cantallops,18,2006,36,18
180,080431,Canyelles,325,2006,559,234
181,430398,Capafonts,8,2006,13,5
182,430402,Capçanes,-7,2006,10,17
183,080446,Capellades,2,2006,287,285
184,170427,Capmany,21,2006,43,22
185,080459,Capolat,8,2006,12,4
186,080462,Cardedeu,189,2006,976,787
187,080478,Cardona,6,2006,141,135
188,080484,Carme,50,2006,81,31
189,430419,Caseres,0,2006,7,7
190,170448,Cassà de la Selva,166,2006,548,382
191,080497,Casserres,15,2006,98,83
192,080575,Castell de l'Areny,5,2006,8,3
193,259046,Castell de Mur,11,2006,17,6
194,250642,Castellar de la Ribera,1,2006,9,8
195,080522,Castellar de n'Hug,25,2006,48,23
196,080500,Castellar del Riu,-4,2006,8,12
197,080517,Castellar del Vallès,485,2006,1532,1047
198,080538,Castellbell i el Vilar,124,2006,330,206
199,080543,Castellbisbal,191,2006,777,586
200,080556,Castellcir,10,2006,52,42
201,250674,Castelldans,25,2006,66,41
202,080569,Castelldefels,1071,2006,5445,4374
203,080581,Castellet i la Gornal,126,2006,250,124
204,170464,Castellfollit de la Roca,7,2006,80,73
205,080608,Castellfollit de Riubregós,-4,2006,11,15
206,080594,Castellfollit del Boix,11,2006,24,13
207,080615,Castellgalí,176,2006,246,70
208,080620,Castellnou de Bages,71,2006,127,56
209,250680,Castellnou de Seana,2,2006,40,38
210,170470,Castelló d'Empúries,975,2006,1685,710
211,250693,Castelló de Farfanya,20,2006,49,29
212,080636,Castellolí,3,2006,21,18
213,170486,Castell-Platja d'Aro,373,2006,1327,954
214,250707,Castellserà,8,2006,54,46
215,080641,Castellterçol,65,2006,162,97
216,430424,Castellvell del Camp,53,2006,135,82
217,080654,Castellví de la Marca,16,2006,109,93
218,080667,Castellví de Rosanes,68,2006,144,76
219,430430,"Catllar, el",231,2006,436,205
220,250714,Cava,0,2006,1,1
221,171899,"Cellera de Ter, la",33,2006,125,92
222,170499,Celrà,198,2006,408,210
223,080673,Centelles,225,2006,451,226
224,082687,Cercs,10,2006,84,74
225,082665,Cerdanyola del Vallès,373,2006,3602,3229
226,080689,Cervelló,264,2006,692,428
227,250729,Cervera,30,2006,770,740
228,250735,Cervià de les Garrigues,1,2006,40,39
229,170502,Cervià de Ter,17,2006,67,50
230,170519,Cistella,3,2006,20,17
231,250740,Ciutadilla,-2,2006,10,12
232,250753,Clariana de Cardener,-1,2006,5,6
233,250766,"Cogul, el",2,2006,6,4
234,170545,Colera,-10,2006,39,49
235,250772,Coll de Nargó,17,2006,49,32
236,080692,Collbató,188,2006,377,189
237,430458,Colldejou,-1,2006,8,9
238,080706,Collsuspina,9,2006,21,12
239,170558,Colomers,-4,2006,6,10
240,251636,"Coma i la Pedra, la",5,2006,18,13
241,251615,Conca de Dalt,7,2006,36,29
242,430461,Conesa,0,2006,19,19
243,430477,Constantí,338,2006,686,348
244,080713,Copons,21,2006,32,11
245,430483,Corbera d'Ebre,30,2006,68,38
246,080728,Corbera de Llobregat,434,2006,1288,854
247,250788,Corbins,30,2006,100,70
248,170577,Corçà,-1,2006,75,76
249,080734,Cornellà de Llobregat,540,2006,5540,5000
250,170561,Cornellà del Terri,28,2006,100,72
251,430496,Cornudella de Montsant,36,2006,86,50
252,430509,Creixell,222,2006,412,190
253,170583,Crespià,5,2006,17,12
254,179011,"Cruïlles, Monells i Sant Sadurní de l'Heura",43,2006,112,69
255,080749,Cubelles,966,2006,1960,994
256,250791,Cubells,-5,2006,16,21
257,430516,Cunit,1095,2006,2083,988
258,170600,Darnius,0,2006,39,39
259,170617,Das,10,2006,25,15
260,439018,Deltebre,-23,2006,668,691
261,080752,Dosrius,168,2006,489,321
262,430537,Duesaigües,23,2006,28,5
263,170622,"Escala, l'",474,2006,889,415
264,080765,Esparreguera,135,2006,1269,1134
265,170638,Espinelves,-13,2006,8,21
266,250812,"Espluga Calba, l'",0,2006,28,28
267,430542,"Espluga de Francolí, l'",70,2006,246,176
268,080771,Esplugues de Llobregat,25,2006,3386,3361
269,170643,Espolla,21,2006,36,15
270,170656,Esponellà,7,2006,24,17
271,250827,Espot,4,2006,26,22
272,080787,"Espunyola, l'",-12,2006,7,19
273,082541,"Esquirol, l'",24,2006,97,73
274,250886,Estamariu,4,2006,6,2
275,080790,"Estany, l'",-4,2006,11,15
276,250851,Estaràs,-2,2006,10,12
277,250864,Esterri d'Àneu,18,2006,103,85
278,250870,Esterri de Cardós,0,2006,2,2
279,430555,Falset,29,2006,158,129
280,170059,"Far d'Empordà, el",21,2006,39,18
281,250899,Farrera,0,2006,9,9
282,430568,"Fatarella, la",7,2006,34,27
283,430574,"Febró, la",-1,2006,5,6
284,081347,Figaró-Montmany,37,2006,112,75
285,080804,Fígols,8,2006,8,0
286,259084,Fígols i Alinyà,14,2006,22,8
287,430580,"Figuera, la",1,2006,13,12
288,170669,Figueres,1425,2006,3798,2373
289,430593,Figuerola del Camp,-2,2006,20,22
290,170675,Flaçà,14,2006,84,70
291,430607,Flix,58,2006,184,126
292,250925,"Floresta, la",2,2006,14,12
293,080826,Fogars de la Selva,100,2006,194,94
294,080811,Fogars de Montclús,11,2006,48,37
295,170681,Foixà,1,2006,12,11
296,080832,Folgueroles,76,2006,124,48
297,250931,Fondarella,0,2006,42,42
298,080847,Fonollosa,7,2006,92,85
299,170694,Fontanals de Cerdanya,26,2006,41,15
300,170708,Fontanilles,-10,2006,10,20
301,170715,Fontcoberta,30,2006,77,47
302,080850,Font-rubí,45,2006,117,72
303,250946,Foradada,-3,2006,9,12
304,179026,Forallac,5,2006,85,80
305,430614,Forès,-3,2006,2,5
306,170736,Fornells de la Selva,56,2006,113,57
307,170741,Fortià,15,2006,43,28
308,080863,"Franqueses del Vallès, les",544,2006,1624,1080
309,430629,Freginals,17,2006,35,18
310,250962,"Fuliola, la",21,2006,72,51
311,250978,Fulleda,2,2006,6,4
312,080902,Gaià,1,2006,9,8
313,430635,"Galera, la",24,2006,67,43
314,080879,Gallifa,9,2006,32,23
315,430640,Gandesa,1,2006,173,172
316,430653,Garcia,25,2006,42,17
317,430666,"Garidells, els",0,2006,13,13
318,080885,"Garriga, la",377,2006,948,571
319,170754,Garrigàs,11,2006,21,10
320,170767,Garrigoles,7,2006,15,8
321,170773,Garriguella,73,2006,96,23
322,080898,Gavà,65,2006,2795,2730
323,250984,Gavet de la Conca,-5,2006,14,19
324,080919,Gelida,172,2006,511,339
325,170789,Ger,-2,2006,45,47
326,259123,Gimenells i el Pla de la Font,10,2006,47,37
327,430672,Ginestar,113,2006,162,49
328,170792,Girona,2507,2006,8602,6095
329,080924,Gironella,32,2006,177,145
330,080930,Gisclareny,1,2006,1,0
331,430688,Godall,46,2006,86,40
332,250997,Golmés,37,2006,138,101
333,170806,Gombrèn,8,2006,21,13
334,251001,Gósol,1,2006,23,22
335,080945,"Granada, la",95,2006,145,50
336,251018,"Granadella, la",-9,2006,29,38
337,080958,Granera,1,2006,4,3
338,251023,"Granja d'Escarp, la",3,2006,56,53
339,080961,Granollers,649,2006,4908,4259
340,251039,Granyanella,8,2006,16,8
341,251057,Granyena de les Garrigues,-11,2006,4,15
342,251044,Granyena de Segarra,1,2006,3,2
343,430691,Gratallops,12,2006,24,12
344,080977,Gualba,16,2006,146,130
345,170813,Gualta,-17,2006,38,55
346,080996,Guardiola de Berguedà,22,2006,67,45
347,430705,"Guiamets, els",7,2006,19,12
348,170828,Guils de Cerdanya,15,2006,49,34
349,251095,Guimerà,5,2006,25,20
350,259031,"Guingueta d'Àneu, la",8,2006,36,28
351,251109,Guissona,172,2006,598,426
352,251116,Guixers,12,2006,18,6
353,081000,Gurb,33,2006,137,104
354,430712,Horta de Sant Joan,17,2006,49,32
355,081017,"Hospitalet de Llobregat, l'",3531,2006,23153,19622
356,081629,"Hostalets de Pierola, els",170,2006,313,143
357,170834,Hostalric,152,2006,380,228
358,081022,Igualada,454,2006,2394,1940
359,251155,Isona i Conca Dellà,4,2006,68,64
360,170849,Isòvol,15,2006,40,25
361,251137,Ivars d'Urgell,-29,2006,94,123
362,251121,Ivars de Noguera,-7,2006,15,22
363,251142,Ivorra,4,2006,8,4
364,170852,Jafre,20,2006,45,25
365,170865,"Jonquera, la",65,2006,347,282
366,081038,Jorba,38,2006,69,31
367,259101,Josa i Tuixén,0,2006,12,12
368,170871,Juià,-21,2006,31,52
369,251180,Juncosa,-9,2006,19,28
370,251193,Juneda,54,2006,202,148
371,251214,Les,43,2006,114,71
372,251229,Linyola,79,2006,172,93
373,081043,"Llacuna, la",18,2006,72,54
374,170887,Lladó,13,2006,46,33
375,251235,Lladorre,1,2006,7,6
376,251240,Lladurs,-7,2006,5,12
377,081056,"Llagosta, la",-64,2006,907,971
378,170890,Llagostera,279,2006,583,304
379,170904,Llambilles,31,2006,52,21
380,170911,Llanars,15,2006,48,33
381,170926,Llançà,272,2006,489,217
382,251253,Llardecans,-7,2006,22,29
383,251266,Llavorsí,-12,2006,21,33
384,251207,Lleida,2908,2006,8825,5917
385,170932,Llers,-13,2006,62,75
386,251272,Lles de Cerdanya,-7,2006,0,7
387,081075,Lliçà d'Amunt,454,2006,1132,678
388,081081,Lliçà de Vall,48,2006,420,372
389,251288,Llimiana,0,2006,10,10
390,081069,Llinars del Vallès,143,2006,721,578
391,170947,Llívia,109,2006,187,78
392,430727,"Lloar, el",4,2006,8,4
393,251291,Llobera,3,2006,7,4
394,430733,Llorac,0,2006,8,8
395,430748,Llorenç del Penedès,23,2006,117,94
396,170950,Lloret de Mar,3015,2006,5079,2064
397,170963,"Llosses, les",-2,2006,16,18
398,081094,Lluçà,0,2006,14,14
399,171024,Maçanet de Cabrenys,1,2006,53,52
400,171030,Maçanet de la Selva,515,2006,900,385
401,170979,Madremanya,-6,2006,11,17
402,170985,Maià de Montcal,3,2006,34,31
403,251333,Maials,-4,2006,33,37
404,251305,Maldà,-7,2006,17,24
405,081108,Malgrat de Mar,519,2006,1522,1003
406,081115,Malla,11,2006,19,8
407,081120,Manlleu,320,2006,1204,884
408,081136,Manresa,1410,2006,4711,3301
409,430764,Marçà,22,2006,48,26
410,430751,Margalef,-5,2006,2,7
411,082423,Marganell,9,2006,25,16
412,081141,Martorell,321,2006,2030,1709
413,081154,Martorelles,-24,2006,298,322
414,430770,Mas de Barberans,1,2006,25,24
415,171002,Masarac,5,2006,21,16
416,430786,Masdenverge,68,2006,119,51
417,081167,"Masies de Roda, les",28,2006,46,18
418,081173,"Masies de Voltregà, les",32,2006,172,140
419,430799,Masllorenç,0,2006,35,35
420,081189,"Masnou, el",165,2006,1364,1199
421,430803,"Masó, la",10,2006,17,7
422,430810,Maspujols,17,2006,29,12
423,081192,Masquefa,269,2006,698,429
424,430825,"Masroig, el",-13,2006,26,39
425,251312,Massalcoreig,1,2006,38,37
426,171019,Massanes,38,2006,97,59
427,251327,Massoteres,2,2006,28,26
428,081206,Matadepera,65,2006,426,361
429,081213,Mataró,1339,2006,7070,5731
430,081228,Mediona,186,2006,343,157
431,251348,Menàrguens,-15,2006,23,38
432,170998,Meranges,3,2006,5,2
433,171058,Mieres,-11,2006,26,37
434,430831,"Milà, el",-2,2006,10,12
435,251351,Miralcamp,47,2006,118,71
436,430846,Miravet,16,2006,47,31
437,081385,Moià,92,2006,366,274
438,430859,"Molar, el",0,2006,12,12
439,081234,Molins de Rei,130,2006,1218,1088
440,251370,Mollerussa,619,2006,1547,928
441,171061,Mollet de Peralada,2,2006,11,9
442,081249,Mollet del Vallès,48,2006,3546,3498
443,171077,Molló,10,2006,15,5
444,251364,"Molsosa, la",1,2006,4,3
445,081287,Monistrol de Calders,14,2006,46,32
446,081271,Monistrol de Montserrat,100,2006,277,177
447,171096,Montagut i Oix,48,2006,95,47
448,430862,Montblanc,64,2006,406,342
449,430884,Montbrió del Camp,122,2006,221,99
450,081252,Montcada i Reixac,15,2006,2049,2034
451,081304,Montclar,1,2006,6,5
452,251399,Montellà i Martinet,4,2006,45,41
453,081311,Montesquiu,7,2006,78,71
454,251403,Montferrer i Castellbò,44,2006,111,67
455,430897,Montferri,58,2006,83,25
456,251386,Montgai,-15,2006,16,31
457,081265,Montgat,311,2006,835,524
458,081326,Montmajor,17,2006,30,13
459,081332,Montmaneu,-3,2006,11,14
460,430901,"Montmell, el",162,2006,284,122
461,081350,Montmeló,-40,2006,475,515
462,251425,Montoliu de Lleida,11,2006,42,31
463,251410,Montoliu de Segarra,-2,2006,18,20
464,251431,Montornès de Segarra,4,2006,14,10
465,081363,Montornès del Vallès,197,2006,1148,951
466,430918,Mont-ral,0,2006,11,11
467,171100,Mont-ras,23,2006,104,81
468,430923,Mont-roig del Camp,839,2006,1480,641
469,081379,Montseny,4,2006,18,14
470,430939,Móra d'Ebre,120,2006,324,204
471,430944,Móra la Nova,30,2006,198,168
472,430957,"Morell, el",147,2006,332,185
473,430960,"Morera de Montsant, la",-3,2006,13,16
474,081290,Muntanyola,48,2006,72,24
475,081398,Mura,-4,2006,12,16
476,251459,Nalec,-5,2006,1,6
477,250254,Naut Aran,7,2006,129,122
478,081402,Navarcles,57,2006,273,216
479,081419,Navàs,181,2006,372,191
480,171117,Navata,44,2006,80,36
481,251462,Navès,-10,2006,1,11
482,081424,"Nou de Berguedà, la",-11,2006,6,17
483,430976,"Nou de Gaià, la",15,2006,36,21
484,430982,Nulles,35,2006,59,24
485,251484,Odèn,9,2006,16,7
486,081430,Òdena,58,2006,242,184
487,171122,Ogassa,6,2006,16,10
488,081458,Olèrdola,186,2006,357,171
489,081461,Olesa de Bonesvalls,48,2006,141,93
490,081477,Olesa de Montserrat,-114,2006,993,1107
491,251497,Oliana,11,2006,121,110
492,251500,Oliola,13,2006,17,4
493,251517,Olius,61,2006,82,21
494,081483,Olivella,316,2006,509,193
495,081496,Olost,16,2006,40,24
496,171143,Olot,618,2006,1952,1334
497,251522,"Oluges, les",5,2006,8,3
498,081445,Olvan,-22,2006,24,46
499,251538,"Omellons, els",-2,2006,10,12
500,251543,"Omells de na Gaia, els",-12,2006,5,17
501,171156,Ordis,12,2006,20,8
502,251556,Organyà,3,2006,65,62
503,081509,Orís,3,2006,16,13
504,081516,Oristà,4,2006,17,13
505,081521,Orpí,-4,2006,6,10
506,081537,Òrrius,-17,2006,0,17
507,251569,Os de Balaguer,42,2006,72,30
508,171169,Osor,-18,2006,0,18
509,251575,Ossó de Sió,-1,2006,6,7
510,081542,Pacs del Penedès,37,2006,78,41
511,081555,Palafolls,421,2006,860,439
512,171175,Palafrugell,542,2006,1620,1078
513,171181,Palamós,442,2006,1420,978
514,251581,"Palau d'Anglesola, el",67,2006,129,62
515,171194,Palau de Santa Eulàlia,5,2006,11,6
516,171215,Palau-sator,-1,2006,13,14
517,171208,Palau-saverdera,87,2006,185,98
518,081568,Palau-solità i Plegamans,305,2006,1058,753
519,431009,"Pallaresos, els",151,2006,331,180
520,081574,Pallejà,264,2006,765,501
521,430995,"Palma d'Ebre, la",29,2006,33,4
522,089058,"Palma de Cervelló, la",42,2006,262,220
523,171236,Palol de Revardit,31,2006,44,13
524,171241,Pals,175,2006,311,136
525,081580,"Papiol, el",53,2006,225,172
526,171254,Pardines,15,2006,16,1
527,081593,Parets del Vallès,154,2006,1281,1127
528,171267,Parlavà,29,2006,46,17
529,431016,Passanant i Belltall,15,2006,26,11
530,171289,Pau,71,2006,121,50
531,431021,Paüls,8,2006,12,4
532,171292,Pedret i Marzà,20,2006,24,4
533,251641,Penelles,3,2006,33,30
534,171306,"Pera, la",-13,2006,23,36
535,081607,Perafita,17,2006,24,7
536,431037,Perafort,97,2006,136,39
537,171328,Peralada,68,2006,192,124
538,251654,Peramola,1,2006,28,27
539,431042,"Perelló, el",157,2006,251,94
540,081614,Piera,609,2006,1283,674
541,431055,"Piles, les",5,2006,11,6
542,081635,Pineda de Mar,301,2006,2044,1743
543,431068,"Pinell de Brai, el",15,2006,50,35
544,251667,Pinell de Solsonès,-1,2006,6,7
545,251673,Pinós,-6,2006,6,12
546,431074,Pira,13,2006,37,24
547,431080,"Pla de Santa Maria, el",45,2006,167,122
548,081640,"Pla del Penedès, el",-38,2006,50,88
549,171334,"Planes d'Hostoles, les",22,2006,69,47
550,171349,Planoles,-8,2006,18,26
551,259118,"Plans de Sió, els",5,2006,30,25
552,251689,"Poal, el",-5,2006,32,37
553,251692,"Pobla de Cérvoles, la",-2,2006,20,22
554,081653,"Pobla de Claramunt, la",107,2006,232,125
555,081666,"Pobla de Lillet, la",11,2006,64,53
556,431093,"Pobla de Mafumet, la",262,2006,320,58
557,431107,"Pobla de Massaluca, la",0,2006,22,22
558,431114,"Pobla de Montornès, la",210,2006,413,203
559,251713,"Pobla de Segur, la",63,2006,222,159
560,431129,Poboleda,6,2006,28,22
561,081672,Polinyà,261,2006,638,377
562,431135,"Pont d'Armentera, el",24,2006,53,29
563,250306,"Pont de Bar, el",1,2006,11,10
564,171352,Pont de Molins,25,2006,46,21
565,251734,"Pont de Suert, el",125,2006,243,118
566,081825,"Pont de Vilomara i Rocafort, el",197,2006,338,141
567,431418,Pontils,3,2006,24,21
568,081688,Pontons,64,2006,126,62
569,171365,Pontós,-14,2006,0,14
570,251728,Ponts,67,2006,214,147
571,171371,Porqueres,23,2006,239,216
572,431140,Porrera,-13,2006,8,21
573,171404,"Port de la Selva, el",44,2006,93,49
574,171387,Portbou,-30,2006,45,75
575,251749,"Portella, la",7,2006,93,86
576,431153,Pradell de la Teixeta,-4,2006,0,4
577,431166,Prades,36,2006,69,33
578,431172,Prat de Comte,-2,2006,12,14
579,081691,"Prat de Llobregat, el",-64,2006,2627,2691
580,431188,Pratdip,48,2006,87,39
581,081712,Prats de Lluçanès,0,2006,110,110
582,081705,"Prats de Rei, els",8,2006,31,23
583,251752,Prats i Sansor,-15,2006,12,27
584,251765,Preixana,-7,2006,15,22
585,251771,Preixens,9,2006,28,19
586,082303,Premià de Dalt,-14,2006,657,671
587,081727,Premià de Mar,25,2006,1771,1746
588,171390,"Preses, les",-2,2006,68,70
589,251790,Prullans,13,2006,29,16
590,171411,Puigcerdà,150,2006,688,538
591,081748,Puigdàlber,74,2006,85,11
592,251804,Puiggròs,10,2006,15,5
593,431191,Puigpelat,62,2006,119,57
594,081751,Puig-reig,91,2006,268,177
595,251811,Puigverd d'Agramunt,13,2006,33,20
596,251826,Puigverd de Lleida,60,2006,119,59
597,081764,Pujalt,-1,2006,7,8
598,081770,"Quar, la",1,2006,6,5
599,171426,Quart,-5,2006,136,141
600,170433,Queralbs,0,2006,6,6
601,431205,Querol,125,2006,165,40
602,171432,Rabós,-9,2006,6,15
603,081786,Rajadell,-4,2006,29,33
604,431212,Rasquera,21,2006,51,30
605,171447,Regencós,24,2006,41,17
606,081799,Rellinars,2,2006,62,60
607,431227,Renau,-2,2006,14,16
608,431233,Reus,2754,2006,7913,5159
609,251832,Rialp,15,2006,74,59
610,431248,"Riba, la",25,2006,50,25
611,431251,Riba-roja d'Ebre,-9,2006,57,66
612,259059,Ribera d'Ondara,-4,2006,22,26
613,251850,Ribera d'Urgellet,-16,2006,82,98
614,171450,Ribes de Freser,6,2006,92,86
615,171463,Riells i Viabrea,173,2006,437,264
616,431264,"Riera de Gaià, la",102,2006,153,51
617,251863,Riner,17,2006,26,9
618,171479,Ripoll,76,2006,508,432
619,081803,Ripollet,356,2006,2549,2193
620,259139,Riu de Cerdanya,15,2006,20,5
621,171485,Riudarenes,90,2006,234,144
622,171498,Riudaura,7,2006,28,21
623,431270,Riudecanyes,82,2006,122,40
624,431286,Riudecols,53,2006,95,42
625,171501,Riudellots de la Selva,45,2006,158,113
626,431299,Riudoms,200,2006,445,245
627,171518,Riumors,13,2006,20,7
628,081810,"Roca del Vallès, la",217,2006,760,543
629,431303,Rocafort de Queralt,6,2006,16,10
630,431310,Roda de Berà,389,2006,776,387
631,081831,Roda de Ter,131,2006,318,187
632,431325,Rodonyà,27,2006,70,43
633,431331,Roquetes,236,2006,603,367
634,171523,Roses,1125,2006,2006,881
635,251898,Rosselló,154,2006,303,149
636,431346,"Rourell, el",7,2006,32,25
637,081846,Rubí,822,2006,4458,3636
638,081859,Rubió,14,2006,17,3
639,171539,Rupià,10,2006,26,16
640,089019,Rupit i Pruit,-3,2006,9,12
641,081878,Sabadell,2141,2006,10744,8603
642,081884,Sagàs,-10,2006,2,12
643,251902,Salàs de Pallars,9,2006,31,22
644,081901,Saldes,12,2006,23,11
645,171544,Sales de Llierca,6,2006,15,9
646,081918,Sallent,-1,2006,253,254
647,431359,Salomó,15,2006,26,11
648,439057,Salou,2120,2006,4554,2434
649,171557,Salt,79,2006,3234,3155
650,251919,Sanaüja,6,2006,16,10
651,081944,Sant Adrià de Besòs,86,2006,2185,2099
652,081957,Sant Agustí de Lluçanès,-6,2006,3,9
653,081960,Sant Andreu de la Barca,254,2006,1886,1632
654,081976,Sant Andreu de Llavaneres,243,2006,815,572
655,171576,Sant Andreu Salou,4,2006,7,3
656,171833,Sant Aniol de Finestres,21,2006,33,12
657,081982,Sant Antoni de Vilamajor,222,2006,499,277
658,081995,Sant Bartomeu del Grau,-15,2006,36,51
659,082009,Sant Boi de Llobregat,-213,2006,3750,3963
660,082016,Sant Boi de Lluçanès,9,2006,35,26
661,431362,Sant Carles de la Ràpita,755,2006,1304,549
662,082037,Sant Cebrià de Vallalta,203,2006,422,219
663,082021,Sant Celoni,529,2006,1373,844
664,082042,Sant Climent de Llobregat,61,2006,248,187
665,171582,Sant Climent Sescebes,29,2006,72,43
666,082055,Sant Cugat del Vallès,1658,2006,5120,3462
667,082068,Sant Cugat Sesgarrigues,30,2006,68,38
668,251961,Sant Esteve de la Sarga,1,2006,8,7
669,082074,Sant Esteve de Palautordera,153,2006,279,126
670,082080,Sant Esteve Sesrovires,143,2006,495,352
671,171595,Sant Feliu de Buixalleu,22,2006,52,30
672,082107,Sant Feliu de Codines,203,2006,539,336
673,171609,Sant Feliu de Guíxols,394,2006,1550,1156
674,082114,Sant Feliu de Llobregat,-16,2006,2055,2071
675,171616,Sant Feliu de Pallerols,52,2006,104,52
676,082129,Sant Feliu Sasserra,11,2006,31,20
677,171621,Sant Ferriol,13,2006,26,13
678,082093,Sant Fost de Campsentelles,177,2006,603,426
679,082135,Sant Fruitós de Bages,182,2006,566,384
680,171637,Sant Gregori,48,2006,182,134
681,251924,Sant Guim de Freixenet,0,2006,80,80
682,251977,Sant Guim de la Plana,-10,2006,4,14
683,171642,Sant Hilari Sacalm,143,2006,287,144
684,082153,Sant Hipòlit de Voltregà,100,2006,225,125
685,081939,Sant Iscle de Vallalta,23,2006,103,80
686,439023,Sant Jaume d'Enveja,74,2006,185,111
687,082166,Sant Jaume de Frontanyà,-2,2006,0,2
688,171655,Sant Jaume de Llierca,-7,2006,52,59
689,431378,Sant Jaume dels Domenys,126,2006,256,130
690,171674,Sant Joan de les Abadesses,29,2006,134,105
691,171680,Sant Joan de Mollet,24,2006,41,17
692,082188,Sant Joan de Vilatorrada,26,2006,518,492
693,082172,Sant Joan Despí,152,2006,1875,1723
694,171851,Sant Joan les Fonts,42,2006,177,135
695,171668,Sant Jordi Desvalls,-7,2006,31,38
696,089030,Sant Julià de Cerdanyola,-6,2006,11,17
697,171693,Sant Julià de Ramis,206,2006,330,124
698,082205,Sant Julià de Vilatorta,55,2006,168,113
699,179032,Sant Julià del Llor i Bonmatí,90,2006,142,52
700,082212,Sant Just Desvern,141,2006,1021,880
701,082227,Sant Llorenç d'Hortons,86,2006,202,116
702,171714,Sant Llorenç de la Muga,1,2006,11,10
703,251930,Sant Llorenç de Morunys,58,2006,87,29
704,082233,Sant Llorenç Savall,54,2006,177,123
705,082251,Sant Martí d'Albars,-2,2006,3,5
706,082248,Sant Martí de Centelles,34,2006,89,55
707,171729,Sant Martí de Llémena,6,2006,37,31
708,259025,Sant Martí de Riucorb,2,2006,26,24
709,082264,Sant Martí de Tous,-1,2006,53,54
710,082270,Sant Martí Sarroca,185,2006,335,150
711,082286,Sant Martí Sesgueioles,21,2006,39,18
712,171735,Sant Martí Vell,11,2006,26,15
713,082299,Sant Mateu de Bages,12,2006,30,18
714,171740,Sant Miquel de Campmajor,-1,2006,11,12
715,171753,Sant Miquel de Fluvià,20,2006,69,49
716,171766,Sant Mori,0,2006,16,16
717,171772,Sant Pau de Segúries,16,2006,50,34
718,082310,Sant Pere de Ribes,672,2006,2305,1633
719,082325,Sant Pere de Riudebitlles,65,2006,165,100
720,082331,Sant Pere de Torelló,31,2006,124,93
721,082346,Sant Pere de Vilamajor,148,2006,368,220
722,171788,Sant Pere Pescador,57,2006,239,182
723,081897,Sant Pere Sallavinera,7,2006,13,6
724,082359,Sant Pol de Mar,133,2006,403,270
725,082362,Sant Quintí de Mediona,123,2006,242,119
726,082378,Sant Quirze de Besora,100,2006,160,60
727,082384,Sant Quirze del Vallès,574,2006,1389,815
728,082397,Sant Quirze Safaja,48,2006,105,57
729,251945,Sant Ramon,3,2006,23,20
730,082401,Sant Sadurní d'Anoia,258,2006,727,469
731,082418,Sant Sadurní d'Osormort,-6,2006,3,9
732,080983,Sant Salvador de Guardiola,84,2006,261,177
733,082628,Sant Vicenç de Castellet,333,2006,745,412
734,082649,Sant Vicenç de Montalt,145,2006,478,333
735,082652,Sant Vicenç de Torelló,54,2006,121,67
736,082634,Sant Vicenç dels Horts,87,2006,1456,1369
737,431384,Santa Bàrbara,99,2006,276,177
738,082439,Santa Cecília de Voltregà,-7,2006,6,13
739,082444,Santa Coloma de Cervelló,116,2006,519,403
740,171805,Santa Coloma de Farners,264,2006,734,470
741,082457,Santa Coloma de Gramenet,1158,2006,10471,9313
742,431397,Santa Coloma de Queralt,46,2006,203,157
743,171812,Santa Cristina d'Aro,273,2006,542,269
744,082460,Santa Eugènia de Berga,42,2006,212,170
745,082476,Santa Eulàlia de Riuprimer,27,2006,64,37
746,082482,Santa Eulàlia de Ronçana,292,2006,651,359
747,082495,Santa Fe del Penedès,14,2006,28,14
748,171827,Santa Llogaia d'Àlguema,-7,2006,22,29
749,082508,Santa Margarida de Montbui,116,2006,687,571
750,082515,Santa Margarida i els Monjos,255,2006,668,413
751,082589,Santa Maria d'Oló,23,2006,57,34
752,082536,Santa Maria de Besora,2,2006,5,3
753,082567,Santa Maria de Martorelles,12,2006,63,51
754,082554,Santa Maria de Merlès,-2,2006,8,10
755,082573,Santa Maria de Miralles,5,2006,16,11
756,082592,Santa Maria de Palautordera,253,2006,698,445
757,431401,Santa Oliva,105,2006,333,228
758,171848,Santa Pau,16,2006,62,46
759,082606,Santa Perpètua de Mogoda,378,2006,1835,1457
760,082613,Santa Susanna,114,2006,380,266
761,081923,Santpedor,246,2006,476,230
762,431423,Sarral,65,2006,153,88
763,171864,Sarrià de Ter,90,2006,326,236
764,252017,Sarroca de Bellera,-6,2006,3,9
765,252000,Sarroca de Lleida,-8,2006,9,17
766,171870,"Saus, Camallera i Llampaies",34,2006,69,35
767,431439,Savallà del Comtat,-2,2006,3,5
768,431444,"Secuita, la",79,2006,135,56
769,171886,"Selva de Mar, la",-6,2006,13,19
770,431457,"Selva del Camp, la",71,2006,254,183
771,431460,Senan,8,2006,8,0
772,430445,"Sénia, la",20,2006,404,384
773,252022,Senterada,13,2006,19,6
774,250352,"Sentiu de Sió, la",32,2006,49,17
775,082671,Sentmenat,181,2006,526,345
776,171903,Serinyà,34,2006,88,54
777,252043,Seròs,-2,2006,123,125
778,171910,Serra de Daró,9,2006,16,7
779,171925,Setcases,-3,2006,8,11
780,252038,"Seu d'Urgell, la",245,2006,965,720
781,082690,Seva,77,2006,231,154
782,252056,Sidamon,11,2006,45,34
783,171931,Sils,228,2006,419,191
784,082704,Sitges,1078,2006,2666,1588
785,170524,Siurana,21,2006,38,17
786,082711,Sobremunt,-4,2006,3,7
787,252069,"Soleràs, el",18,2006,32,14
788,431476,Solivella,19,2006,35,16
789,252075,Solsona,221,2006,546,325
790,082726,Sora,-10,2006,4,14
791,252081,Soriguera,4,2006,28,24
792,252094,Sort,61,2006,206,145
793,252108,Soses,51,2006,142,91
794,082732,Subirats,91,2006,198,107
795,252115,Sudanell,26,2006,43,17
796,252120,Sunyer,11,2006,17,6
797,082747,Súria,102,2006,313,211
798,171946,Susqueda,14,2006,19,5
799,082763,Tagamanent,16,2006,40,24
800,082779,Talamanca,8,2006,26,18
801,252154,Talarn,27,2006,55,28
802,252167,Talavera,6,2006,15,9
803,171959,"Tallada d'Empordà, la",28,2006,41,13
804,082785,Taradell,105,2006,297,192
805,431482,Tarragona,2788,2006,8864,6076
806,252173,Tàrrega,484,2006,1354,870
807,252189,Tarrés,-1,2006,3,4
808,252192,Tarroja de Segarra,-1,2006,8,9
809,082750,Tavèrnoles,11,2006,31,20
810,082802,Tavertet,-7,2006,11,18
811,082819,Teià,108,2006,389,281
812,252206,Térmens,-5,2006,111,116
813,171962,Terrades,54,2006,58,4
814,082798,Terrassa,2865,2006,10531,7666
815,082824,Tiana,70,2006,375,305
816,252213,Tírvia,5,2006,11,6
817,252228,Tiurana,8,2006,8,0
818,431495,Tivenys,11,2006,32,21
819,431508,Tivissa,39,2006,94,55
820,082830,Tona,230,2006,568,338
821,252234,Torà,25,2006,89,64
822,082845,Tordera,655,2006,1436,781
823,082858,Torelló,237,2006,749,512
824,252249,"Torms, els",-4,2006,5,9
825,252252,Tornabous,16,2006,59,43
826,252271,"Torre de Cabdella, la",75,2006,109,34
827,082861,"Torre de Claramunt, la",174,2006,387,213
828,431515,"Torre de Fontaubella, la",1,2006,13,12
829,431520,"Torre de l'Espanyol, la",-5,2006,50,55
830,252265,Torrebesses,6,2006,14,8
831,431536,Torredembarra,592,2006,1540,948
832,252287,Torrefarrera,285,2006,426,141
833,259078,Torrefeta i Florejacs,-8,2006,31,39
834,252304,Torregrossa,2,2006,98,96
835,252311,Torrelameu,14,2006,53,39
836,082877,Torrelavit,49,2006,98,49
837,082883,Torrelles de Foix,94,2006,283,189
838,082896,Torrelles de Llobregat,98,2006,372,274
839,171978,Torrent,0,2006,19,19
840,252326,Torres de Segre,-14,2006,135,149
841,252332,Torre-serona,-1,2006,30,31
842,171984,Torroella de Fluvià,102,2006,144,42
843,171997,Torroella de Montgrí,548,2006,1136,588
844,431541,Torroja del Priorat,3,2006,6,3
845,172001,Tortellà,23,2006,53,30
846,431554,Tortosa,1296,2006,3104,1808
847,172018,Toses,0,2006,10,10
848,172023,Tossa de Mar,212,2006,535,323
849,252347,Tremp,264,2006,510,246
850,172044,Ullà,-5,2006,160,165
851,082900,Ullastrell,135,2006,192,57
852,172057,Ullastret,-7,2006,12,19
853,431567,Ulldecona,244,2006,519,275
854,431573,Ulldemolins,-4,2006,20,24
855,172039,Ultramort,-5,2006,3,8
856,172060,Urús,0,2006,7,7
857,082917,Vacarisses,293,2006,618,325
858,170144,"Vajol, la",8,2006,12,4
859,172076,"Vall d'en Bas, la",35,2006,105,70
860,172082,"Vall de Bianya, la",43,2006,108,65
861,250432,"Vall de Boí, la",-9,2006,102,111
862,259010,Vall de Cardós,11,2006,54,43
863,082922,Vallbona d'Anoia,23,2006,88,65
864,252385,Vallbona de les Monges,9,2006,20,11
865,082938,Vallcebre,-5,2006,11,16
866,431589,Vallclara,12,2006,20,8
867,252402,Vallfogona de Balaguer,58,2006,118,60
868,171707,Vallfogona de Ripollès,14,2006,23,9
869,431592,Vallfogona de Riucorb,16,2006,26,10
870,082943,Vallgorguina,143,2006,288,145
871,082956,Vallirana,388,2006,1085,697
872,172095,Vall-llobrega,42,2006,99,57
873,431606,Vallmoll,42,2006,124,82
874,082969,Vallromanes,74,2006,209,135
875,431613,Valls,649,2006,1697,1048
876,259062,"Valls d'Aguilar, les",-5,2006,23,28
877,252398,"Valls de Valira, les",65,2006,138,73
878,431628,Vandellòs i l'Hospitalet de l'Infant,274,2006,543,269
879,259097,"Vansa i Fórnols, la",4,2006,17,13
880,082975,Veciana,2,2006,7,5
881,431634,"Vendrell, el",1361,2006,3575,2214
882,172109,Ventalló,28,2006,83,55
883,252424,Verdú,19,2006,67,48
884,172116,Verges,15,2006,71,56
885,431649,Vespella de Gaià,43,2006,66,23
886,082981,Vic,76,2006,2448,2372
887,172121,Vidrà,10,2006,10,0
888,172137,Vidreres,361,2006,777,416
889,252430,Vielha e Mijaran,199,2006,646,447
890,431652,Vilabella,15,2006,47,32
891,172142,Vilabertran,-1,2006,45,46
892,172155,Vilablareix,36,2006,124,88
893,082994,Vilada,15,2006,21,6
894,172174,Viladamat,24,2006,38,14
895,172168,Viladasens,9,2006,20,11
896,083015,Viladecans,-120,2006,3188,3308
897,083008,Viladecavalls,41,2006,436,395
898,172180,Vilademuls,-8,2006,44,52
899,172207,Viladrau,34,2006,87,53
900,172214,Vilafant,154,2006,394,240
901,083054,Vilafranca del Penedès,534,2006,2653,2119
902,252445,Vilagrassa,-1,2006,26,27
903,172235,Vilajuïga,41,2006,103,62
904,431750,Vilalba dels Arcs,13,2006,19,6
905,083067,Vilalba Sasserra,13,2006,63,50
906,252458,Vilaller,-15,2006,99,114
907,172240,Vilallonga de Ter,12,2006,33,21
908,431665,Vilallonga del Camp,84,2006,164,80
909,172253,Vilamacolum,7,2006,23,16
910,172266,Vilamalla,8,2006,64,56
911,172272,Vilamaniscle,-7,2006,9,16
912,252477,Vilamòs,6,2006,34,28
913,172288,Vilanant,-9,2006,21,30
914,431671,Vilanova d'Escornalbou,21,2006,41,20
915,252483,Vilanova de Bellpuig,21,2006,52,31
916,252496,Vilanova de l'Aguda,-11,2006,0,11
917,252542,Vilanova de la Barca,15,2006,101,86
918,252509,Vilanova de Meià,-15,2006,16,31
919,431687,Vilanova de Prades,-6,2006,8,14
920,083036,Vilanova de Sau,5,2006,16,11
921,252516,Vilanova de Segrià,13,2006,62,49
922,083020,Vilanova del Camí,147,2006,842,695
923,089024,Vilanova del Vallès,297,2006,491,194
924,083073,Vilanova i la Geltrú,1420,2006,4396,2976
925,431690,Vilaplana,32,2006,52,20
926,431704,Vila-rodona,15,2006,101,86
927,172305,Vila-sacra,22,2006,47,25
928,252521,Vila-sana,9,2006,43,34
929,431711,Vila-seca,1372,2006,2458,1086
930,082140,Vilassar de Dalt,126,2006,499,373
931,082191,Vilassar de Mar,41,2006,1228,1187
932,172229,Vilaür,4,2006,10,6
933,431726,Vilaverd,42,2006,72,30
934,431732,"Vilella Alta, la",-4,2006,0,4
935,431747,"Vilella Baixa, la",5,2006,14,9
936,172333,Vilobí d'Onyar,56,2006,206,150
937,083041,Vilobí del Penedès,45,2006,75,30
938,172327,Vilopriu,-1,2006,9,10
939,252537,"Vilosell, el",1,2006,10,9
940,431763,Vimbodí i Poblet,0,2006,56,56
941,252555,Vinaixa,-1,2006,21,22
942,431779,Vinebre,-10,2006,30,40
943,431785,Vinyols i els Arcs,43,2006,164,121
944,083089,Viver i Serrateix,-5,2006,4,9
945,430521,Xerta,22,2006,60,38
0,250019,Abella de la Conca,-3,2007,14,17
1,080018,Abrera,278,2007,842,564
2,250024,Àger,5,2007,34,29
3,250030,Agramunt,143,2007,403,260
4,080023,Aguilar de Segarra,-5,2007,10,15
5,170010,Agullana,49,2007,92,43
6,080142,Aiguafreda,74,2007,197,123
7,430017,Aiguamúrcia,16,2007,86,70
8,170025,Aiguaviva,52,2007,85,33
9,250387,Aitona,-26,2007,135,161
10,250045,"Alamús, els",-6,2007,40,46
11,250058,Alàs i Cerc,6,2007,21,15
12,250061,"Albagés, l'",-10,2007,13,23
13,170031,Albanyà,4,2007,18,14
14,250077,Albatàrrec,87,2007,196,109
15,250083,Albesa,-14,2007,59,73
16,250096,"Albi, l'",6,2007,39,33
17,430022,Albinyana,75,2007,217,142
18,430038,"Albiol, l'",40,2007,56,16
19,170046,Albons,33,2007,73,40
20,430043,Alcanar,549,2007,985,436
21,250100,Alcanó,0,2007,7,7
22,250117,Alcarràs,794,2007,1070,276
23,250122,Alcoletge,252,2007,350,98
24,430056,Alcover,199,2007,338,139
25,439044,"Aldea, l'",102,2007,259,157
26,430069,Aldover,8,2007,60,52
27,430075,"Aleixar, l'",40,2007,59,19
28,080039,Alella,195,2007,641,446
29,430081,Alfara de Carles,3,2007,20,17
30,250138,Alfarràs,-69,2007,159,228
31,250143,Alfés,-4,2007,15,19
32,430094,Alforja,77,2007,172,95
33,250156,Algerri,-2,2007,14,16
34,250169,Alguaire,64,2007,201,137
35,250175,Alins,10,2007,13,3
36,430108,Alió,16,2007,28,12
37,250194,Almacelles,133,2007,377,244
38,250208,Almatret,-8,2007,12,20
39,250215,Almenar,61,2007,191,130
40,430115,Almoster,29,2007,82,53
41,250220,Alòs de Balaguer,-2,2007,5,7
42,170062,Alp,96,2007,244,148
43,080044,Alpens,11,2007,17,6
44,250236,Alpicat,216,2007,482,266
45,250241,Alt Àneu,-6,2007,20,26
46,430120,Altafulla,101,2007,354,253
47,170078,Amer,26,2007,146,120
48,430136,"Ametlla de Mar, l'",333,2007,614,281
49,080057,"Ametlla del Vallès, l'",134,2007,517,383
50,439060,"Ampolla, l'",312,2007,465,153
51,430141,Amposta,804,2007,1690,886
52,170084,Anglès,144,2007,368,224
53,250273,Anglesola,35,2007,93,58
54,250292,Arbeca,38,2007,134,96
55,430167,"Arboç, l'",277,2007,538,261
56,430154,Arbolí,-1,2007,9,10
57,170097,Arbúcies,223,2007,556,333
58,080060,Arenys de Mar,293,2007,1101,808
59,080076,Arenys de Munt,176,2007,504,328
60,170101,Argelaguer,16,2007,36,20
61,080082,Argençola,-4,2007,12,16
62,430173,"Argentera, l'",2,2007,8,6
63,080095,Argentona,110,2007,614,504
64,170118,"Armentera, l'",42,2007,69,27
65,430189,Arnes,3,2007,17,14
66,250313,Arres,1,2007,4,3
67,250328,Arsèguel,-1,2007,7,8
68,080109,Artés,137,2007,325,188
69,250334,Artesa de Lleida,42,2007,94,52
70,250349,Artesa de Segre,158,2007,344,186
71,430192,Ascó,12,2007,67,55
72,250365,Aspa,-2,2007,4,6
73,250371,"Avellanes i Santa Linya, les",1,2007,33,32
74,080116,Avià,41,2007,135,94
75,080121,Avinyó,20,2007,93,73
76,170123,Avinyonet de Puigventós,45,2007,116,71
77,080137,Avinyonet del Penedès,69,2007,165,96
78,080155,Badalona,-2030,2007,16411,18441
79,089045,Badia del Vallès,-194,2007,701,895
80,080168,Bagà,73,2007,178,105
81,250390,Baix Pallars,-2,2007,21,23
82,250404,Balaguer,420,2007,1371,951
83,080174,Balenyà,76,2007,259,183
84,080180,Balsareny,108,2007,243,135
85,430206,Banyeres del Penedès,123,2007,270,147
86,170157,Banyoles,461,2007,1183,722
87,250411,Barbens,52,2007,93,41
88,430213,Barberà de la Conca,14,2007,45,31
89,082520,Barberà del Vallès,911,2007,2373,1462
90,080193,Barcelona,17672,2007,110822,93150
91,250426,"Baronia de Rialb, la",-8,2007,20,28
92,170160,Bàscara,6,2007,57,51
93,250447,Bassella,8,2007,19,11
94,430228,Batea,59,2007,108,49
95,250450,Bausen,-1,2007,0,1
96,080207,Begues,154,2007,382,228
97,170139,Begur,189,2007,395,206
98,250463,Belianes,6,2007,25,19
99,251706,Bellaguarda,-5,2007,8,13
100,170182,Bellcaire d'Empordà,1,2007,49,48
101,250479,Bellcaire d'Urgell,4,2007,49,45
102,250485,Bell-lloc d'Urgell,47,2007,161,114
103,250498,Bellmunt d'Urgell,3,2007,15,12
104,430234,Bellmunt del Priorat,14,2007,24,10
105,080214,Bellprat,-3,2007,3,6
106,250501,Bellpuig,229,2007,471,242
107,430249,Bellvei,118,2007,240,122
108,250518,Bellver de Cerdanya,115,2007,227,112
109,250523,Bellvís,39,2007,153,114
110,250539,Benavent de Segrià,67,2007,141,74
111,430252,Benifallet,-22,2007,2,24
112,430265,Benissanet,20,2007,95,75
113,080229,Berga,462,2007,1180,718
114,170195,Besalú,31,2007,120,89
115,170209,Bescanó,92,2007,237,145
116,170216,Beuda,3,2007,7,4
117,080235,Bigues i Riells del Fai,151,2007,575,424
118,250557,Biosca,1,2007,7,6
119,170221,"Bisbal d'Empordà, la",387,2007,845,458
120,430271,"Bisbal de Falset, la",-5,2007,4,9
121,430287,"Bisbal del Penedès, la",156,2007,360,204
122,172348,Biure,-6,2007,9,15
123,430290,Blancafort,18,2007,29,11
124,170237,Blanes,612,2007,3053,2441
125,170293,Boadella i les Escaules,-9,2007,11,20
126,170242,Bolvir,34,2007,56,22
127,430304,Bonastre,56,2007,109,53
128,250576,"Bòrdes, Es",-9,2007,15,24
129,170255,Bordils,75,2007,197,122
130,250582,"Borges Blanques, les",197,2007,412,215
131,430311,"Borges del Camp, les",83,2007,156,73
132,170268,Borrassà,57,2007,80,23
133,080240,Borredà,39,2007,65,26
134,250595,Bossòst,57,2007,129,72
135,430326,Bot,-4,2007,17,21
136,430332,Botarell,18,2007,83,65
137,250560,Bovera,-5,2007,11,16
138,430347,Bràfim,-21,2007,29,50
139,170274,Breda,34,2007,189,155
140,080253,"Bruc, el",71,2007,154,83
141,080266,"Brull, el",15,2007,23,8
142,170280,Brunyola i Sant Martí Sapresa,6,2007,21,15
143,430350,Cabacés,3,2007,11,8
144,250609,Cabanabona,8,2007,11,3
145,170314,Cabanelles,-3,2007,5,8
146,170307,Cabanes,-21,2007,58,79
147,080272,"Cabanyes, les",38,2007,64,26
148,250616,Cabó,-4,2007,2,6
149,430363,Cabra del Camp,63,2007,137,74
150,080288,Cabrera d'Anoia,74,2007,187,113
151,080291,Cabrera de Mar,39,2007,323,284
152,080305,Cabrils,97,2007,521,424
153,170329,Cadaqués,36,2007,224,188
154,080312,Calaf,116,2007,301,185
155,430379,Calafell,1009,2007,2785,1776
156,080348,Calders,30,2007,62,32
157,080327,Caldes d'Estrac,81,2007,335,254
158,170335,Caldes de Malavella,342,2007,643,301
159,080333,Caldes de Montbui,337,2007,1047,710
160,080351,Calella,455,2007,1803,1348
161,080370,Calldetenes,67,2007,159,92
162,080386,Callús,49,2007,110,61
163,080364,Calonge de Segarra,-2,2007,5,7
164,170340,Calonge i Sant Antoni,329,2007,1093,764
165,250621,Camarasa,28,2007,53,25
166,439039,Camarles,166,2007,274,108
167,430385,Cambrils,1613,2007,3370,1757
168,170353,Camós,-1,2007,29,30
169,170366,Campdevànol,8,2007,118,110
170,170372,Campelles,15,2007,22,7
171,080399,Campins,-1,2007,32,33
172,170388,Campllong,18,2007,33,15
173,170391,Camprodon,60,2007,224,164
174,250637,Canejan,5,2007,5,0
175,170405,Canet d'Adri,-2,2007,27,29
176,080403,Canet de Mar,216,2007,878,662
177,080410,Canovelles,160,2007,1344,1184
178,080425,Cànoves i Samalús,52,2007,225,173
179,170412,Cantallops,20,2007,33,13
180,080431,Canyelles,171,2007,381,210
181,430398,Capafonts,-5,2007,4,9
182,430402,Capçanes,6,2007,18,12
183,080446,Capellades,77,2007,338,261
184,170427,Capmany,44,2007,71,27
185,080459,Capolat,-8,2007,4,12
186,080462,Cardedeu,162,2007,897,735
187,080478,Cardona,38,2007,187,149
188,080484,Carme,5,2007,48,43
189,430419,Caseres,-6,2007,5,11
190,170448,Cassà de la Selva,267,2007,629,362
191,080497,Casserres,38,2007,104,66
192,080575,Castell de l'Areny,0,2007,13,13
193,259046,Castell de Mur,-7,2007,9,16
194,250642,Castellar de la Ribera,-4,2007,2,6
195,080522,Castellar de n'Hug,-17,2007,21,38
196,080500,Castellar del Riu,6,2007,16,10
197,080517,Castellar del Vallès,469,2007,1329,860
198,080538,Castellbell i el Vilar,149,2007,356,207
199,080543,Castellbisbal,102,2007,688,586
200,080556,Castellcir,51,2007,83,32
201,250674,Castelldans,30,2007,105,75
202,080569,Castelldefels,1139,2007,5680,4541
203,080581,Castellet i la Gornal,136,2007,301,165
204,170464,Castellfollit de la Roca,17,2007,81,64
205,080608,Castellfollit de Riubregós,-3,2007,10,13
206,080594,Castellfollit del Boix,7,2007,27,20
207,080615,Castellgalí,128,2007,230,102
208,080620,Castellnou de Bages,48,2007,106,58
209,250680,Castellnou de Seana,-11,2007,22,33
210,170470,Castelló d'Empúries,1033,2007,1701,668
211,250693,Castelló de Farfanya,5,2007,21,16
212,080636,Castellolí,7,2007,30,23
213,170486,Castell-Platja d'Aro,289,2007,1235,946
214,250707,Castellserà,22,2007,73,51
215,080641,Castellterçol,90,2007,182,92
216,430424,Castellvell del Camp,96,2007,166,70
217,080654,Castellví de la Marca,37,2007,117,80
218,080667,Castellví de Rosanes,73,2007,164,91
219,430430,"Catllar, el",197,2007,381,184
220,250714,Cava,0,2007,3,3
221,171899,"Cellera de Ter, la",34,2007,105,71
222,170499,Celrà,317,2007,520,203
223,080673,Centelles,190,2007,421,231
224,082687,Cercs,10,2007,76,66
225,082665,Cerdanyola del Vallès,436,2007,3555,3119
226,080689,Cervelló,211,2007,657,446
227,250729,Cervera,122,2007,625,503
228,250735,Cervià de les Garrigues,3,2007,53,50
229,170502,Cervià de Ter,10,2007,45,35
230,170519,Cistella,9,2007,20,11
231,250740,Ciutadilla,-2,2007,14,16
232,250753,Clariana de Cardener,0,2007,6,6
233,250766,"Cogul, el",-3,2007,6,9
234,170545,Colera,-11,2007,38,49
235,250772,Coll de Nargó,12,2007,39,27
236,080692,Collbató,152,2007,318,166
237,430458,Colldejou,0,2007,6,6
238,080706,Collsuspina,12,2007,28,16
239,170558,Colomers,-1,2007,11,12
240,251636,"Coma i la Pedra, la",9,2007,19,10
241,251615,Conca de Dalt,-5,2007,18,23
242,430461,Conesa,0,2007,9,9
243,430477,Constantí,103,2007,692,589
244,080713,Copons,3,2007,26,23
245,430483,Corbera d'Ebre,15,2007,69,54
246,080728,Corbera de Llobregat,329,2007,1057,728
247,250788,Corbins,8,2007,100,92
248,170577,Corçà,12,2007,86,74
249,080734,Cornellà de Llobregat,730,2007,5597,4867
250,170561,Cornellà del Terri,82,2007,149,67
251,430496,Cornudella de Montsant,7,2007,61,54
252,430509,Creixell,201,2007,411,210
253,170583,Crespià,7,2007,24,17
254,179011,"Cruïlles, Monells i Sant Sadurní de l'Heura",-37,2007,49,86
255,080749,Cubelles,332,2007,1256,924
256,250791,Cubells,14,2007,26,12
257,430516,Cunit,623,2007,1760,1137
258,170600,Darnius,1,2007,32,31
259,170617,Das,22,2007,34,12
260,439018,Deltebre,436,2007,677,241
261,080752,Dosrius,159,2007,418,259
262,430537,Duesaigües,4,2007,10,6
263,170622,"Escala, l'",474,2007,947,473
264,080765,Esparreguera,32,2007,1118,1086
265,170638,Espinelves,9,2007,19,10
266,250812,"Espluga Calba, l'",-13,2007,21,34
267,430542,"Espluga de Francolí, l'",61,2007,236,175
268,080771,Esplugues de Llobregat,46,2007,3411,3365
269,170643,Espolla,4,2007,36,32
270,170656,Esponellà,12,2007,32,20
271,250827,Espot,-1,2007,23,24
272,080787,"Espunyola, l'",9,2007,11,2
273,082541,"Esquirol, l'",35,2007,116,81
274,250886,Estamariu,-6,2007,1,7
275,080790,"Estany, l'",8,2007,19,11
276,250851,Estaràs,-1,2007,9,10
277,250864,Esterri d'Àneu,72,2007,152,80
278,250870,Esterri de Cardós,0,2007,2,2
279,430555,Falset,69,2007,152,83
280,170059,"Far d'Empordà, el",7,2007,29,22
281,250899,Farrera,0,2007,8,8
282,430568,"Fatarella, la",-8,2007,22,30
283,430574,"Febró, la",-6,2007,1,7
284,081347,Figaró-Montmany,47,2007,117,70
285,080804,Fígols,-2,2007,1,3
286,259084,Fígols i Alinyà,5,2007,19,14
287,430580,"Figuera, la",-8,2007,12,20
288,170669,Figueres,1435,2007,3809,2374
289,430593,Figuerola del Camp,0,2007,13,13
290,170675,Flaçà,35,2007,95,60
291,430607,Flix,71,2007,213,142
292,250925,"Floresta, la",8,2007,20,12
293,080826,Fogars de la Selva,36,2007,130,94
294,080811,Fogars de Montclús,3,2007,36,33
295,170681,Foixà,6,2007,18,12
296,080832,Folgueroles,69,2007,123,54
297,250931,Fondarella,14,2007,40,26
298,080847,Fonollosa,78,2007,126,48
299,170694,Fontanals de Cerdanya,-1,2007,39,40
300,170708,Fontanilles,13,2007,17,4
301,170715,Fontcoberta,-11,2007,57,68
302,080850,Font-rubí,33,2007,96,63
303,250946,Foradada,-1,2007,17,18
304,179026,Forallac,6,2007,98,92
305,430614,Forès,-4,2007,4,8
306,170736,Fornells de la Selva,119,2007,193,74
307,170741,Fortià,14,2007,47,33
308,080863,"Franqueses del Vallès, les",455,2007,1438,983
309,430629,Freginals,-1,2007,22,23
310,250962,"Fuliola, la",-12,2007,56,68
311,250978,Fulleda,6,2007,23,17
312,080902,Gaià,-2,2007,13,15
313,430635,"Galera, la",7,2007,59,52
314,080879,Gallifa,-4,2007,12,16
315,430640,Gandesa,135,2007,253,118
316,430653,Garcia,58,2007,79,21
317,430666,"Garidells, els",18,2007,29,11
318,080885,"Garriga, la",346,2007,921,575
319,170754,Garrigàs,42,2007,62,20
320,170767,Garrigoles,-1,2007,12,13
321,170773,Garriguella,19,2007,69,50
322,080898,Gavà,74,2007,2833,2759
323,250984,Gavet de la Conca,3,2007,15,12
324,080919,Gelida,406,2007,681,275
325,170789,Ger,3,2007,46,43
326,259123,Gimenells i el Pla de la Font,29,2007,81,52
327,430672,Ginestar,58,2007,142,84
328,170792,Girona,1174,2007,8740,7566
329,080924,Gironella,162,2007,301,139
330,080930,Gisclareny,0,2007,3,3
331,430688,Godall,25,2007,55,30
332,250997,Golmés,38,2007,140,102
333,170806,Gombrèn,7,2007,22,15
334,251001,Gósol,15,2007,34,19
335,080945,"Granada, la",80,2007,175,95
336,251018,"Granadella, la",23,2007,55,32
337,080958,Granera,-4,2007,2,6
338,251023,"Granja d'Escarp, la",-20,2007,40,60
339,080961,Granollers,945,2007,5060,4115
340,251039,Granyanella,3,2007,8,5
341,251057,Granyena de les Garrigues,-4,2007,10,14
342,251044,Granyena de Segarra,-2,2007,0,2
343,430691,Gratallops,11,2007,20,9
344,080977,Gualba,57,2007,120,63
345,170813,Gualta,-4,2007,36,40
346,080996,Guardiola de Berguedà,45,2007,106,61
347,430705,"Guiamets, els",0,2007,12,12
348,170828,Guils de Cerdanya,12,2007,61,49
349,251095,Guimerà,6,2007,32,26
350,259031,"Guingueta d'Àneu, la",6,2007,35,29
351,251109,Guissona,403,2007,766,363
352,251116,Guixers,-9,2007,4,13
353,081000,Gurb,39,2007,132,93
354,430712,Horta de Sant Joan,46,2007,97,51
355,081017,"Hospitalet de Llobregat, l'",2927,2007,23037,20110
356,081629,"Hostalets de Pierola, els",162,2007,342,180
357,170834,Hostalric,91,2007,325,234
358,081022,Igualada,894,2007,2757,1863
359,251155,Isona i Conca Dellà,17,2007,69,52
360,170849,Isòvol,-7,2007,16,23
361,251137,Ivars d'Urgell,-36,2007,110,146
362,251121,Ivars de Noguera,8,2007,20,12
363,251142,Ivorra,-2,2007,2,4
364,170852,Jafre,7,2007,41,34
365,170865,"Jonquera, la",2,2007,348,346
366,081038,Jorba,42,2007,79,37
367,259101,Josa i Tuixén,-11,2007,6,17
368,170871,Juià,12,2007,39,27
369,251180,Juncosa,-11,2007,25,36
370,251193,Juneda,110,2007,231,121
371,251214,Les,18,2007,94,76
372,251229,Linyola,113,2007,212,99
373,081043,"Llacuna, la",31,2007,78,47
374,170887,Lladó,18,2007,38,20
375,251235,Lladorre,3,2007,11,8
376,251240,Lladurs,15,2007,21,6
377,081056,"Llagosta, la",31,2007,959,928
378,170890,Llagostera,210,2007,612,402
379,170904,Llambilles,16,2007,47,31
380,170911,Llanars,4,2007,41,37
381,170926,Llançà,200,2007,424,224
382,251253,Llardecans,-5,2007,13,18
383,251266,Llavorsí,18,2007,37,19
384,251207,Lleida,3758,2007,10040,6282
385,170932,Llers,24,2007,86,62
386,251272,Lles de Cerdanya,-9,2007,7,16
387,081075,Lliçà d'Amunt,219,2007,914,695
388,081081,Lliçà de Vall,39,2007,327,288
389,251288,Llimiana,1,2007,17,16
390,081069,Llinars del Vallès,221,2007,726,505
391,170947,Llívia,118,2007,212,94
392,430727,"Lloar, el",0,2007,8,8
393,251291,Llobera,-4,2007,2,6
394,430733,Llorac,-4,2007,4,8
395,430748,Llorenç del Penedès,52,2007,170,118
396,170950,Lloret de Mar,2401,2007,5142,2741
397,170963,"Llosses, les",-1,2007,16,17
398,081094,Lluçà,0,2007,8,8
399,171024,Maçanet de Cabrenys,4,2007,44,40
400,171030,Maçanet de la Selva,331,2007,749,418
401,170979,Madremanya,14,2007,23,9
402,170985,Maià de Montcal,27,2007,42,15
403,251333,Maials,14,2007,51,37
404,251305,Maldà,-2,2007,13,15
405,081108,Malgrat de Mar,407,2007,1394,987
406,081115,Malla,-5,2007,13,18
407,081120,Manlleu,302,2007,1221,919
408,081136,Manresa,1430,2007,5056,3626
409,430764,Marçà,-8,2007,24,32
410,430751,Margalef,-4,2007,6,10
411,082423,Marganell,11,2007,30,19
412,081141,Martorell,240,2007,1926,1686
413,081154,Martorelles,-4,2007,275,279
414,430770,Mas de Barberans,17,2007,36,19
415,171002,Masarac,11,2007,22,11
416,430786,Masdenverge,17,2007,85,68
417,081167,"Masies de Roda, les",-23,2007,34,57
418,081173,"Masies de Voltregà, les",22,2007,130,108
419,430799,Masllorenç,14,2007,45,31
420,081189,"Masnou, el",119,2007,1160,1041
421,430803,"Masó, la",1,2007,10,9
422,430810,Maspujols,22,2007,41,19
423,081192,Masquefa,219,2007,655,436
424,430825,"Masroig, el",27,2007,47,20
425,251312,Massalcoreig,1,2007,30,29
426,171019,Massanes,20,2007,71,51
427,251327,Massoteres,4,2007,24,20
428,081206,Matadepera,100,2007,430,330
429,081213,Mataró,3,2007,6468,6465
430,081228,Mediona,58,2007,282,224
431,251348,Menàrguens,13,2007,46,33
432,170998,Meranges,-5,2007,2,7
433,171058,Mieres,23,2007,40,17
434,430831,"Milà, el",3,2007,6,3
435,251351,Miralcamp,30,2007,96,66
436,430846,Miravet,17,2007,48,31
437,081385,Moià,135,2007,404,269
438,430859,"Molar, el",3,2007,21,18
439,081234,Molins de Rei,197,2007,1129,932
440,251370,Mollerussa,392,2007,1506,1114
441,171061,Mollet de Peralada,0,2007,7,7
442,081249,Mollet del Vallès,186,2007,3298,3112
443,171077,Molló,9,2007,20,11
444,251364,"Molsosa, la",-3,2007,0,3
445,081287,Monistrol de Calders,1,2007,42,41
446,081271,Monistrol de Montserrat,70,2007,260,190
447,171096,Montagut i Oix,22,2007,82,60
448,430862,Montblanc,294,2007,516,222
449,430884,Montbrió del Camp,130,2007,273,143
450,081252,Montcada i Reixac,523,2007,2336,1813
451,081304,Montclar,-1,2007,0,1
452,251399,Montellà i Martinet,29,2007,68,39
453,081311,Montesquiu,25,2007,54,29
454,251403,Montferrer i Castellbò,87,2007,174,87
455,430897,Montferri,25,2007,44,19
456,251386,Montgai,4,2007,32,28
457,081265,Montgat,201,2007,746,545
458,081326,Montmajor,4,2007,24,20
459,081332,Montmaneu,-1,2007,12,13
460,430901,"Montmell, el",74,2007,205,131
461,081350,Montmeló,-56,2007,420,476
462,251425,Montoliu de Lleida,-23,2007,24,47
463,251410,Montoliu de Segarra,4,2007,13,9
464,251431,Montornès de Segarra,0,2007,2,2
465,081363,Montornès del Vallès,234,2007,1183,949
466,430918,Mont-ral,-12,2007,9,21
467,171100,Mont-ras,-23,2007,66,89
468,430923,Mont-roig del Camp,777,2007,1502,725
469,081379,Montseny,20,2007,32,12
470,430939,Móra d'Ebre,264,2007,478,214
471,430944,Móra la Nova,23,2007,193,170
472,430957,"Morell, el",197,2007,376,179
473,430960,"Morera de Montsant, la",-1,2007,19,20
474,081290,Muntanyola,30,2007,59,29
475,081398,Mura,1,2007,21,20
476,251459,Nalec,1,2007,2,1
477,250254,Naut Aran,4,2007,133,129
478,081402,Navarcles,81,2007,286,205
479,081419,Navàs,170,2007,369,199
480,171117,Navata,63,2007,101,38
481,251462,Navès,-5,2007,5,10
482,081424,"Nou de Berguedà, la",7,2007,13,6
483,430976,"Nou de Gaià, la",12,2007,28,16
484,430982,Nulles,1,2007,20,19
485,251484,Odèn,8,2007,14,6
486,081430,Òdena,95,2007,237,142
487,171122,Ogassa,-6,2007,11,17
488,081458,Olèrdola,71,2007,245,174
489,081461,Olesa de Bonesvalls,95,2007,183,88
490,081477,Olesa de Montserrat,192,2007,1281,1089
491,251497,Oliana,38,2007,158,120
492,251500,Oliola,3,2007,16,13
493,251517,Olius,40,2007,75,35
494,081483,Olivella,256,2007,491,235
495,081496,Olost,13,2007,42,29
496,171143,Olot,536,2007,2015,1479
497,251522,"Oluges, les",10,2007,16,6
498,081445,Olvan,26,2007,52,26
499,251538,"Omellons, els",-3,2007,9,12
500,251543,"Omells de na Gaia, els",1,2007,4,3
501,171156,Ordis,3,2007,19,16
502,251556,Organyà,-4,2007,59,63
503,081509,Orís,14,2007,23,9
504,081516,Oristà,3,2007,22,19
505,081521,Orpí,10,2007,29,19
506,081537,Òrrius,33,2007,52,19
507,251569,Os de Balaguer,43,2007,79,36
508,171169,Osor,-18,2007,0,18
509,251575,Ossó de Sió,-6,2007,3,9
510,081542,Pacs del Penedès,21,2007,64,43
511,081555,Palafolls,207,2007,668,461
512,171175,Palafrugell,470,2007,1610,1140
513,171181,Palamós,270,2007,1309,1039
514,251581,"Palau d'Anglesola, el",88,2007,178,90
515,171194,Palau de Santa Eulàlia,6,2007,13,7
516,171215,Palau-sator,-3,2007,10,13
517,171208,Palau-saverdera,120,2007,195,75
518,081568,Palau-solità i Plegamans,219,2007,839,620
519,431009,"Pallaresos, els",258,2007,400,142
520,081574,Pallejà,83,2007,592,509
521,430995,"Palma d'Ebre, la",-6,2007,14,20
522,089058,"Palma de Cervelló, la",7,2007,169,162
523,171236,Palol de Revardit,17,2007,29,12
524,171241,Pals,145,2007,317,172
525,081580,"Papiol, el",44,2007,201,157
526,171254,Pardines,2,2007,10,8
527,081593,Parets del Vallès,316,2007,1154,838
528,171267,Parlavà,1,2007,19,18
529,431016,Passanant i Belltall,-17,2007,8,25
530,171289,Pau,22,2007,72,50
531,431021,Paüls,19,2007,32,13
532,171292,Pedret i Marzà,-8,2007,12,20
533,251641,Penelles,31,2007,50,19
534,171306,"Pera, la",14,2007,44,30
535,081607,Perafita,18,2007,24,6
536,431037,Perafort,104,2007,145,41
537,171328,Peralada,60,2007,137,77
538,251654,Peramola,4,2007,22,18
539,431042,"Perelló, el",191,2007,312,121
540,081614,Piera,336,2007,1018,682
541,431055,"Piles, les",19,2007,27,8
542,081635,Pineda de Mar,201,2007,2019,1818
543,431068,"Pinell de Brai, el",7,2007,33,26
544,251667,Pinell de Solsonès,-1,2007,9,10
545,251673,Pinós,-1,2007,11,12
546,431074,Pira,11,2007,26,15
547,431080,"Pla de Santa Maria, el",164,2007,257,93
548,081640,"Pla del Penedès, el",106,2007,131,25
549,171334,"Planes d'Hostoles, les",-11,2007,56,67
550,171349,Planoles,14,2007,22,8
551,259118,"Plans de Sió, els",-10,2007,12,22
552,251689,"Poal, el",10,2007,40,30
553,251692,"Pobla de Cérvoles, la",-4,2007,9,13
554,081653,"Pobla de Claramunt, la",5,2007,153,148
555,081666,"Pobla de Lillet, la",36,2007,74,38
556,431093,"Pobla de Mafumet, la",346,2007,446,100
557,431107,"Pobla de Massaluca, la",2,2007,24,22
558,431114,"Pobla de Montornès, la",144,2007,344,200
559,251713,"Pobla de Segur, la",73,2007,269,196
560,431129,Poboleda,22,2007,41,19
561,081672,Polinyà,209,2007,649,440
562,431135,"Pont d'Armentera, el",4,2007,49,45
563,250306,"Pont de Bar, el",0,2007,9,9
564,171352,Pont de Molins,15,2007,50,35
565,251734,"Pont de Suert, el",108,2007,241,133
566,081825,"Pont de Vilomara i Rocafort, el",97,2007,256,159
567,431418,Pontils,6,2007,23,17
568,081688,Pontons,-6,2007,86,92
569,171365,Pontós,16,2007,29,13
570,251728,Ponts,38,2007,216,178
571,171371,Porqueres,98,2007,268,170
572,431140,Porrera,-9,2007,15,24
573,171404,"Port de la Selva, el",82,2007,149,67
574,171387,Portbou,-5,2007,53,58
575,251749,"Portella, la",14,2007,110,96
576,431153,Pradell de la Teixeta,-4,2007,0,4
577,431166,Prades,40,2007,74,34
578,431172,Prat de Comte,0,2007,9,9
579,081691,"Prat de Llobregat, el",82,2007,2691,2609
580,431188,Pratdip,63,2007,105,42
581,081712,Prats de Lluçanès,27,2007,107,80
582,081705,"Prats de Rei, els",7,2007,38,31
583,251752,Prats i Sansor,13,2007,27,14
584,251765,Preixana,4,2007,18,14
585,251771,Preixens,-11,2007,15,26
586,082303,Premià de Dalt,81,2007,620,539
587,081727,Premià de Mar,102,2007,1661,1559
588,171390,"Preses, les",11,2007,66,55
589,251790,Prullans,-8,2007,13,21
590,171411,Puigcerdà,78,2007,737,659
591,081748,Puigdàlber,35,2007,50,15
592,251804,Puiggròs,11,2007,21,10
593,431191,Puigpelat,54,2007,94,40
594,081751,Puig-reig,135,2007,307,172
595,251811,Puigverd d'Agramunt,6,2007,31,25
596,251826,Puigverd de Lleida,32,2007,86,54
597,081764,Pujalt,2,2007,11,9
598,081770,"Quar, la",-3,2007,5,8
599,171426,Quart,91,2007,213,122
600,170433,Queralbs,-7,2007,2,9
601,431205,Querol,14,2007,61,47
602,171432,Rabós,13,2007,18,5
603,081786,Rajadell,13,2007,39,26
604,431212,Rasquera,22,2007,44,22
605,171447,Regencós,-7,2007,16,23
606,081799,Rellinars,26,2007,89,63
607,431227,Renau,6,2007,20,14
608,431233,Reus,3026,2007,8102,5076
609,251832,Rialp,-4,2007,69,73
610,431248,"Riba, la",18,2007,58,40
611,431251,Riba-roja d'Ebre,-3,2007,50,53
612,259059,Ribera d'Ondara,-1,2007,24,25
613,251850,Ribera d'Urgellet,45,2007,129,84
614,171450,Ribes de Freser,22,2007,124,102
615,171463,Riells i Viabrea,177,2007,410,233
616,431264,"Riera de Gaià, la",69,2007,139,70
617,251863,Riner,4,2007,19,15
618,171479,Ripoll,218,2007,546,328
619,081803,Ripollet,183,2007,2234,2051
620,259139,Riu de Cerdanya,6,2007,13,7
621,171485,Riudarenes,142,2007,273,131
622,171498,Riudaura,-5,2007,12,17
623,431270,Riudecanyes,68,2007,106,38
624,431286,Riudecols,27,2007,96,69
625,171501,Riudellots de la Selva,53,2007,145,92
626,431299,Riudoms,227,2007,466,239
627,171518,Riumors,13,2007,27,14
628,081810,"Roca del Vallès, la",262,2007,727,465
629,431303,Rocafort de Queralt,12,2007,27,15
630,431310,Roda de Berà,422,2007,764,342
631,081831,Roda de Ter,193,2007,363,170
632,431325,Rodonyà,19,2007,43,24
633,431331,Roquetes,292,2007,642,350
634,171523,Roses,1115,2007,2141,1026
635,251898,Rosselló,110,2007,243,133
636,431346,"Rourell, el",10,2007,20,10
637,081846,Rubí,1127,2007,4644,3517
638,081859,Rubió,23,2007,31,8
639,171539,Rupià,18,2007,35,17
640,089019,Rupit i Pruit,5,2007,15,10
641,081878,Sabadell,1743,2007,10706,8963
642,081884,Sagàs,1,2007,4,3
643,251902,Salàs de Pallars,6,2007,24,18
644,081901,Saldes,11,2007,36,25
645,171544,Sales de Llierca,-3,2007,4,7
646,081918,Sallent,24,2007,264,240
647,431359,Salomó,24,2007,47,23
648,439057,Salou,2077,2007,4585,2508
649,171557,Salt,447,2007,3269,2822
650,251919,Sanaüja,14,2007,31,17
651,081944,Sant Adrià de Besòs,469,2007,2443,1974
652,081957,Sant Agustí de Lluçanès,6,2007,14,8
653,081960,Sant Andreu de la Barca,147,2007,1794,1647
654,081976,Sant Andreu de Llavaneres,187,2007,811,624
655,171576,Sant Andreu Salou,-2,2007,2,4
656,171833,Sant Aniol de Finestres,10,2007,22,12
657,081982,Sant Antoni de Vilamajor,223,2007,488,265
658,081995,Sant Bartomeu del Grau,-23,2007,27,50
659,082009,Sant Boi de Llobregat,388,2007,4037,3649
660,082016,Sant Boi de Lluçanès,25,2007,50,25
661,431362,Sant Carles de la Ràpita,996,2007,1619,623
662,082037,Sant Cebrià de Vallalta,85,2007,295,210
663,082021,Sant Celoni,488,2007,1361,873
664,082042,Sant Climent de Llobregat,0,2007,166,166
665,171582,Sant Climent Sescebes,-3,2007,46,49
666,082055,Sant Cugat del Vallès,1490,2007,4854,3364
667,082068,Sant Cugat Sesgarrigues,-4,2007,39,43
668,251961,Sant Esteve de la Sarga,-1,2007,8,9
669,082074,Sant Esteve de Palautordera,112,2007,271,159
670,082080,Sant Esteve Sesrovires,167,2007,474,307
671,171595,Sant Feliu de Buixalleu,14,2007,51,37
672,082107,Sant Feliu de Codines,122,2007,476,354
673,171609,Sant Feliu de Guíxols,597,2007,1711,1114
674,082114,Sant Feliu de Llobregat,177,2007,1942,1765
675,171616,Sant Feliu de Pallerols,47,2007,98,51
676,082129,Sant Feliu Sasserra,19,2007,29,10
677,171621,Sant Ferriol,6,2007,18,12
678,082093,Sant Fost de Campsentelles,292,2007,633,341
679,082135,Sant Fruitós de Bages,282,2007,689,407
680,171637,Sant Gregori,53,2007,195,142
681,251924,Sant Guim de Freixenet,27,2007,90,63
682,251977,Sant Guim de la Plana,-2,2007,17,19
683,171642,Sant Hilari Sacalm,164,2007,335,171
684,082153,Sant Hipòlit de Voltregà,46,2007,225,179
685,081939,Sant Iscle de Vallalta,39,2007,90,51
686,439023,Sant Jaume d'Enveja,49,2007,185,136
687,082166,Sant Jaume de Frontanyà,-2,2007,1,3
688,171655,Sant Jaume de Llierca,9,2007,64,55
689,431378,Sant Jaume dels Domenys,184,2007,318,134
690,171674,Sant Joan de les Abadesses,13,2007,143,130
691,171680,Sant Joan de Mollet,1,2007,33,32
692,082188,Sant Joan de Vilatorrada,173,2007,589,416
693,082172,Sant Joan Despí,-152,2007,1543,1695
694,171851,Sant Joan les Fonts,71,2007,178,107
695,171668,Sant Jordi Desvalls,8,2007,38,30
696,089030,Sant Julià de Cerdanyola,5,2007,21,16
697,171693,Sant Julià de Ramis,237,2007,376,139
698,082205,Sant Julià de Vilatorta,36,2007,146,110
699,179032,Sant Julià del Llor i Bonmatí,8,2007,99,91
700,082212,Sant Just Desvern,66,2007,737,671
701,082227,Sant Llorenç d'Hortons,80,2007,206,126
702,171714,Sant Llorenç de la Muga,2,2007,21,19
703,251930,Sant Llorenç de Morunys,62,2007,104,42
704,082233,Sant Llorenç Savall,38,2007,158,120
705,082251,Sant Martí d'Albars,2,2007,4,2
706,082248,Sant Martí de Centelles,49,2007,122,73
707,171729,Sant Martí de Llémena,6,2007,29,23
708,259025,Sant Martí de Riucorb,-2,2007,17,19
709,082264,Sant Martí de Tous,45,2007,63,18
710,082270,Sant Martí Sarroca,68,2007,229,161
711,082286,Sant Martí Sesgueioles,-7,2007,11,18
712,171735,Sant Martí Vell,3,2007,23,20
713,082299,Sant Mateu de Bages,7,2007,28,21
714,171740,Sant Miquel de Campmajor,12,2007,27,15
715,171753,Sant Miquel de Fluvià,-3,2007,57,60
716,171766,Sant Mori,19,2007,37,18
717,171772,Sant Pau de Segúries,21,2007,60,39
718,082310,Sant Pere de Ribes,566,2007,2210,1644
719,082325,Sant Pere de Riudebitlles,29,2007,158,129
720,082331,Sant Pere de Torelló,40,2007,131,91
721,082346,Sant Pere de Vilamajor,133,2007,343,210
722,171788,Sant Pere Pescador,59,2007,249,190
723,081897,Sant Pere Sallavinera,0,2007,4,4
724,082359,Sant Pol de Mar,-67,2007,402,469
725,082362,Sant Quintí de Mediona,2,2007,142,140
726,082378,Sant Quirze de Besora,74,2007,146,72
727,082384,Sant Quirze del Vallès,250,2007,1018,768
728,082397,Sant Quirze Safaja,-10,2007,66,76
729,251945,Sant Ramon,-11,2007,33,44
730,082401,Sant Sadurní d'Anoia,51,2007,723,672
731,082418,Sant Sadurní d'Osormort,4,2007,8,4
732,080983,Sant Salvador de Guardiola,45,2007,234,189
733,082628,Sant Vicenç de Castellet,245,2007,645,400
734,082649,Sant Vicenç de Montalt,121,2007,440,319
735,082652,Sant Vicenç de Torelló,21,2007,92,71
736,082634,Sant Vicenç dels Horts,234,2007,1494,1260
737,431384,Santa Bàrbara,161,2007,322,161
738,082439,Santa Cecília de Voltregà,4,2007,7,3
739,082444,Santa Coloma de Cervelló,45,2007,399,354
740,171805,Santa Coloma de Farners,306,2007,758,452
741,082457,Santa Coloma de Gramenet,297,2007,10596,10299
742,431397,Santa Coloma de Queralt,94,2007,228,134
743,171812,Santa Cristina d'Aro,119,2007,439,320
744,082460,Santa Eugènia de Berga,42,2007,193,151
745,082476,Santa Eulàlia de Riuprimer,49,2007,68,19
746,082482,Santa Eulàlia de Ronçana,183,2007,476,293
747,082495,Santa Fe del Penedès,20,2007,34,14
748,171827,Santa Llogaia d'Àlguema,-1,2007,13,14
749,082508,Santa Margarida de Montbui,-20,2007,553,573
750,082515,Santa Margarida i els Monjos,247,2007,737,490
751,082589,Santa Maria d'Oló,9,2007,44,35
752,082536,Santa Maria de Besora,-8,2007,2,10
753,082567,Santa Maria de Martorelles,14,2007,73,59
754,082554,Santa Maria de Merlès,4,2007,18,14
755,082573,Santa Maria de Miralles,2,2007,8,6
756,082592,Santa Maria de Palautordera,350,2007,760,410
757,431401,Santa Oliva,85,2007,283,198
758,171848,Santa Pau,19,2007,70,51
759,082606,Santa Perpètua de Mogoda,129,2007,1602,1473
760,082613,Santa Susanna,96,2007,337,241
761,081923,Santpedor,223,2007,436,213
762,431423,Sarral,33,2007,118,85
763,171864,Sarrià de Ter,155,2007,374,219
764,252017,Sarroca de Bellera,10,2007,14,4
765,252000,Sarroca de Lleida,2,2007,18,16
766,171870,"Saus, Camallera i Llampaies",1,2007,51,50
767,431439,Savallà del Comtat,1,2007,2,1
768,431444,"Secuita, la",87,2007,151,64
769,171886,"Selva de Mar, la",1,2007,14,13
770,431457,"Selva del Camp, la",129,2007,309,180
771,431460,Senan,5,2007,7,2
772,430445,"Sénia, la",88,2007,568,480
773,252022,Senterada,-5,2007,12,17
774,250352,"Sentiu de Sió, la",10,2007,28,18
775,082671,Sentmenat,218,2007,588,370
776,171903,Serinyà,11,2007,80,69
777,252043,Seròs,-8,2007,108,116
778,171910,Serra de Daró,11,2007,26,15
779,171925,Setcases,-12,2007,11,23
780,252038,"Seu d'Urgell, la",285,2007,984,699
781,082690,Seva,69,2007,231,162
782,252056,Sidamon,0,2007,23,23
783,171931,Sils,444,2007,670,226
784,082704,Sitges,770,2007,2499,1729
785,170524,Siurana,4,2007,14,10
786,082711,Sobremunt,7,2007,9,2
787,252069,"Soleràs, el",-3,2007,20,23
788,431476,Solivella,-3,2007,29,32
789,252075,Solsona,252,2007,615,363
790,082726,Sora,-7,2007,15,22
791,252081,Soriguera,11,2007,31,20
792,252094,Sort,87,2007,220,133
793,252108,Soses,-23,2007,99,122
794,082732,Subirats,50,2007,208,158
795,252115,Sudanell,33,2007,69,36
796,252120,Sunyer,8,2007,20,12
797,082747,Súria,95,2007,304,209
798,171946,Susqueda,-2,2007,16,18
799,082763,Tagamanent,0,2007,25,25
800,082779,Talamanca,7,2007,18,11
801,252154,Talarn,16,2007,47,31
802,252167,Talavera,5,2007,18,13
803,171959,"Tallada d'Empordà, la",18,2007,34,16
804,082785,Taradell,84,2007,247,163
805,431482,Tarragona,2277,2007,9458,7181
806,252173,Tàrrega,421,2007,1365,944
807,252189,Tarrés,-2,2007,0,2
808,252192,Tarroja de Segarra,9,2007,13,4
809,082750,Tavèrnoles,6,2007,24,18
810,082802,Tavertet,-3,2007,5,8
811,082819,Teià,20,2007,302,282
812,252206,Térmens,44,2007,141,97
813,171962,Terrades,-8,2007,4,12
814,082798,Terrassa,2604,2007,11076,8472
815,082824,Tiana,67,2007,351,284
816,252213,Tírvia,0,2007,5,5
817,252228,Tiurana,23,2007,25,2
818,431495,Tivenys,25,2007,48,23
819,431508,Tivissa,65,2007,141,76
820,082830,Tona,201,2007,489,288
821,252234,Torà,40,2007,127,87
822,082845,Tordera,687,2007,1428,741
823,082858,Torelló,208,2007,650,442
824,252249,"Torms, els",-3,2007,4,7
825,252252,Tornabous,30,2007,68,38
826,252271,"Torre de Cabdella, la",23,2007,52,29
827,082861,"Torre de Claramunt, la",91,2007,293,202
828,431515,"Torre de Fontaubella, la",2,2007,12,10
829,431520,"Torre de l'Espanyol, la",0,2007,47,47
830,252265,Torrebesses,-3,2007,4,7
831,431536,Torredembarra,445,2007,1468,1023
832,252287,Torrefarrera,335,2007,504,169
833,259078,Torrefeta i Florejacs,-1,2007,30,31
834,252304,Torregrossa,-8,2007,89,97
835,252311,Torrelameu,20,2007,58,38
836,082877,Torrelavit,36,2007,79,43
837,082883,Torrelles de Foix,88,2007,267,179
838,082896,Torrelles de Llobregat,163,2007,391,228
839,171978,Torrent,-7,2007,15,22
840,252326,Torres de Segre,17,2007,148,131
841,252332,Torre-serona,5,2007,17,12
842,171984,Torroella de Fluvià,88,2007,133,45
843,171997,Torroella de Montgrí,438,2007,1088,650
844,431541,Torroja del Priorat,22,2007,29,7
845,172001,Tortellà,17,2007,42,25
846,431554,Tortosa,1229,2007,3212,1983
847,172018,Toses,-7,2007,9,16
848,172023,Tossa de Mar,174,2007,474,300
849,252347,Tremp,243,2007,574,331
850,172044,Ullà,33,2007,164,131
851,082900,Ullastrell,74,2007,141,67
852,172057,Ullastret,5,2007,15,10
853,431567,Ulldecona,465,2007,796,331
854,431573,Ulldemolins,-11,2007,18,29
855,172039,Ultramort,-2,2007,13,15
856,172060,Urús,-5,2007,7,12
857,082917,Vacarisses,292,2007,599,307
858,170144,"Vajol, la",-10,2007,7,17
859,172076,"Vall d'en Bas, la",47,2007,109,62
860,172082,"Vall de Bianya, la",-4,2007,70,74
861,250432,"Vall de Boí, la",29,2007,105,76
862,259010,Vall de Cardós,-2,2007,36,38
863,082922,Vallbona d'Anoia,44,2007,107,63
864,252385,Vallbona de les Monges,4,2007,18,14
865,082938,Vallcebre,3,2007,17,14
866,431589,Vallclara,7,2007,15,8
867,252402,Vallfogona de Balaguer,69,2007,133,64
868,171707,Vallfogona de Ripollès,10,2007,15,5
869,431592,Vallfogona de Riucorb,-15,2007,4,19
870,082943,Vallgorguina,175,2007,300,125
871,082956,Vallirana,375,2007,945,570
872,172095,Vall-llobrega,37,2007,73,36
873,431606,Vallmoll,54,2007,136,82
874,082969,Vallromanes,-22,2007,134,156
875,431613,Valls,761,2007,1878,1117
876,259062,"Valls d'Aguilar, les",-9,2007,11,20
877,252398,"Valls de Valira, les",1,2007,88,87
878,431628,Vandellòs i l'Hospitalet de l'Infant,239,2007,520,281
879,259097,"Vansa i Fórnols, la",-5,2007,7,12
880,082975,Veciana,-2,2007,7,9
881,431634,"Vendrell, el",1232,2007,3489,2257
882,172109,Ventalló,7,2007,84,77
883,252424,Verdú,23,2007,67,44
884,172116,Verges,13,2007,76,63
885,431649,Vespella de Gaià,14,2007,45,31
886,082981,Vic,225,2007,2705,2480
887,172121,Vidrà,-2,2007,6,8
888,172137,Vidreres,293,2007,739,446
889,252430,Vielha e Mijaran,176,2007,637,461
890,431652,Vilabella,13,2007,45,32
891,172142,Vilabertran,18,2007,60,42
892,172155,Vilablareix,3,2007,97,94
893,082994,Vilada,12,2007,26,14
894,172174,Viladamat,0,2007,30,30
895,172168,Viladasens,8,2007,20,12
896,083015,Viladecans,-87,2007,3109,3196
897,083008,Viladecavalls,65,2007,406,341
898,172180,Vilademuls,12,2007,55,43
899,172207,Viladrau,31,2007,93,62
900,172214,Vilafant,116,2007,384,268
901,083054,Vilafranca del Penedès,668,2007,2793,2125
902,252445,Vilagrassa,3,2007,37,34
903,172235,Vilajuïga,9,2007,85,76
904,431750,Vilalba dels Arcs,-4,2007,19,23
905,083067,Vilalba Sasserra,-12,2007,42,54
906,252458,Vilaller,27,2007,92,65
907,172240,Vilallonga de Ter,15,2007,36,21
908,431665,Vilallonga del Camp,124,2007,205,81
909,172253,Vilamacolum,15,2007,29,14
910,172266,Vilamalla,-2,2007,72,74
911,172272,Vilamaniscle,7,2007,12,5
912,252477,Vilamòs,2,2007,28,26
913,172288,Vilanant,9,2007,25,16
914,431671,Vilanova d'Escornalbou,10,2007,40,30
915,252483,Vilanova de Bellpuig,38,2007,81,43
916,252496,Vilanova de l'Aguda,-2,2007,0,2
917,252542,Vilanova de la Barca,85,2007,176,91
918,252509,Vilanova de Meià,1,2007,20,19
919,431687,Vilanova de Prades,9,2007,15,6
920,083036,Vilanova de Sau,1,2007,19,18
921,252516,Vilanova de Segrià,0,2007,61,61
922,083020,Vilanova del Camí,109,2007,803,694
923,089024,Vilanova del Vallès,257,2007,423,166
924,083073,Vilanova i la Geltrú,1163,2007,4328,3165
925,431690,Vilaplana,0,2007,26,26
926,431704,Vila-rodona,31,2007,100,69
927,172305,Vila-sacra,36,2007,72,36
928,252521,Vila-sana,40,2007,72,32
929,431711,Vila-seca,1241,2007,2341,1100
930,082140,Vilassar de Dalt,95,2007,497,402
931,082191,Vilassar de Mar,-41,2007,1100,1141
932,172229,Vilaür,2,2007,9,7
933,431726,Vilaverd,20,2007,50,30
934,431732,"Vilella Alta, la",-3,2007,0,3
935,431747,"Vilella Baixa, la",5,2007,14,9
936,172333,Vilobí d'Onyar,101,2007,240,139
937,083041,Vilobí del Penedès,29,2007,77,48
938,172327,Vilopriu,25,2007,31,6
939,252537,"Vilosell, el",-1,2007,14,15
940,431763,Vimbodí i Poblet,25,2007,61,36
941,252555,Vinaixa,14,2007,34,20
942,431779,Vinebre,20,2007,48,28
943,431785,Vinyols i els Arcs,147,2007,273,126
944,083089,Viver i Serrateix,-2,2007,7,9
945,430521,Xerta,18,2007,52,34
0,250019,Abella de la Conca,5,2008,15,10
1,080018,Abrera,161,2008,657,496
2,250024,Àger,10,2008,30,20
3,250030,Agramunt,21,2008,247,226
4,080023,Aguilar de Segarra,13,2008,18,5
5,170010,Agullana,7,2008,67,60
6,080142,Aiguafreda,40,2008,154,114
7,430017,Aiguamúrcia,23,2008,80,57
8,170025,Aiguaviva,29,2008,61,32
9,250387,Aitona,77,2008,194,117
10,250045,"Alamús, els",25,2008,51,26
11,250058,Alàs i Cerc,-2,2008,10,12
12,250061,"Albagés, l'",4,2008,20,16
13,170031,Albanyà,12,2008,15,3
14,250077,Albatàrrec,103,2008,204,101
15,250083,Albesa,53,2008,100,47
16,250096,"Albi, l'",-6,2008,24,30
17,430022,Albinyana,-16,2008,129,145
18,430038,"Albiol, l'",-5,2008,21,26
19,170046,Albons,21,2008,61,40
20,430043,Alcanar,10,2008,559,549
21,250100,Alcanó,-1,2008,9,10
22,250117,Alcarràs,415,2008,801,386
23,250122,Alcoletge,103,2008,230,127
24,430056,Alcover,123,2008,295,172
25,439044,"Aldea, l'",134,2008,304,170
26,430069,Aldover,38,2008,55,17
27,430075,"Aleixar, l'",12,2008,38,26
28,080039,Alella,153,2008,627,474
29,430081,Alfara de Carles,10,2008,26,16
30,250138,Alfarràs,-25,2008,131,156
31,250143,Alfés,-3,2008,20,23
32,430094,Alforja,45,2008,133,88
33,250156,Algerri,2,2008,14,12
34,250169,Alguaire,35,2008,157,122
35,250175,Alins,20,2008,22,2
36,430108,Alió,7,2008,16,9
37,250194,Almacelles,176,2008,405,229
38,250208,Almatret,-6,2008,10,16
39,250215,Almenar,15,2008,185,170
40,430115,Almoster,23,2008,78,55
41,250220,Alòs de Balaguer,-7,2008,10,17
42,170062,Alp,37,2008,188,151
43,080044,Alpens,-2,2008,12,14
44,250236,Alpicat,159,2008,350,191
45,250241,Alt Àneu,3,2008,23,20
46,430120,Altafulla,98,2008,338,240
47,170078,Amer,28,2008,114,86
48,430136,"Ametlla de Mar, l'",157,2008,448,291
49,080057,"Ametlla del Vallès, l'",121,2008,507,386
50,439060,"Ampolla, l'",155,2008,328,173
51,430141,Amposta,547,2008,1408,861
52,170084,Anglès,108,2008,390,282
53,250273,Anglesola,24,2008,62,38
54,250292,Arbeca,27,2008,103,76
55,430167,"Arboç, l'",-12,2008,306,318
56,430154,Arbolí,2,2008,10,8
57,170097,Arbúcies,62,2008,351,289
58,080060,Arenys de Mar,147,2008,964,817
59,080076,Arenys de Munt,127,2008,454,327
60,170101,Argelaguer,11,2008,34,23
61,080082,Argençola,10,2008,15,5
62,430173,"Argentera, l'",-10,2008,2,12
63,080095,Argentona,57,2008,481,424
64,170118,"Armentera, l'",26,2008,56,30
65,430189,Arnes,-4,2008,13,17
66,250313,Arres,3,2008,3,0
67,250328,Arsèguel,-2,2008,3,5
68,080109,Artés,122,2008,362,240
69,250334,Artesa de Lleida,15,2008,74,59
70,250349,Artesa de Segre,23,2008,232,209
71,430192,Ascó,35,2008,77,42
72,250365,Aspa,-3,2008,4,7
73,250371,"Avellanes i Santa Linya, les",4,2008,22,18
74,080116,Avià,46,2008,107,61
75,080121,Avinyó,85,2008,166,81
76,170123,Avinyonet de Puigventós,28,2008,82,54
77,080137,Avinyonet del Penedès,16,2008,110,94
78,080155,Badalona,2321,2008,17577,15256
79,089045,Badia del Vallès,-175,2008,531,706
80,080168,Bagà,55,2008,132,77
81,250390,Baix Pallars,0,2008,21,21
82,250404,Balaguer,315,2008,1109,794
83,080174,Balenyà,48,2008,233,185
84,080180,Balsareny,15,2008,165,150
85,430206,Banyeres del Penedès,81,2008,227,146
86,170157,Banyoles,430,2008,1157,727
87,250411,Barbens,24,2008,57,33
88,430213,Barberà de la Conca,21,2008,59,38
89,082520,Barberà del Vallès,617,2008,1994,1377
90,080193,Barcelona,17329,2008,109316,91987
91,250426,"Baronia de Rialb, la",11,2008,30,19
92,170160,Bàscara,28,2008,62,34
93,250447,Bassella,-2,2008,7,9
94,430228,Batea,4,2008,62,58
95,250450,Bausen,1,2008,2,1
96,080207,Begues,147,2008,366,219
97,170139,Begur,-51,2008,219,270
98,250463,Belianes,7,2008,20,13
99,251706,Bellaguarda,-1,2008,12,13
100,170182,Bellcaire d'Empordà,14,2008,46,32
101,250479,Bellcaire d'Urgell,11,2008,79,68
102,250485,Bell-lloc d'Urgell,16,2008,95,79
103,250498,Bellmunt d'Urgell,-1,2008,8,9
104,430234,Bellmunt del Priorat,14,2008,20,6
105,080214,Bellprat,3,2008,7,4
106,250501,Bellpuig,131,2008,350,219
107,430249,Bellvei,9,2008,129,120
108,250518,Bellver de Cerdanya,70,2008,160,90
109,250523,Bellvís,41,2008,125,84
110,250539,Benavent de Segrià,44,2008,92,48
111,430252,Benifallet,-8,2008,6,14
112,430265,Benissanet,-3,2008,65,68
113,080229,Berga,119,2008,864,745
114,170195,Besalú,59,2008,134,75
115,170209,Bescanó,166,2008,272,106
116,170216,Beuda,3,2008,15,12
117,080235,Bigues i Riells del Fai,111,2008,457,346
118,250557,Biosca,9,2008,18,9
119,170221,"Bisbal d'Empordà, la",233,2008,705,472
120,430271,"Bisbal de Falset, la",0,2008,7,7
121,430287,"Bisbal del Penedès, la",68,2008,267,199
122,172348,Biure,0,2008,11,11
123,430290,Blancafort,13,2008,37,24
124,170237,Blanes,774,2008,2876,2102
125,170293,Boadella i les Escaules,9,2008,17,8
126,170242,Bolvir,7,2008,41,34
127,430304,Bonastre,15,2008,53,38
128,250576,"Bòrdes, Es",2,2008,17,15
129,170255,Bordils,13,2008,117,104
130,250582,"Borges Blanques, les",102,2008,335,233
131,430311,"Borges del Camp, les",43,2008,130,87
132,170268,Borrassà,-13,2008,26,39
133,080240,Borredà,5,2008,43,38
134,250595,Bossòst,2,2008,94,92
135,430326,Bot,0,2008,37,37
136,430332,Botarell,7,2008,57,50
137,250560,Bovera,-1,2008,7,8
138,430347,Bràfim,17,2008,59,42
139,170274,Breda,22,2008,168,146
140,080253,"Bruc, el",54,2008,149,95
141,080266,"Brull, el",5,2008,14,9
142,170280,Brunyola i Sant Martí Sapresa,7,2008,24,17
143,430350,Cabacés,4,2008,8,4
144,250609,Cabanabona,2,2008,8,6
145,170314,Cabanelles,2,2008,19,17
146,170307,Cabanes,32,2008,74,42
147,080272,"Cabanyes, les",-2,2008,45,47
148,250616,Cabó,-2,2008,0,2
149,430363,Cabra del Camp,40,2008,120,80
150,080288,Cabrera d'Anoia,34,2008,151,117
151,080291,Cabrera de Mar,37,2008,263,226
152,080305,Cabrils,70,2008,441,371
153,170329,Cadaqués,22,2008,163,141
154,080312,Calaf,62,2008,244,182
155,430379,Calafell,302,2008,2570,2268
156,080348,Calders,-8,2008,50,58
157,080327,Caldes d'Estrac,79,2008,339,260
158,170335,Caldes de Malavella,190,2008,533,343
159,080333,Caldes de Montbui,345,2008,1039,694
160,080351,Calella,132,2008,1503,1371
161,080370,Calldetenes,47,2008,134,87
162,080386,Callús,87,2008,177,90
163,080364,Calonge de Segarra,-7,2008,4,11
164,170340,Calonge i Sant Antoni,202,2008,978,776
165,250621,Camarasa,46,2008,69,23
166,439039,Camarles,-75,2008,172,247
167,430385,Cambrils,633,2008,2627,1994
168,170353,Camós,-2,2008,26,28
169,170366,Campdevànol,0,2008,120,120
170,170372,Campelles,-3,2008,6,9
171,080399,Campins,17,2008,46,29
172,170388,Campllong,3,2008,26,23
173,170391,Camprodon,-17,2008,180,197
174,250637,Canejan,-4,2008,1,5
175,170405,Canet d'Adri,-2,2008,34,36
176,080403,Canet de Mar,247,2008,838,591
177,080410,Canovelles,41,2008,1236,1195
178,080425,Cànoves i Samalús,37,2008,197,160
179,170412,Cantallops,3,2008,20,17
180,080431,Canyelles,79,2008,307,228
181,430398,Capafonts,2,2008,6,4
182,430402,Capçanes,13,2008,30,17
183,080446,Capellades,47,2008,255,208
184,170427,Capmany,29,2008,44,15
185,080459,Capolat,-2,2008,2,4
186,080462,Cardedeu,365,2008,1002,637
187,080478,Cardona,17,2008,173,156
188,080484,Carme,25,2008,46,21
189,430419,Caseres,1,2008,11,10
190,170448,Cassà de la Selva,271,2008,632,361
191,080497,Casserres,-26,2008,55,81
192,080575,Castell de l'Areny,-2,2008,4,6
193,259046,Castell de Mur,-3,2008,4,7
194,250642,Castellar de la Ribera,-2,2008,1,3
195,080522,Castellar de n'Hug,-6,2008,16,22
196,080500,Castellar del Riu,5,2008,13,8
197,080517,Castellar del Vallès,205,2008,1066,861
198,080538,Castellbell i el Vilar,64,2008,256,192
199,080543,Castellbisbal,30,2008,546,516
200,080556,Castellcir,-2,2008,48,50
201,250674,Castelldans,-1,2008,62,63
202,080569,Castelldefels,1172,2008,5314,4142
203,080581,Castellet i la Gornal,47,2008,169,122
204,170464,Castellfollit de la Roca,28,2008,82,54
205,080608,Castellfollit de Riubregós,4,2008,7,3
206,080594,Castellfollit del Boix,3,2008,16,13
207,080615,Castellgalí,148,2008,231,83
208,080620,Castellnou de Bages,48,2008,103,55
209,250680,Castellnou de Seana,9,2008,21,12
210,170470,Castelló d'Empúries,227,2008,1229,1002
211,250693,Castelló de Farfanya,-2,2008,30,32
212,080636,Castellolí,33,2008,50,17
213,170486,Castell-Platja d'Aro,213,2008,1184,971
214,250707,Castellserà,18,2008,57,39
215,080641,Castellterçol,58,2008,198,140
216,430424,Castellvell del Camp,71,2008,147,76
217,080654,Castellví de la Marca,18,2008,119,101
218,080667,Castellví de Rosanes,65,2008,136,71
219,430430,"Catllar, el",75,2008,268,193
220,250714,Cava,-2,2008,1,3
221,171899,"Cellera de Ter, la",26,2008,103,77
222,170499,Celrà,130,2008,323,193
223,080673,Centelles,33,2008,269,236
224,082687,Cercs,28,2008,71,43
225,082665,Cerdanyola del Vallès,32,2008,3006,2974
226,080689,Cervelló,190,2008,676,486
227,250729,Cervera,66,2008,490,424
228,250735,Cervià de les Garrigues,-9,2008,33,42
229,170502,Cervià de Ter,26,2008,41,15
230,170519,Cistella,-12,2008,14,26
231,250740,Ciutadilla,2,2008,18,16
232,250753,Clariana de Cardener,4,2008,10,6
233,250766,"Cogul, el",-2,2008,5,7
234,170545,Colera,3,2008,35,32
235,250772,Coll de Nargó,10,2008,22,12
236,080692,Collbató,61,2008,252,191
237,430458,Colldejou,-2,2008,9,11
238,080706,Collsuspina,14,2008,27,13
239,170558,Colomers,-9,2008,5,14
240,251636,"Coma i la Pedra, la",7,2008,17,10
241,251615,Conca de Dalt,-2,2008,13,15
242,430461,Conesa,-8,2008,1,9
243,430477,Constantí,76,2008,487,411
244,080713,Copons,4,2008,15,11
245,430483,Corbera d'Ebre,14,2008,37,23
246,080728,Corbera de Llobregat,407,2008,1010,603
247,250788,Corbins,-26,2008,60,86
248,170577,Corçà,6,2008,74,68
249,080734,Cornellà de Llobregat,1681,2008,5983,4302
250,170561,Cornellà del Terri,-4,2008,94,98
251,430496,Cornudella de Montsant,10,2008,51,41
252,430509,Creixell,48,2008,310,262
253,170583,Crespià,-4,2008,25,29
254,179011,"Cruïlles, Monells i Sant Sadurní de l'Heura",10,2008,91,81
255,080749,Cubelles,260,2008,1251,991
256,250791,Cubells,9,2008,22,13
257,430516,Cunit,497,2008,1665,1168
258,170600,Darnius,13,2008,35,22
259,170617,Das,10,2008,19,9
260,439018,Deltebre,184,2008,584,400
261,080752,Dosrius,40,2008,293,253
262,430537,Duesaigües,7,2008,13,6
263,170622,"Escala, l'",355,2008,833,478
264,080765,Esparreguera,179,2008,1170,991
265,170638,Espinelves,-3,2008,3,6
266,250812,"Espluga Calba, l'",6,2008,28,22
267,430542,"Espluga de Francolí, l'",69,2008,260,191
268,080771,Esplugues de Llobregat,164,2008,3357,3193
269,170643,Espolla,-5,2008,20,25
270,170656,Esponellà,14,2008,34,20
271,250827,Espot,4,2008,20,16
272,080787,"Espunyola, l'",-12,2008,3,15
273,082541,"Esquirol, l'",1,2008,74,73
274,250886,Estamariu,3,2008,5,2
275,080790,"Estany, l'",0,2008,19,19
276,250851,Estaràs,-1,2008,5,6
277,250864,Esterri d'Àneu,76,2008,166,90
278,250870,Esterri de Cardós,2,2008,5,3
279,430555,Falset,37,2008,128,91
280,170059,"Far d'Empordà, el",12,2008,37,25
281,250899,Farrera,4,2008,14,10
282,430568,"Fatarella, la",-1,2008,30,31
283,430574,"Febró, la",-1,2008,0,1
284,081347,Figaró-Montmany,26,2008,104,78
285,080804,Fígols,0,2008,5,5
286,259084,Fígols i Alinyà,5,2008,15,10
287,430580,"Figuera, la",-9,2008,9,18
288,170669,Figueres,538,2008,3167,2629
289,430593,Figuerola del Camp,9,2008,24,15
290,170675,Flaçà,17,2008,75,58
291,430607,Flix,56,2008,179,123
292,250925,"Floresta, la",-20,2008,6,26
293,080826,Fogars de la Selva,30,2008,131,101
294,080811,Fogars de Montclús,6,2008,32,26
295,170681,Foixà,4,2008,9,5
296,080832,Folgueroles,32,2008,89,57
297,250931,Fondarella,-3,2008,23,26
298,080847,Fonollosa,37,2008,108,71
299,170694,Fontanals de Cerdanya,5,2008,27,22
300,170708,Fontanilles,3,2008,15,12
301,170715,Fontcoberta,42,2008,78,36
302,080850,Font-rubí,20,2008,88,68
303,250946,Foradada,6,2008,12,6
304,179026,Forallac,3,2008,107,104
305,430614,Forès,-4,2008,0,4
306,170736,Fornells de la Selva,170,2008,219,49
307,170741,Fortià,7,2008,31,24
308,080863,"Franqueses del Vallès, les",475,2008,1481,1006
309,430629,Freginals,4,2008,33,29
310,250962,"Fuliola, la",21,2008,62,41
311,250978,Fulleda,-2,2008,1,3
312,080902,Gaià,15,2008,25,10
313,430635,"Galera, la",36,2008,54,18
314,080879,Gallifa,1,2008,5,4
315,430640,Gandesa,77,2008,174,97
316,430653,Garcia,4,2008,39,35
317,430666,"Garidells, els",-5,2008,7,12
318,080885,"Garriga, la",175,2008,785,610
319,170754,Garrigàs,4,2008,25,21
320,170767,Garrigoles,-6,2008,6,12
321,170773,Garriguella,7,2008,61,54
322,080898,Gavà,553,2008,2862,2309
323,250984,Gavet de la Conca,1,2008,8,7
324,080919,Gelida,151,2008,472,321
325,170789,Ger,12,2008,42,30
326,259123,Gimenells i el Pla de la Font,11,2008,46,35
327,430672,Ginestar,-27,2008,56,83
328,170792,Girona,393,2008,7510,7117
329,080924,Gironella,73,2008,204,131
330,080930,Gisclareny,0,2008,2,2
331,430688,Godall,10,2008,27,17
332,250997,Golmés,37,2008,130,93
333,170806,Gombrèn,-4,2008,12,16
334,251001,Gósol,-9,2008,19,28
335,080945,"Granada, la",22,2008,112,90
336,251018,"Granadella, la",8,2008,40,32
337,080958,Granera,7,2008,8,1
338,251023,"Granja d'Escarp, la",-26,2008,27,53
339,080961,Granollers,-39,2008,4259,4298
340,251039,Granyanella,-13,2008,0,13
341,251057,Granyena de les Garrigues,5,2008,13,8
342,251044,Granyena de Segarra,-3,2008,0,3
343,430691,Gratallops,14,2008,20,6
344,080977,Gualba,63,2008,128,65
345,170813,Gualta,20,2008,47,27
346,080996,Guardiola de Berguedà,26,2008,88,62
347,430705,"Guiamets, els",3,2008,15,12
348,170828,Guils de Cerdanya,9,2008,46,37
349,251095,Guimerà,1,2008,15,14
350,259031,"Guingueta d'Àneu, la",-3,2008,26,29
351,251109,Guissona,483,2008,732,249
352,251116,Guixers,-1,2008,4,5
353,081000,Gurb,63,2008,123,60
354,430712,Horta de Sant Joan,17,2008,41,24
355,081017,"Hospitalet de Llobregat, l'",2164,2008,22414,20250
356,081629,"Hostalets de Pierola, els",148,2008,287,139
357,170834,Hostalric,89,2008,331,242
358,081022,Igualada,525,2008,2630,2105
359,251155,Isona i Conca Dellà,18,2008,54,36
360,170849,Isòvol,18,2008,34,16
361,251137,Ivars d'Urgell,4,2008,82,78
362,251121,Ivars de Noguera,16,2008,23,7
363,251142,Ivorra,-2,2008,2,4
364,170852,Jafre,31,2008,43,12
365,170865,"Jonquera, la",39,2008,336,297
366,081038,Jorba,32,2008,71,39
367,259101,Josa i Tuixén,-1,2008,13,14
368,170871,Juià,31,2008,61,30
369,251180,Juncosa,-5,2008,16,21
370,251193,Juneda,98,2008,188,90
371,251214,Les,18,2008,81,63
372,251229,Linyola,52,2008,182,130
373,081043,"Llacuna, la",18,2008,60,42
374,170887,Lladó,26,2008,50,24
375,251235,Lladorre,-6,2008,5,11
376,251240,Lladurs,-8,2008,2,10
377,081056,"Llagosta, la",113,2008,899,786
378,170890,Llagostera,190,2008,532,342
379,170904,Llambilles,17,2008,40,23
380,170911,Llanars,6,2008,41,35
381,170926,Llançà,121,2008,380,259
382,251253,Llardecans,-11,2008,5,16
383,251266,Llavorsí,5,2008,31,26
384,251207,Lleida,2411,2008,8856,6445
385,170932,Llers,22,2008,79,57
386,251272,Lles de Cerdanya,8,2008,19,11
387,081075,Lliçà d'Amunt,221,2008,811,590
388,081081,Lliçà de Vall,89,2008,350,261
389,251288,Llimiana,4,2008,8,4
390,081069,Llinars del Vallès,183,2008,670,487
391,170947,Llívia,74,2008,173,99
392,430727,"Lloar, el",-3,2008,2,5
393,251291,Llobera,1,2008,3,2
394,430733,Llorac,4,2008,8,4
395,430748,Llorenç del Penedès,25,2008,129,104
396,170950,Lloret de Mar,1417,2008,4369,2952
397,170963,"Llosses, les",1,2008,19,18
398,081094,Lluçà,6,2008,9,3
399,171024,Maçanet de Cabrenys,8,2008,37,29
400,171030,Maçanet de la Selva,165,2008,529,364
401,170979,Madremanya,1,2008,20,19
402,170985,Maià de Montcal,9,2008,31,22
403,251333,Maials,18,2008,41,23
404,251305,Maldà,-6,2008,11,17
405,081108,Malgrat de Mar,159,2008,1175,1016
406,081115,Malla,-6,2008,5,11
407,081120,Manlleu,-4,2008,1092,1096
408,081136,Manresa,828,2008,4561,3733
409,430764,Marçà,7,2008,29,22
410,430751,Margalef,3,2008,10,7
411,082423,Marganell,7,2008,22,15
412,081141,Martorell,289,2008,1972,1683
413,081154,Martorelles,-13,2008,280,293
414,430770,Mas de Barberans,-10,2008,12,22
415,171002,Masarac,-1,2008,22,23
416,430786,Masdenverge,14,2008,79,65
417,081167,"Masies de Roda, les",2,2008,41,39
418,081173,"Masies de Voltregà, les",26,2008,139,113
419,430799,Masllorenç,0,2008,31,31
420,081189,"Masnou, el",183,2008,1229,1046
421,430803,"Masó, la",5,2008,10,5
422,430810,Maspujols,105,2008,133,28
423,081192,Masquefa,90,2008,482,392
424,430825,"Masroig, el",22,2008,36,14
425,251312,Massalcoreig,-6,2008,18,24
426,171019,Massanes,7,2008,63,56
427,251327,Massoteres,-12,2008,16,28
428,081206,Matadepera,98,2008,371,273
429,081213,Mataró,1287,2008,6900,5613
430,081228,Mediona,54,2008,232,178
431,251348,Menàrguens,22,2008,55,33
432,170998,Meranges,5,2008,7,2
433,171058,Mieres,6,2008,28,22
434,430831,"Milà, el",0,2008,4,4
435,251351,Miralcamp,17,2008,74,57
436,430846,Miravet,18,2008,52,34
437,081385,Moià,33,2008,335,302
438,430859,"Molar, el",11,2008,20,9
439,081234,Molins de Rei,3,2008,1093,1090
440,251370,Mollerussa,480,2008,1324,844
441,171061,Mollet de Peralada,6,2008,8,2
442,081249,Mollet del Vallès,343,2008,3182,2839
443,171077,Molló,11,2008,21,10
444,251364,"Molsosa, la",-4,2008,0,4
445,081287,Monistrol de Calders,-12,2008,30,42
446,081271,Monistrol de Montserrat,41,2008,232,191
447,171096,Montagut i Oix,11,2008,71,60
448,430862,Montblanc,216,2008,522,306
449,430884,Montbrió del Camp,143,2008,227,84
450,081252,Montcada i Reixac,330,2008,2321,1991
451,081304,Montclar,-5,2008,2,7
452,251399,Montellà i Martinet,25,2008,55,30
453,081311,Montesquiu,30,2008,71,41
454,251403,Montferrer i Castellbò,23,2008,116,93
455,430897,Montferri,20,2008,50,30
456,251386,Montgai,1,2008,12,11
457,081265,Montgat,171,2008,624,453
458,081326,Montmajor,17,2008,26,9
459,081332,Montmaneu,-5,2008,6,11
460,430901,"Montmell, el",10,2008,135,125
461,081350,Montmeló,71,2008,434,363
462,251425,Montoliu de Lleida,-3,2008,19,22
463,251410,Montoliu de Segarra,6,2008,13,7
464,251431,Montornès de Segarra,-4,2008,1,5
465,081363,Montornès del Vallès,326,2008,1140,814
466,430918,Mont-ral,-5,2008,11,16
467,171100,Mont-ras,-13,2008,85,98
468,430923,Mont-roig del Camp,811,2008,1566,755
469,081379,Montseny,-1,2008,20,21
470,430939,Móra d'Ebre,209,2008,434,225
471,430944,Móra la Nova,-6,2008,117,123
472,430957,"Morell, el",180,2008,375,195
473,430960,"Morera de Montsant, la",3,2008,9,6
474,081290,Muntanyola,16,2008,38,22
475,081398,Mura,2,2008,14,12
476,251459,Nalec,-1,2008,1,2
477,250254,Naut Aran,0,2008,119,119
478,081402,Navarcles,122,2008,297,175
479,081419,Navàs,126,2008,329,203
480,171117,Navata,52,2008,103,51
481,251462,Navès,-3,2008,2,5
482,081424,"Nou de Berguedà, la",5,2008,6,1
483,430976,"Nou de Gaià, la",23,2008,36,13
484,430982,Nulles,4,2008,31,27
485,251484,Odèn,-5,2008,1,6
486,081430,Òdena,34,2008,213,179
487,171122,Ogassa,3,2008,7,4
488,081458,Olèrdola,48,2008,233,185
489,081461,Olesa de Bonesvalls,55,2008,174,119
490,081477,Olesa de Montserrat,205,2008,1221,1016
491,251497,Oliana,36,2008,124,88
492,251500,Oliola,-11,2008,7,18
493,251517,Olius,16,2008,50,34
494,081483,Olivella,167,2008,409,242
495,081496,Olost,22,2008,42,20
496,171143,Olot,475,2008,1941,1466
497,251522,"Oluges, les",-7,2008,1,8
498,081445,Olvan,6,2008,49,43
499,251538,"Omellons, els",8,2008,14,6
500,251543,"Omells de na Gaia, els",-2,2008,3,5
501,171156,Ordis,4,2008,22,18
502,251556,Organyà,18,2008,65,47
503,081509,Orís,-15,2008,6,21
504,081516,Oristà,6,2008,21,15
505,081521,Orpí,-6,2008,5,11
506,081537,Òrrius,5,2008,43,38
507,251569,Os de Balaguer,-5,2008,34,39
508,171169,Osor,-11,2008,0,11
509,251575,Ossó de Sió,-7,2008,0,7
510,081542,Pacs del Penedès,16,2008,58,42
511,081555,Palafolls,142,2008,568,426
512,171175,Palafrugell,154,2008,1267,1113
513,171181,Palamós,321,2008,1287,966
514,251581,"Palau d'Anglesola, el",59,2008,117,58
515,171194,Palau de Santa Eulàlia,7,2008,11,4
516,171215,Palau-sator,-3,2008,15,18
517,171208,Palau-saverdera,10,2008,113,103
518,081568,Palau-solità i Plegamans,100,2008,743,643
519,431009,"Pallaresos, els",108,2008,272,164
520,081574,Pallejà,53,2008,577,524
521,430995,"Palma d'Ebre, la",2,2008,11,9
522,089058,"Palma de Cervelló, la",-1,2008,158,159
523,171236,Palol de Revardit,-2,2008,15,17
524,171241,Pals,122,2008,277,155
525,081580,"Papiol, el",35,2008,208,173
526,171254,Pardines,-9,2008,2,11
527,081593,Parets del Vallès,91,2008,1054,963
528,171267,Parlavà,14,2008,21,7
529,431016,Passanant i Belltall,-15,2008,6,21
530,171289,Pau,-10,2008,46,56
531,431021,Paüls,-7,2008,10,17
532,171292,Pedret i Marzà,-1,2008,6,7
533,251641,Penelles,3,2008,22,19
534,171306,"Pera, la",-2,2008,26,28
535,081607,Perafita,4,2008,16,12
536,431037,Perafort,43,2008,105,62
537,171328,Peralada,37,2008,121,84
538,251654,Peramola,3,2008,25,22
539,431042,"Perelló, el",93,2008,181,88
540,081614,Piera,286,2008,962,676
541,431055,"Piles, les",-2,2008,10,12
542,081635,Pineda de Mar,204,2008,2001,1797
543,431068,"Pinell de Brai, el",8,2008,29,21
544,251667,Pinell de Solsonès,6,2008,9,3
545,251673,Pinós,-10,2008,5,15
546,431074,Pira,-1,2008,25,26
547,431080,"Pla de Santa Maria, el",94,2008,204,110
548,081640,"Pla del Penedès, el",52,2008,80,28
549,171334,"Planes d'Hostoles, les",-40,2008,39,79
550,171349,Planoles,5,2008,24,19
551,259118,"Plans de Sió, els",-15,2008,5,20
552,251689,"Poal, el",14,2008,31,17
553,251692,"Pobla de Cérvoles, la",5,2008,13,8
554,081653,"Pobla de Claramunt, la",33,2008,170,137
555,081666,"Pobla de Lillet, la",0,2008,61,61
556,431093,"Pobla de Mafumet, la",299,2008,423,124
557,431107,"Pobla de Massaluca, la",-2,2008,17,19
558,431114,"Pobla de Montornès, la",93,2008,235,142
559,251713,"Pobla de Segur, la",57,2008,238,181
560,431129,Poboleda,7,2008,27,20
561,081672,Polinyà,165,2008,513,348
562,431135,"Pont d'Armentera, el",19,2008,50,31
563,250306,"Pont de Bar, el",12,2008,13,1
564,171352,Pont de Molins,-8,2008,43,51
565,251734,"Pont de Suert, el",36,2008,168,132
566,081825,"Pont de Vilomara i Rocafort, el",49,2008,207,158
567,431418,Pontils,0,2008,17,17
568,081688,Pontons,-25,2008,57,82
569,171365,Pontós,-1,2008,19,20
570,251728,Ponts,32,2008,185,153
571,171371,Porqueres,20,2008,174,154
572,431140,Porrera,18,2008,28,10
573,171404,"Port de la Selva, el",-8,2008,69,77
574,171387,Portbou,20,2008,68,48
575,251749,"Portella, la",-44,2008,79,123
576,431153,Pradell de la Teixeta,-2,2008,3,5
577,431166,Prades,-1,2008,51,52
578,431172,Prat de Comte,11,2008,20,9
579,081691,"Prat de Llobregat, el",312,2008,2670,2358
580,431188,Pratdip,14,2008,66,52
581,081712,Prats de Lluçanès,9,2008,75,66
582,081705,"Prats de Rei, els",3,2008,24,21
583,251752,Prats i Sansor,-1,2008,14,15
584,251765,Preixana,16,2008,31,15
585,251771,Preixens,2,2008,20,18
586,082303,Premià de Dalt,93,2008,647,554
587,081727,Premià de Mar,120,2008,1421,1301
588,171390,"Preses, les",19,2008,96,77
589,251790,Prullans,3,2008,17,14
590,171411,Puigcerdà,-370,2008,434,804
591,081748,Puigdàlber,18,2008,44,26
592,251804,Puiggròs,-2,2008,14,16
593,431191,Puigpelat,21,2008,89,68
594,081751,Puig-reig,95,2008,310,215
595,251811,Puigverd d'Agramunt,0,2008,7,7
596,251826,Puigverd de Lleida,40,2008,90,50
597,081764,Pujalt,6,2008,13,7
598,081770,"Quar, la",1,2008,4,3
599,171426,Quart,69,2008,148,79
600,170433,Queralbs,6,2008,10,4
601,431205,Querol,-5,2008,58,63
602,171432,Rabós,20,2008,24,4
603,081786,Rajadell,5,2008,32,27
604,431212,Rasquera,4,2008,33,29
605,171447,Regencós,17,2008,28,11
606,081799,Rellinars,28,2008,75,47
607,431227,Renau,-5,2008,10,15
608,431233,Reus,-534,2008,4427,4961
609,251832,Rialp,20,2008,64,44
610,431248,"Riba, la",-1,2008,45,46
611,431251,Riba-roja d'Ebre,27,2008,65,38
612,259059,Ribera d'Ondara,-20,2008,8,28
613,251850,Ribera d'Urgellet,-16,2008,101,117
614,171450,Ribes de Freser,4,2008,101,97
615,171463,Riells i Viabrea,97,2008,332,235
616,431264,"Riera de Gaià, la",43,2008,109,66
617,251863,Riner,7,2008,21,14
618,171479,Ripoll,58,2008,459,401
619,081803,Ripollet,310,2008,2250,1940
620,259139,Riu de Cerdanya,-4,2008,8,12
621,171485,Riudarenes,57,2008,192,135
622,171498,Riudaura,13,2008,20,7
623,431270,Riudecanyes,34,2008,92,58
624,431286,Riudecols,73,2008,117,44
625,171501,Riudellots de la Selva,47,2008,109,62
626,431299,Riudoms,36,2008,287,251
627,171518,Riumors,8,2008,22,14
628,081810,"Roca del Vallès, la",91,2008,568,477
629,431303,Rocafort de Queralt,-1,2008,12,13
630,431310,Roda de Berà,194,2008,557,363
631,081831,Roda de Ter,88,2008,310,222
632,431325,Rodonyà,-12,2008,23,35
633,431331,Roquetes,203,2008,558,355
634,171523,Roses,620,2008,1630,1010
635,251898,Rosselló,119,2008,268,149
636,431346,"Rourell, el",6,2008,22,16
637,081846,Rubí,537,2008,4297,3760
638,081859,Rubió,16,2008,16,0
639,171539,Rupià,3,2008,16,13
640,089019,Rupit i Pruit,1,2008,19,18
641,081878,Sabadell,1575,2008,10309,8734
642,081884,Sagàs,-2,2008,5,7
643,251902,Salàs de Pallars,11,2008,33,22
644,081901,Saldes,5,2008,31,26
645,171544,Sales de Llierca,9,2008,16,7
646,081918,Sallent,64,2008,311,247
647,431359,Salomó,7,2008,33,26
648,439057,Salou,707,2008,3555,2848
649,171557,Salt,857,2008,3309,2452
650,251919,Sanaüja,4,2008,15,11
651,081944,Sant Adrià de Besòs,503,2008,2219,1716
652,081957,Sant Agustí de Lluçanès,-3,2008,5,8
653,081960,Sant Andreu de la Barca,-120,2008,1392,1512
654,081976,Sant Andreu de Llavaneres,155,2008,717,562
655,171576,Sant Andreu Salou,-4,2008,3,7
656,171833,Sant Aniol de Finestres,10,2008,20,10
657,081982,Sant Antoni de Vilamajor,113,2008,422,309
658,081995,Sant Bartomeu del Grau,-7,2008,75,82
659,082009,Sant Boi de Llobregat,793,2008,4241,3448
660,082016,Sant Boi de Lluçanès,8,2008,47,39
661,431362,Sant Carles de la Ràpita,250,2008,1064,814
662,082037,Sant Cebrià de Vallalta,64,2008,252,188
663,082021,Sant Celoni,185,2008,1015,830
664,082042,Sant Climent de Llobregat,68,2008,202,134
665,171582,Sant Climent Sescebes,16,2008,56,40
666,082055,Sant Cugat del Vallès,1493,2008,5569,4076
667,082068,Sant Cugat Sesgarrigues,4,2008,52,48
668,251961,Sant Esteve de la Sarga,-4,2008,7,11
669,082074,Sant Esteve de Palautordera,63,2008,207,144
670,082080,Sant Esteve Sesrovires,249,2008,573,324
671,171595,Sant Feliu de Buixalleu,4,2008,30,26
672,082107,Sant Feliu de Codines,22,2008,439,417
673,171609,Sant Feliu de Guíxols,143,2008,1424,1281
674,082114,Sant Feliu de Llobregat,-44,2008,1925,1969
675,171616,Sant Feliu de Pallerols,26,2008,86,60
676,082129,Sant Feliu Sasserra,5,2008,28,23
677,171621,Sant Ferriol,4,2008,19,15
678,082093,Sant Fost de Campsentelles,308,2008,649,341
679,082135,Sant Fruitós de Bages,147,2008,509,362
680,171637,Sant Gregori,82,2008,183,101
681,251924,Sant Guim de Freixenet,12,2008,74,62
682,251977,Sant Guim de la Plana,3,2008,5,2
683,171642,Sant Hilari Sacalm,37,2008,266,229
684,082153,Sant Hipòlit de Voltregà,15,2008,205,190
685,081939,Sant Iscle de Vallalta,18,2008,76,58
686,439023,Sant Jaume d'Enveja,37,2008,164,127
687,082166,Sant Jaume de Frontanyà,0,2008,3,3
688,171655,Sant Jaume de Llierca,8,2008,48,40
689,431378,Sant Jaume dels Domenys,34,2008,190,156
690,171674,Sant Joan de les Abadesses,0,2008,117,117
691,171680,Sant Joan de Mollet,3,2008,38,35
692,082188,Sant Joan de Vilatorrada,108,2008,539,431
693,082172,Sant Joan Despí,77,2008,1571,1494
694,171851,Sant Joan les Fonts,53,2008,155,102
695,171668,Sant Jordi Desvalls,20,2008,47,27
696,089030,Sant Julià de Cerdanyola,13,2008,22,9
697,171693,Sant Julià de Ramis,87,2008,234,147
698,082205,Sant Julià de Vilatorta,21,2008,121,100
699,179032,Sant Julià del Llor i Bonmatí,41,2008,97,56
700,082212,Sant Just Desvern,267,2008,926,659
701,082227,Sant Llorenç d'Hortons,95,2008,190,95
702,171714,Sant Llorenç de la Muga,-2,2008,8,10
703,251930,Sant Llorenç de Morunys,22,2008,60,38
704,082233,Sant Llorenç Savall,54,2008,172,118
705,082251,Sant Martí d'Albars,1,2008,3,2
706,082248,Sant Martí de Centelles,0,2008,76,76
707,171729,Sant Martí de Llémena,16,2008,52,36
708,259025,Sant Martí de Riucorb,5,2008,27,22
709,082264,Sant Martí de Tous,2,2008,34,32
710,082270,Sant Martí Sarroca,59,2008,227,168
711,082286,Sant Martí Sesgueioles,-1,2008,18,19
712,171735,Sant Martí Vell,11,2008,22,11
713,082299,Sant Mateu de Bages,-10,2008,22,32
714,171740,Sant Miquel de Campmajor,4,2008,12,8
715,171753,Sant Miquel de Fluvià,19,2008,66,47
716,171766,Sant Mori,2,2008,9,7
717,171772,Sant Pau de Segúries,17,2008,54,37
718,082310,Sant Pere de Ribes,526,2008,2208,1682
719,082325,Sant Pere de Riudebitlles,1,2008,143,142
720,082331,Sant Pere de Torelló,65,2008,132,67
721,082346,Sant Pere de Vilamajor,100,2008,295,195
722,171788,Sant Pere Pescador,58,2008,211,153
723,081897,Sant Pere Sallavinera,-1,2008,3,4
724,082359,Sant Pol de Mar,119,2008,401,282
725,082362,Sant Quintí de Mediona,-18,2008,118,136
726,082378,Sant Quirze de Besora,48,2008,106,58
727,082384,Sant Quirze del Vallès,104,2008,866,762
728,082397,Sant Quirze Safaja,30,2008,70,40
729,251945,Sant Ramon,22,2008,43,21
730,082401,Sant Sadurní d'Anoia,272,2008,772,500
731,082418,Sant Sadurní d'Osormort,11,2008,15,4
732,080983,Sant Salvador de Guardiola,32,2008,204,172
733,082628,Sant Vicenç de Castellet,325,2008,722,397
734,082649,Sant Vicenç de Montalt,174,2008,478,304
735,082652,Sant Vicenç de Torelló,21,2008,88,67
736,082634,Sant Vicenç dels Horts,95,2008,1357,1262
737,431384,Santa Bàrbara,-28,2008,225,253
738,082439,Santa Cecília de Voltregà,-5,2008,8,13
739,082444,Santa Coloma de Cervelló,12,2008,387,375
740,171805,Santa Coloma de Farners,287,2008,682,395
741,082457,Santa Coloma de Gramenet,-326,2008,11163,11489
742,431397,Santa Coloma de Queralt,25,2008,135,110
743,171812,Santa Cristina d'Aro,276,2008,542,266
744,082460,Santa Eugènia de Berga,-2,2008,119,121
745,082476,Santa Eulàlia de Riuprimer,40,2008,72,32
746,082482,Santa Eulàlia de Ronçana,101,2008,408,307
747,082495,Santa Fe del Penedès,-4,2008,13,17
748,171827,Santa Llogaia d'Àlguema,9,2008,33,24
749,082508,Santa Margarida de Montbui,7,2008,546,539
750,082515,Santa Margarida i els Monjos,131,2008,621,490
751,082589,Santa Maria d'Oló,-8,2008,51,59
752,082536,Santa Maria de Besora,-4,2008,6,10
753,082567,Santa Maria de Martorelles,42,2008,85,43
754,082554,Santa Maria de Merlès,2,2008,6,4
755,082573,Santa Maria de Miralles,2,2008,7,5
756,082592,Santa Maria de Palautordera,199,2008,607,408
757,431401,Santa Oliva,76,2008,269,193
758,171848,Santa Pau,18,2008,66,48
759,082606,Santa Perpètua de Mogoda,408,2008,1609,1201
760,082613,Santa Susanna,119,2008,320,201
761,081923,Santpedor,37,2008,347,310
762,431423,Sarral,27,2008,127,100
763,171864,Sarrià de Ter,84,2008,313,229
764,252017,Sarroca de Bellera,-2,2008,8,10
765,252000,Sarroca de Lleida,-4,2008,9,13
766,171870,"Saus, Camallera i Llampaies",3,2008,43,40
767,431439,Savallà del Comtat,0,2008,3,3
768,431444,"Secuita, la",39,2008,102,63
769,171886,"Selva de Mar, la",10,2008,17,7
770,431457,"Selva del Camp, la",140,2008,325,185
771,431460,Senan,0,2008,3,3
772,430445,"Sénia, la",-49,2008,378,427
773,252022,Senterada,4,2008,18,14
774,250352,"Sentiu de Sió, la",-12,2008,18,30
775,082671,Sentmenat,207,2008,519,312
776,171903,Serinyà,3,2008,50,47
777,252043,Seròs,-35,2008,68,103
778,171910,Serra de Daró,-1,2008,14,15
779,171925,Setcases,7,2008,11,4
780,252038,"Seu d'Urgell, la",76,2008,777,701
781,082690,Seva,87,2008,208,121
782,252056,Sidamon,17,2008,46,29
783,171931,Sils,219,2008,476,257
784,082704,Sitges,437,2008,2235,1798
785,170524,Siurana,-3,2008,16,19
786,082711,Sobremunt,-4,2008,4,8
787,252069,"Soleràs, el",-17,2008,9,26
788,431476,Solivella,8,2008,29,21
789,252075,Solsona,-39,2008,457,496
790,082726,Sora,6,2008,13,7
791,252081,Soriguera,7,2008,36,29
792,252094,Sort,-12,2008,165,177
793,252108,Soses,35,2008,112,77
794,082732,Subirats,39,2008,195,156
795,252115,Sudanell,26,2008,49,23
796,252120,Sunyer,5,2008,14,9
797,082747,Súria,7,2008,203,196
798,171946,Susqueda,4,2008,14,10
799,082763,Tagamanent,8,2008,26,18
800,082779,Talamanca,10,2008,21,11
801,252154,Talarn,-6,2008,35,41
802,252167,Talavera,-3,2008,6,9
803,171959,"Tallada d'Empordà, la",17,2008,30,13
804,082785,Taradell,14,2008,223,209
805,431482,Tarragona,2195,2008,8666,6471
806,252173,Tàrrega,199,2008,1079,880
807,252189,Tarrés,0,2008,6,6
808,252192,Tarroja de Segarra,-1,2008,1,2
809,082750,Tavèrnoles,-15,2008,13,28
810,082802,Tavertet,11,2008,18,7
811,082819,Teià,102,2008,333,231
812,252206,Térmens,42,2008,99,57
813,171962,Terrades,19,2008,27,8
814,082798,Terrassa,3272,2008,11558,8286
815,082824,Tiana,55,2008,342,287
816,252213,Tírvia,3,2008,13,10
817,252228,Tiurana,9,2008,14,5
818,431495,Tivenys,25,2008,39,14
819,431508,Tivissa,-17,2008,54,71
820,082830,Tona,125,2008,432,307
821,252234,Torà,20,2008,97,77
822,082845,Tordera,503,2008,1289,786
823,082858,Torelló,61,2008,599,538
824,252249,"Torms, els",-5,2008,3,8
825,252252,Tornabous,6,2008,36,30
826,252271,"Torre de Cabdella, la",18,2008,51,33
827,082861,"Torre de Claramunt, la",87,2008,265,178
828,431515,"Torre de Fontaubella, la",11,2008,15,4
829,431520,"Torre de l'Espanyol, la",28,2008,52,24
830,252265,Torrebesses,3,2008,4,1
831,431536,Torredembarra,123,2008,1114,991
832,252287,Torrefarrera,181,2008,339,158
833,259078,Torrefeta i Florejacs,0,2008,28,28
834,252304,Torregrossa,22,2008,93,71
835,252311,Torrelameu,35,2008,67,32
836,082877,Torrelavit,80,2008,120,40
837,082883,Torrelles de Foix,0,2008,249,249
838,082896,Torrelles de Llobregat,168,2008,378,210
839,171978,Torrent,7,2008,14,7
840,252326,Torres de Segre,15,2008,101,86
841,252332,Torre-serona,1,2008,23,22
842,171984,Torroella de Fluvià,3,2008,65,62
843,171997,Torroella de Montgrí,135,2008,880,745
844,431541,Torroja del Priorat,-2,2008,9,11
845,172001,Tortellà,2,2008,37,35
846,431554,Tortosa,-682,2008,1275,1957
847,172018,Toses,1,2008,15,14
848,172023,Tossa de Mar,151,2008,427,276
849,252347,Tremp,156,2008,455,299
850,172044,Ullà,8,2008,140,132
851,082900,Ullastrell,92,2008,165,73
852,172057,Ullastret,10,2008,24,14
853,431567,Ulldecona,184,2008,470,286
854,431573,Ulldemolins,13,2008,33,20
855,172039,Ultramort,4,2008,13,9
856,172060,Urús,7,2008,16,9
857,082917,Vacarisses,64,2008,336,272
858,170144,"Vajol, la",-3,2008,5,8
859,172076,"Vall d'en Bas, la",52,2008,126,74
860,172082,"Vall de Bianya, la",11,2008,70,59
861,250432,"Vall de Boí, la",9,2008,72,63
862,259010,Vall de Cardós,17,2008,44,27
863,082922,Vallbona d'Anoia,35,2008,89,54
864,252385,Vallbona de les Monges,5,2008,13,8
865,082938,Vallcebre,-2,2008,9,11
866,431589,Vallclara,-1,2008,15,16
867,252402,Vallfogona de Balaguer,35,2008,113,78
868,171707,Vallfogona de Ripollès,-2,2008,14,16
869,431592,Vallfogona de Riucorb,-4,2008,6,10
870,082943,Vallgorguina,34,2008,214,180
871,082956,Vallirana,247,2008,866,619
872,172095,Vall-llobrega,16,2008,52,36
873,431606,Vallmoll,6,2008,120,114
874,082969,Vallromanes,59,2008,136,77
875,431613,Valls,240,2008,1425,1185
876,259062,"Valls d'Aguilar, les",2,2008,15,13
877,252398,"Valls de Valira, les",0,2008,79,79
878,431628,Vandellòs i l'Hospitalet de l'Infant,60,2008,484,424
879,259097,"Vansa i Fórnols, la",19,2008,22,3
880,082975,Veciana,-3,2008,10,13
881,431634,"Vendrell, el",748,2008,2975,2227
882,172109,Ventalló,21,2008,78,57
883,252424,Verdú,3,2008,42,39
884,172116,Verges,-29,2008,52,81
885,431649,Vespella de Gaià,6,2008,40,34
886,082981,Vic,618,2008,2759,2141
887,172121,Vidrà,-4,2008,1,5
888,172137,Vidreres,136,2008,600,464
889,252430,Vielha e Mijaran,37,2008,538,501
890,431652,Vilabella,-6,2008,27,33
891,172142,Vilabertran,19,2008,39,20
892,172155,Vilablareix,-14,2008,68,82
893,082994,Vilada,-7,2008,18,25
894,172174,Viladamat,29,2008,40,11
895,172168,Viladasens,6,2008,13,7
896,083015,Viladecans,243,2008,3130,2887
897,083008,Viladecavalls,130,2008,407,277
898,172180,Vilademuls,10,2008,66,56
899,172207,Viladrau,34,2008,84,50
900,172214,Vilafant,85,2008,291,206
901,083054,Vilafranca del Penedès,750,2008,2620,1870
902,252445,Vilagrassa,6,2008,37,31
903,172235,Vilajuïga,11,2008,63,52
904,431750,Vilalba dels Arcs,6,2008,21,15
905,083067,Vilalba Sasserra,56,2008,101,45
906,252458,Vilaller,14,2008,54,40
907,172240,Vilallonga de Ter,2,2008,32,30
908,431665,Vilallonga del Camp,92,2008,174,82
909,172253,Vilamacolum,2,2008,28,26
910,172266,Vilamalla,-9,2008,64,73
911,172272,Vilamaniscle,-6,2008,5,11
912,252477,Vilamòs,-16,2008,7,23
913,172288,Vilanant,10,2008,24,14
914,431671,Vilanova d'Escornalbou,23,2008,49,26
915,252483,Vilanova de Bellpuig,15,2008,49,34
916,252496,Vilanova de l'Aguda,1,2008,8,7
917,252542,Vilanova de la Barca,83,2008,150,67
918,252509,Vilanova de Meià,13,2008,26,13
919,431687,Vilanova de Prades,0,2008,6,6
920,083036,Vilanova de Sau,1,2008,11,10
921,252516,Vilanova de Segrià,24,2008,70,46
922,083020,Vilanova del Camí,151,2008,810,659
923,089024,Vilanova del Vallès,146,2008,315,169
924,083073,Vilanova i la Geltrú,733,2008,3864,3131
925,431690,Vilaplana,18,2008,31,13
926,431704,Vila-rodona,35,2008,109,74
927,172305,Vila-sacra,45,2008,73,28
928,252521,Vila-sana,22,2008,38,16
929,431711,Vila-seca,686,2008,2029,1343
930,082140,Vilassar de Dalt,42,2008,419,377
931,082191,Vilassar de Mar,291,2008,1246,955
932,172229,Vilaür,-2,2008,6,8
933,431726,Vilaverd,1,2008,37,36
934,431732,"Vilella Alta, la",1,2008,4,3
935,431747,"Vilella Baixa, la",5,2008,20,15
936,172333,Vilobí d'Onyar,43,2008,181,138
937,083041,Vilobí del Penedès,0,2008,54,54
938,172327,Vilopriu,1,2008,10,9
939,252537,"Vilosell, el",-2,2008,14,16
940,431763,Vimbodí i Poblet,16,2008,64,48
941,252555,Vinaixa,1,2008,27,26
942,431779,Vinebre,-7,2008,23,30
943,431785,Vinyols i els Arcs,88,2008,210,122
944,083089,Viver i Serrateix,-5,2008,5,10
945,430521,Xerta,0,2008,36,36
0,250019,Abella de la Conca,-2,2009,7,9
1,080018,Abrera,-96,2009,574,670
2,250024,Àger,19,2009,43,24
3,250030,Agramunt,-15,2009,260,275
4,080023,Aguilar de Segarra,-3,2009,7,10
5,170010,Agullana,27,2009,82,55
6,080142,Aiguafreda,38,2009,174,136
7,430017,Aiguamúrcia,5,2009,64,59
8,170025,Aiguaviva,15,2009,44,29
9,250387,Aitona,38,2009,184,146
10,250045,"Alamús, els",1,2009,25,24
11,250058,Alàs i Cerc,3,2009,20,17
12,250061,"Albagés, l'",-10,2009,13,23
13,170031,Albanyà,-2,2009,9,11
14,250077,Albatàrrec,92,2009,230,138
15,250083,Albesa,48,2009,84,36
16,250096,"Albi, l'",11,2009,34,23
17,430022,Albinyana,38,2009,176,138
18,430038,"Albiol, l'",10,2009,23,13
19,170046,Albons,38,2009,58,20
20,430043,Alcanar,5,2009,484,479
21,250100,Alcanó,-2,2009,4,6
22,250117,Alcarràs,187,2009,659,472
23,250122,Alcoletge,123,2009,258,135
24,430056,Alcover,39,2009,246,207
25,439044,"Aldea, l'",126,2009,295,169
26,430069,Aldover,-12,2009,29,41
27,430075,"Aleixar, l'",9,2009,29,20
28,080039,Alella,157,2009,608,451
29,430081,Alfara de Carles,1,2009,11,10
30,250138,Alfarràs,0,2009,136,136
31,250143,Alfés,22,2009,34,12
32,430094,Alforja,80,2009,175,95
33,250156,Algerri,-11,2009,8,19
34,250169,Alguaire,-16,2009,152,168
35,250175,Alins,13,2009,16,3
36,430108,Alió,0,2009,11,11
37,250194,Almacelles,73,2009,336,263
38,250208,Almatret,10,2009,27,17
39,250215,Almenar,-23,2009,159,182
40,430115,Almoster,24,2009,70,46
41,250220,Alòs de Balaguer,0,2009,4,4
42,170062,Alp,-11,2009,136,147
43,080044,Alpens,-7,2009,12,19
44,250236,Alpicat,9,2009,260,251
45,250241,Alt Àneu,14,2009,24,10
46,430120,Altafulla,13,2009,296,283
47,170078,Amer,-2,2009,100,102
48,430136,"Ametlla de Mar, l'",17,2009,404,387
49,080057,"Ametlla del Vallès, l'",158,2009,551,393
50,439060,"Ampolla, l'",86,2009,270,184
51,430141,Amposta,111,2009,1073,962
52,170084,Anglès,-20,2009,263,283
53,250273,Anglesola,6,2009,48,42
54,250292,Arbeca,16,2009,86,70
55,430167,"Arboç, l'",9,2009,369,360
56,430154,Arbolí,0,2009,3,3
57,170097,Arbúcies,55,2009,318,263
58,080060,Arenys de Mar,68,2009,929,861
59,080076,Arenys de Munt,110,2009,440,330
60,170101,Argelaguer,-19,2009,17,36
61,080082,Argençola,3,2009,17,14
62,430173,"Argentera, l'",3,2009,7,4
63,080095,Argentona,38,2009,508,470
64,170118,"Armentera, l'",17,2009,59,42
65,430189,Arnes,20,2009,35,15
66,250313,Arres,-7,2009,2,9
67,250328,Arsèguel,13,2009,13,0
68,080109,Artés,58,2009,308,250
69,250334,Artesa de Lleida,8,2009,68,60
70,250349,Artesa de Segre,26,2009,163,137
71,430192,Ascó,38,2009,88,50
72,250365,Aspa,-7,2009,5,12
73,250371,"Avellanes i Santa Linya, les",-1,2009,23,24
74,080116,Avià,11,2009,105,94
75,080121,Avinyó,58,2009,132,74
76,170123,Avinyonet de Puigventós,32,2009,92,60
77,080137,Avinyonet del Penedès,5,2009,104,99
78,080155,Badalona,-1476,2009,14857,16333
79,089045,Badia del Vallès,-80,2009,567,647
80,080168,Bagà,15,2009,125,110
81,250390,Baix Pallars,-7,2009,17,24
82,250404,Balaguer,-44,2009,881,925
83,080174,Balenyà,-34,2009,188,222
84,080180,Balsareny,8,2009,142,134
85,430206,Banyeres del Penedès,-18,2009,169,187
86,170157,Banyoles,343,2009,1084,741
87,250411,Barbens,11,2009,54,43
88,430213,Barberà de la Conca,4,2009,28,24
89,082520,Barberà del Vallès,393,2009,1949,1556
90,080193,Barcelona,-9314,2009,97777,107091
91,250426,"Baronia de Rialb, la",-20,2009,4,24
92,170160,Bàscara,5,2009,54,49
93,250447,Bassella,8,2009,12,4
94,430228,Batea,12,2009,46,34
95,250450,Bausen,-2,2009,0,2
96,080207,Begues,45,2009,323,278
97,170139,Begur,-49,2009,219,268
98,250463,Belianes,1,2009,15,14
99,251706,Bellaguarda,-1,2009,7,8
100,170182,Bellcaire d'Empordà,3,2009,39,36
101,250479,Bellcaire d'Urgell,34,2009,74,40
102,250485,Bell-lloc d'Urgell,8,2009,102,94
103,250498,Bellmunt d'Urgell,-6,2009,1,7
104,430234,Bellmunt del Priorat,0,2009,15,15
105,080214,Bellprat,4,2009,9,5
106,250501,Bellpuig,34,2009,284,250
107,430249,Bellvei,86,2009,218,132
108,250518,Bellver de Cerdanya,36,2009,166,130
109,250523,Bellvís,47,2009,153,106
110,250539,Benavent de Segrià,20,2009,92,72
111,430252,Benifallet,0,2009,11,11
112,430265,Benissanet,26,2009,65,39
113,080229,Berga,-26,2009,816,842
114,170195,Besalú,6,2009,109,103
115,170209,Bescanó,97,2009,242,145
116,170216,Beuda,0,2009,18,18
117,080235,Bigues i Riells del Fai,131,2009,508,377
118,250557,Biosca,-8,2009,7,15
119,170221,"Bisbal d'Empordà, la",77,2009,575,498
120,430271,"Bisbal de Falset, la",-3,2009,10,13
121,430287,"Bisbal del Penedès, la",-32,2009,192,224
122,172348,Biure,-1,2009,5,6
123,430290,Blancafort,-2,2009,21,23
124,170237,Blanes,-113,2009,2240,2353
125,170293,Boadella i les Escaules,15,2009,24,9
126,170242,Bolvir,14,2009,36,22
127,430304,Bonastre,-15,2009,54,69
128,250576,"Bòrdes, Es",7,2009,30,23
129,170255,Bordils,-7,2009,110,117
130,250582,"Borges Blanques, les",-4,2009,252,256
131,430311,"Borges del Camp, les",24,2009,117,93
132,170268,Borrassà,6,2009,40,34
133,080240,Borredà,-2,2009,41,43
134,250595,Bossòst,-43,2009,77,120
135,430326,Bot,-4,2009,17,21
136,430332,Botarell,43,2009,86,43
137,250560,Bovera,0,2009,7,7
138,430347,Bràfim,18,2009,56,38
139,170274,Breda,-15,2009,154,169
140,080253,"Bruc, el",46,2009,169,123
141,080266,"Brull, el",0,2009,19,19
142,170280,Brunyola i Sant Martí Sapresa,0,2009,16,16
143,430350,Cabacés,10,2009,18,8
144,250609,Cabanabona,2,2009,6,4
145,170314,Cabanelles,1,2009,16,15
146,170307,Cabanes,-14,2009,42,56
147,080272,"Cabanyes, les",10,2009,49,39
148,250616,Cabó,2,2009,4,2
149,430363,Cabra del Camp,26,2009,99,73
150,080288,Cabrera d'Anoia,22,2009,106,84
151,080291,Cabrera de Mar,65,2009,269,204
152,080305,Cabrils,129,2009,422,293
153,170329,Cadaqués,47,2009,164,117
154,080312,Calaf,-28,2009,162,190
155,430379,Calafell,283,2009,2530,2247
156,080348,Calders,31,2009,79,48
157,080327,Caldes d'Estrac,3,2009,253,250
158,170335,Caldes de Malavella,195,2009,547,352
159,080333,Caldes de Montbui,132,2009,865,733
160,080351,Calella,46,2009,1445,1399
161,080370,Calldetenes,34,2009,106,72
162,080386,Callús,85,2009,166,81
163,080364,Calonge de Segarra,-1,2009,4,5
164,170340,Calonge i Sant Antoni,101,2009,875,774
165,250621,Camarasa,3,2009,27,24
166,439039,Camarles,59,2009,155,96
167,430385,Cambrils,529,2009,2556,2027
168,170353,Camós,-11,2009,20,31
169,170366,Campdevànol,11,2009,141,130
170,170372,Campelles,3,2009,12,9
171,080399,Campins,25,2009,49,24
172,170388,Campllong,38,2009,55,17
173,170391,Camprodon,-34,2009,146,180
174,250637,Canejan,1,2009,3,2
175,170405,Canet d'Adri,9,2009,37,28
176,080403,Canet de Mar,275,2009,883,608
177,080410,Canovelles,-158,2009,1152,1310
178,080425,Cànoves i Samalús,60,2009,205,145
179,170412,Cantallops,0,2009,16,16
180,080431,Canyelles,67,2009,330,263
181,430398,Capafonts,8,2009,12,4
182,430402,Capçanes,14,2009,27,13
183,080446,Capellades,-21,2009,231,252
184,170427,Capmany,23,2009,34,11
185,080459,Capolat,4,2009,8,4
186,080462,Cardedeu,211,2009,944,733
187,080478,Cardona,24,2009,138,114
188,080484,Carme,-6,2009,27,33
189,430419,Caseres,5,2009,10,5
190,170448,Cassà de la Selva,120,2009,516,396
191,080497,Casserres,3,2009,80,77
192,080575,Castell de l'Areny,1,2009,1,0
193,259046,Castell de Mur,5,2009,11,6
194,250642,Castellar de la Ribera,-4,2009,3,7
195,080522,Castellar de n'Hug,-9,2009,10,19
196,080500,Castellar del Riu,7,2009,22,15
197,080517,Castellar del Vallès,43,2009,1003,960
198,080538,Castellbell i el Vilar,44,2009,254,210
199,080543,Castellbisbal,151,2009,669,518
200,080556,Castellcir,38,2009,69,31
201,250674,Castelldans,4,2009,55,51
202,080569,Castelldefels,-89,2009,4576,4665
203,080581,Castellet i la Gornal,2,2009,176,174
204,170464,Castellfollit de la Roca,4,2009,65,61
205,080608,Castellfollit de Riubregós,4,2009,11,7
206,080594,Castellfollit del Boix,-17,2009,14,31
207,080615,Castellgalí,25,2009,169,144
208,080620,Castellnou de Bages,43,2009,83,40
209,250680,Castellnou de Seana,3,2009,33,30
210,170470,Castelló d'Empúries,86,2009,1077,991
211,250693,Castelló de Farfanya,6,2009,33,27
212,080636,Castellolí,14,2009,27,13
213,170486,Castell-Platja d'Aro,48,2009,1070,1022
214,250707,Castellserà,-16,2009,38,54
215,080641,Castellterçol,18,2009,143,125
216,430424,Castellvell del Camp,65,2009,157,92
217,080654,Castellví de la Marca,-32,2009,64,96
218,080667,Castellví de Rosanes,40,2009,114,74
219,430430,"Catllar, el",47,2009,256,209
220,250714,Cava,6,2009,9,3
221,171899,"Cellera de Ter, la",-23,2009,56,79
222,170499,Celrà,62,2009,276,214
223,080673,Centelles,42,2009,309,267
224,082687,Cercs,0,2009,84,84
225,082665,Cerdanyola del Vallès,-449,2009,2608,3057
226,080689,Cervelló,155,2009,591,436
227,250729,Cervera,-75,2009,460,535
228,250735,Cervià de les Garrigues,-25,2009,25,50
229,170502,Cervià de Ter,2,2009,34,32
230,170519,Cistella,6,2009,19,13
231,250740,Ciutadilla,-5,2009,10,15
232,250753,Clariana de Cardener,-3,2009,4,7
233,250766,"Cogul, el",-3,2009,6,9
234,170545,Colera,-7,2009,31,38
235,250772,Coll de Nargó,-11,2009,24,35
236,080692,Collbató,36,2009,261,225
237,430458,Colldejou,0,2009,9,9
238,080706,Collsuspina,0,2009,25,25
239,170558,Colomers,7,2009,15,8
240,251636,"Coma i la Pedra, la",-10,2009,10,20
241,251615,Conca de Dalt,-1,2009,21,22
242,430461,Conesa,-1,2009,9,10
243,430477,Constantí,-87,2009,272,359
244,080713,Copons,3,2009,12,9
245,430483,Corbera d'Ebre,10,2009,40,30
246,080728,Corbera de Llobregat,233,2009,867,634
247,250788,Corbins,26,2009,76,50
248,170577,Corçà,13,2009,87,74
249,080734,Cornellà de Llobregat,95,2009,5008,4913
250,170561,Cornellà del Terri,36,2009,120,84
251,430496,Cornudella de Montsant,26,2009,69,43
252,430509,Creixell,68,2009,313,245
253,170583,Crespià,-1,2009,14,15
254,179011,"Cruïlles, Monells i Sant Sadurní de l'Heura",-30,2009,59,89
255,080749,Cubelles,152,2009,1262,1110
256,250791,Cubells,3,2009,18,15
257,430516,Cunit,246,2009,1489,1243
258,170600,Darnius,-4,2009,35,39
259,170617,Das,-4,2009,24,28
260,439018,Deltebre,144,2009,471,327
261,080752,Dosrius,43,2009,331,288
262,430537,Duesaigües,4,2009,22,18
263,170622,"Escala, l'",240,2009,713,473
264,080765,Esparreguera,75,2009,1034,959
265,170638,Espinelves,4,2009,8,4
266,250812,"Espluga Calba, l'",0,2009,18,18
267,430542,"Espluga de Francolí, l'",-1,2009,172,173
268,080771,Esplugues de Llobregat,-370,2009,3008,3378
269,170643,Espolla,-6,2009,15,21
270,170656,Esponellà,4,2009,25,21
271,250827,Espot,-2,2009,18,20
272,080787,"Espunyola, l'",5,2009,12,7
273,082541,"Esquirol, l'",-33,2009,56,89
274,250886,Estamariu,5,2009,10,5
275,080790,"Estany, l'",0,2009,16,16
276,250851,Estaràs,0,2009,15,15
277,250864,Esterri d'Àneu,-20,2009,98,118
278,250870,Esterri de Cardós,-1,2009,1,2
279,430555,Falset,10,2009,116,106
280,170059,"Far d'Empordà, el",9,2009,28,19
281,250899,Farrera,0,2009,6,6
282,430568,"Fatarella, la",11,2009,27,16
283,430574,"Febró, la",-2,2009,1,3
284,081347,Figaró-Montmany,22,2009,78,56
285,080804,Fígols,7,2009,7,0
286,259084,Fígols i Alinyà,4,2009,9,5
287,430580,"Figuera, la",-8,2009,3,11
288,170669,Figueres,13,2009,2887,2874
289,430593,Figuerola del Camp,4,2009,22,18
290,170675,Flaçà,-2,2009,60,62
291,430607,Flix,-13,2009,144,157
292,250925,"Floresta, la",-3,2009,6,9
293,080826,Fogars de la Selva,-2,2009,118,120
294,080811,Fogars de Montclús,-10,2009,34,44
295,170681,Foixà,-7,2009,12,19
296,080832,Folgueroles,-6,2009,66,72
297,250931,Fondarella,4,2009,45,41
298,080847,Fonollosa,-9,2009,63,72
299,170694,Fontanals de Cerdanya,-3,2009,26,29
300,170708,Fontanilles,-3,2009,6,9
301,170715,Fontcoberta,31,2009,77,46
302,080850,Font-rubí,-10,2009,74,84
303,250946,Foradada,-2,2009,8,10
304,179026,Forallac,15,2009,101,86
305,430614,Forès,0,2009,2,2
306,170736,Fornells de la Selva,41,2009,116,75
307,170741,Fortià,1,2009,41,40
308,080863,"Franqueses del Vallès, les",210,2009,1333,1123
309,430629,Freginals,4,2009,24,20
310,250962,"Fuliola, la",34,2009,73,39
311,250978,Fulleda,-11,2009,1,12
312,080902,Gaià,7,2009,16,9
313,430635,"Galera, la",15,2009,44,29
314,080879,Gallifa,1,2009,12,11
315,430640,Gandesa,-10,2009,122,132
316,430653,Garcia,-1,2009,23,24
317,430666,"Garidells, els",-18,2009,3,21
318,080885,"Garriga, la",46,2009,690,644
319,170754,Garrigàs,-18,2009,38,56
320,170767,Garrigoles,0,2009,10,10
321,170773,Garriguella,-1,2009,44,45
322,080898,Gavà,270,2009,2696,2426
323,250984,Gavet de la Conca,5,2009,23,18
324,080919,Gelida,116,2009,452,336
325,170789,Ger,4,2009,37,33
326,259123,Gimenells i el Pla de la Font,-9,2009,35,44
327,430672,Ginestar,-20,2009,43,63
328,170792,Girona,-930,2009,6262,7192
329,080924,Gironella,104,2009,290,186
330,080930,Gisclareny,-1,2009,1,2
331,430688,Godall,-17,2009,17,34
332,250997,Golmés,9,2009,145,136
333,170806,Gombrèn,-7,2009,10,17
334,251001,Gósol,5,2009,20,15
335,080945,"Granada, la",-20,2009,96,116
336,251018,"Granadella, la",18,2009,38,20
337,080958,Granera,1,2009,1,0
338,251023,"Granja d'Escarp, la",1,2009,28,27
339,080961,Granollers,-814,2009,3984,4798
340,251039,Granyanella,-10,2009,3,13
341,251057,Granyena de les Garrigues,3,2009,9,6
342,251044,Granyena de Segarra,-3,2009,4,7
343,430691,Gratallops,-1,2009,12,13
344,080977,Gualba,37,2009,127,90
345,170813,Gualta,-7,2009,23,30
346,080996,Guardiola de Berguedà,26,2009,69,43
347,430705,"Guiamets, els",5,2009,22,17
348,170828,Guils de Cerdanya,31,2009,71,40
349,251095,Guimerà,5,2009,11,6
350,259031,"Guingueta d'Àneu, la",-14,2009,38,52
351,251109,Guissona,94,2009,517,423
352,251116,Guixers,-2,2009,6,8
353,081000,Gurb,39,2009,129,90
354,430712,Horta de Sant Joan,-6,2009,32,38
355,081017,"Hospitalet de Llobregat, l'",2047,2009,20933,18886
356,081629,"Hostalets de Pierola, els",112,2009,302,190
357,170834,Hostalric,-5,2009,290,295
358,081022,Igualada,161,2009,2054,1893
359,251155,Isona i Conca Dellà,1,2009,52,51
360,170849,Isòvol,16,2009,41,25
361,251137,Ivars d'Urgell,-23,2009,77,100
362,251121,Ivars de Noguera,-2,2009,11,13
363,251142,Ivorra,-12,2009,2,14
364,170852,Jafre,-2,2009,22,24
365,170865,"Jonquera, la",-68,2009,288,356
366,081038,Jorba,-1,2009,58,59
367,259101,Josa i Tuixén,-12,2009,5,17
368,170871,Juià,3,2009,50,47
369,251180,Juncosa,-18,2009,12,30
370,251193,Juneda,67,2009,186,119
371,251214,Les,8,2009,82,74
372,251229,Linyola,-72,2009,114,186
373,081043,"Llacuna, la",13,2009,61,48
374,170887,Lladó,7,2009,36,29
375,251235,Lladorre,6,2009,11,5
376,251240,Lladurs,-10,2009,4,14
377,081056,"Llagosta, la",-126,2009,769,895
378,170890,Llagostera,165,2009,521,356
379,170904,Llambilles,15,2009,30,15
380,170911,Llanars,-8,2009,33,41
381,170926,Llançà,13,2009,330,317
382,251253,Llardecans,-4,2009,16,20
383,251266,Llavorsí,12,2009,32,20
384,251207,Lleida,680,2009,7250,6570
385,170932,Llers,-1,2009,67,68
386,251272,Lles de Cerdanya,-5,2009,14,19
387,081075,Lliçà d'Amunt,138,2009,742,604
388,081081,Lliçà de Vall,44,2009,271,227
389,251288,Llimiana,5,2009,19,14
390,081069,Llinars del Vallès,124,2009,611,487
391,170947,Llívia,36,2009,148,112
392,430727,"Lloar, el",4,2009,11,7
393,251291,Llobera,-2,2009,3,5
394,430733,Llorac,1,2009,10,9
395,430748,Llorenç del Penedès,68,2009,178,110
396,170950,Lloret de Mar,397,2009,3426,3029
397,170963,"Llosses, les",-14,2009,14,28
398,081094,Lluçà,3,2009,16,13
399,171024,Maçanet de Cabrenys,-2,2009,30,32
400,171030,Maçanet de la Selva,102,2009,515,413
401,170979,Madremanya,10,2009,14,4
402,170985,Maià de Montcal,14,2009,35,21
403,251333,Maials,18,2009,50,32
404,251305,Maldà,4,2009,11,7
405,081108,Malgrat de Mar,133,2009,1168,1035
406,081115,Malla,3,2009,12,9
407,081120,Manlleu,-272,2009,762,1034
408,081136,Manresa,-357,2009,3349,3706
409,430764,Marçà,7,2009,30,23
410,430751,Margalef,-2,2009,7,9
411,082423,Marganell,10,2009,30,20
412,081141,Martorell,-28,2009,1554,1582
413,081154,Martorelles,-23,2009,260,283
414,430770,Mas de Barberans,-6,2009,16,22
415,171002,Masarac,11,2009,21,10
416,430786,Masdenverge,13,2009,61,48
417,081167,"Masies de Roda, les",7,2009,50,43
418,081173,"Masies de Voltregà, les",-4,2009,119,123
419,430799,Masllorenç,-10,2009,39,49
420,081189,"Masnou, el",178,2009,1264,1086
421,430803,"Masó, la",1,2009,11,10
422,430810,Maspujols,43,2009,59,16
423,081192,Masquefa,57,2009,440,383
424,430825,"Masroig, el",3,2009,25,22
425,251312,Massalcoreig,7,2009,43,36
426,171019,Massanes,6,2009,53,47
427,251327,Massoteres,6,2009,24,18
428,081206,Matadepera,-32,2009,304,336
429,081213,Mataró,506,2009,5869,5363
430,081228,Mediona,19,2009,181,162
431,251348,Menàrguens,15,2009,54,39
432,170998,Meranges,-3,2009,1,4
433,171058,Mieres,-14,2009,12,26
434,430831,"Milà, el",0,2009,9,9
435,251351,Miralcamp,-10,2009,74,84
436,430846,Miravet,-7,2009,31,38
437,081385,Moià,-21,2009,276,297
438,430859,"Molar, el",-3,2009,16,19
439,081234,Molins de Rei,84,2009,1026,942
440,251370,Mollerussa,270,2009,1076,806
441,171061,Mollet de Peralada,-2,2009,3,5
442,081249,Mollet del Vallès,-372,2009,2695,3067
443,171077,Molló,-6,2009,16,22
444,251364,"Molsosa, la",0,2009,3,3
445,081287,Monistrol de Calders,6,2009,34,28
446,081271,Monistrol de Montserrat,-13,2009,171,184
447,171096,Montagut i Oix,18,2009,79,61
448,430862,Montblanc,57,2009,393,336
449,430884,Montbrió del Camp,72,2009,180,108
450,081252,Montcada i Reixac,141,2009,2033,1892
451,081304,Montclar,-1,2009,0,1
452,251399,Montellà i Martinet,11,2009,49,38
453,081311,Montesquiu,4,2009,60,56
454,251403,Montferrer i Castellbò,-23,2009,71,94
455,430897,Montferri,16,2009,49,33
456,251386,Montgai,4,2009,19,15
457,081265,Montgat,207,2009,703,496
458,081326,Montmajor,1,2009,17,16
459,081332,Montmaneu,-6,2009,4,10
460,430901,"Montmell, el",6,2009,127,121
461,081350,Montmeló,-12,2009,408,420
462,251425,Montoliu de Lleida,7,2009,29,22
463,251410,Montoliu de Segarra,5,2009,9,4
464,251431,Montornès de Segarra,-3,2009,2,5
465,081363,Montornès del Vallès,196,2009,1091,895
466,430918,Mont-ral,3,2009,13,10
467,171100,Mont-ras,-20,2009,76,96
468,430923,Mont-roig del Camp,441,2009,1282,841
469,081379,Montseny,-7,2009,13,20
470,430939,Móra d'Ebre,86,2009,386,300
471,430944,Móra la Nova,29,2009,167,138
472,430957,"Morell, el",86,2009,324,238
473,430960,"Morera de Montsant, la",8,2009,12,4
474,081290,Muntanyola,11,2009,43,32
475,081398,Mura,3,2009,20,17
476,251459,Nalec,1,2009,6,5
477,250254,Naut Aran,-7,2009,91,98
478,081402,Navarcles,7,2009,257,250
479,081419,Navàs,-63,2009,203,266
480,171117,Navata,31,2009,103,72
481,251462,Navès,8,2009,19,11
482,081424,"Nou de Berguedà, la",-3,2009,6,9
483,430976,"Nou de Gaià, la",15,2009,30,15
484,430982,Nulles,34,2009,54,20
485,251484,Odèn,-11,2009,7,18
486,081430,Òdena,79,2009,249,170
487,171122,Ogassa,-3,2009,6,9
488,081458,Olèrdola,58,2009,216,158
489,081461,Olesa de Bonesvalls,-43,2009,88,131
490,081477,Olesa de Montserrat,216,2009,1238,1022
491,251497,Oliana,-13,2009,73,86
492,251500,Oliola,-12,2009,7,19
493,251517,Olius,22,2009,54,32
494,081483,Olivella,42,2009,331,289
495,081496,Olost,-10,2009,27,37
496,171143,Olot,148,2009,1612,1464
497,251522,"Oluges, les",-2,2009,4,6
498,081445,Olvan,13,2009,52,39
499,251538,"Omellons, els",13,2009,20,7
500,251543,"Omells de na Gaia, els",2,2009,4,2
501,171156,Ordis,11,2009,18,7
502,251556,Organyà,-7,2009,46,53
503,081509,Orís,12,2009,22,10
504,081516,Oristà,-4,2009,19,23
505,081521,Orpí,-5,2009,8,13
506,081537,Òrrius,17,2009,50,33
507,251569,Os de Balaguer,8,2009,43,35
508,171169,Osor,0,2009,12,12
509,251575,Ossó de Sió,5,2009,10,5
510,081542,Pacs del Penedès,10,2009,57,47
511,081555,Palafolls,139,2009,540,401
512,171175,Palafrugell,128,2009,1177,1049
513,171181,Palamós,-79,2009,1052,1131
514,251581,"Palau d'Anglesola, el",18,2009,107,89
515,171194,Palau de Santa Eulàlia,-8,2009,2,10
516,171215,Palau-sator,2,2009,13,11
517,171208,Palau-saverdera,35,2009,128,93
518,081568,Palau-solità i Plegamans,92,2009,681,589
519,431009,"Pallaresos, els",103,2009,240,137
520,081574,Pallejà,90,2009,561,471
521,430995,"Palma d'Ebre, la",11,2009,31,20
522,089058,"Palma de Cervelló, la",-7,2009,146,153
523,171236,Palol de Revardit,-1,2009,12,13
524,171241,Pals,5,2009,174,169
525,081580,"Papiol, el",16,2009,192,176
526,171254,Pardines,5,2009,10,5
527,081593,Parets del Vallès,24,2009,947,923
528,171267,Parlavà,9,2009,19,10
529,431016,Passanant i Belltall,9,2009,20,11
530,171289,Pau,-10,2009,33,43
531,431021,Paüls,-9,2009,12,21
532,171292,Pedret i Marzà,12,2009,27,15
533,251641,Penelles,-36,2009,21,57
534,171306,"Pera, la",3,2009,29,26
535,081607,Perafita,-10,2009,9,19
536,431037,Perafort,52,2009,104,52
537,171328,Peralada,40,2009,113,73
538,251654,Peramola,10,2009,24,14
539,431042,"Perelló, el",81,2009,148,67
540,081614,Piera,221,2009,926,705
541,431055,"Piles, les",2,2009,17,15
542,081635,Pineda de Mar,-218,2009,1512,1730
543,431068,"Pinell de Brai, el",11,2009,27,16
544,251667,Pinell de Solsonès,1,2009,11,10
545,251673,Pinós,9,2009,19,10
546,431074,Pira,-11,2009,17,28
547,431080,"Pla de Santa Maria, el",54,2009,157,103
548,081640,"Pla del Penedès, el",57,2009,101,44
549,171334,"Planes d'Hostoles, les",-17,2009,51,68
550,171349,Planoles,1,2009,27,26
551,259118,"Plans de Sió, els",0,2009,25,25
552,251689,"Poal, el",-35,2009,21,56
553,251692,"Pobla de Cérvoles, la",-13,2009,9,22
554,081653,"Pobla de Claramunt, la",16,2009,145,129
555,081666,"Pobla de Lillet, la",4,2009,52,48
556,431093,"Pobla de Mafumet, la",195,2009,356,161
557,431107,"Pobla de Massaluca, la",1,2009,11,10
558,431114,"Pobla de Montornès, la",26,2009,196,170
559,251713,"Pobla de Segur, la",38,2009,201,163
560,431129,Poboleda,15,2009,32,17
561,081672,Polinyà,42,2009,416,374
562,431135,"Pont d'Armentera, el",-23,2009,23,46
563,250306,"Pont de Bar, el",-2,2009,5,7
564,171352,Pont de Molins,15,2009,37,22
565,251734,"Pont de Suert, el",-5,2009,137,142
566,081825,"Pont de Vilomara i Rocafort, el",37,2009,179,142
567,431418,Pontils,-18,2009,18,36
568,081688,Pontons,9,2009,77,68
569,171365,Pontós,-9,2009,11,20
570,251728,Ponts,-59,2009,124,183
571,171371,Porqueres,-2,2009,201,203
572,431140,Porrera,7,2009,19,12
573,171404,"Port de la Selva, el",-19,2009,59,78
574,171387,Portbou,-7,2009,51,58
575,251749,"Portella, la",2,2009,48,46
576,431153,Pradell de la Teixeta,7,2009,10,3
577,431166,Prades,-20,2009,42,62
578,431172,Prat de Comte,-4,2009,9,13
579,081691,"Prat de Llobregat, el",-294,2009,2357,2651
580,431188,Pratdip,3,2009,46,43
581,081712,Prats de Lluçanès,10,2009,113,103
582,081705,"Prats de Rei, els",14,2009,32,18
583,251752,Prats i Sansor,7,2009,17,10
584,251765,Preixana,1,2009,13,12
585,251771,Preixens,-17,2009,20,37
586,082303,Premià de Dalt,106,2009,603,497
587,081727,Premià de Mar,-7,2009,1528,1535
588,171390,"Preses, les",-11,2009,51,62
589,251790,Prullans,-1,2009,13,14
590,171411,Puigcerdà,-216,2009,467,683
591,081748,Puigdàlber,10,2009,34,24
592,251804,Puiggròs,1,2009,6,5
593,431191,Puigpelat,17,2009,75,58
594,081751,Puig-reig,-33,2009,224,257
595,251811,Puigverd d'Agramunt,-5,2009,10,15
596,251826,Puigverd de Lleida,3,2009,87,84
597,081764,Pujalt,3,2009,8,5
598,081770,"Quar, la",-2,2009,2,4
599,171426,Quart,110,2009,225,115
600,170433,Queralbs,-6,2009,2,8
601,431205,Querol,-13,2009,27,40
602,171432,Rabós,-23,2009,2,25
603,081786,Rajadell,21,2009,40,19
604,431212,Rasquera,9,2009,32,23
605,171447,Regencós,-17,2009,13,30
606,081799,Rellinars,10,2009,62,52
607,431227,Renau,12,2009,15,3
608,431233,Reus,-755,2009,3621,4376
609,251832,Rialp,-4,2009,34,38
610,431248,"Riba, la",-16,2009,38,54
611,431251,Riba-roja d'Ebre,-5,2009,49,54
612,259059,Ribera d'Ondara,8,2009,22,14
613,251850,Ribera d'Urgellet,29,2009,105,76
614,171450,Ribes de Freser,-14,2009,97,111
615,171463,Riells i Viabrea,76,2009,297,221
616,431264,"Riera de Gaià, la",58,2009,115,57
617,251863,Riner,-2,2009,12,14
618,171479,Ripoll,-64,2009,398,462
619,081803,Ripollet,-151,2009,1990,2141
620,259139,Riu de Cerdanya,-1,2009,7,8
621,171485,Riudarenes,60,2009,176,116
622,171498,Riudaura,-1,2009,18,19
623,431270,Riudecanyes,27,2009,74,47
624,431286,Riudecols,-19,2009,69,88
625,171501,Riudellots de la Selva,-13,2009,82,95
626,431299,Riudoms,47,2009,294,247
627,171518,Riumors,-11,2009,15,26
628,081810,"Roca del Vallès, la",33,2009,571,538
629,431303,Rocafort de Queralt,-3,2009,18,21
630,431310,Roda de Berà,68,2009,484,416
631,081831,Roda de Ter,96,2009,335,239
632,431325,Rodonyà,24,2009,65,41
633,431331,Roquetes,-21,2009,416,437
634,171523,Roses,107,2009,1337,1230
635,251898,Rosselló,40,2009,193,153
636,431346,"Rourell, el",7,2009,32,25
637,081846,Rubí,174,2009,3618,3444
638,081859,Rubió,20,2009,27,7
639,171539,Rupià,0,2009,16,16
640,089019,Rupit i Pruit,-8,2009,4,12
641,081878,Sabadell,450,2009,9258,8808
642,081884,Sagàs,6,2009,9,3
643,251902,Salàs de Pallars,-7,2009,20,27
644,081901,Saldes,-7,2009,26,33
645,171544,Sales de Llierca,-6,2009,5,11
646,081918,Sallent,-65,2009,220,285
647,431359,Salomó,1,2009,22,21
648,439057,Salou,259,2009,3143,2884
649,171557,Salt,39,2009,2918,2879
650,251919,Sanaüja,2,2009,10,8
651,081944,Sant Adrià de Besòs,-1,2009,2393,2394
652,081957,Sant Agustí de Lluçanès,-1,2009,4,5
653,081960,Sant Andreu de la Barca,172,2009,1647,1475
654,081976,Sant Andreu de Llavaneres,73,2009,657,584
655,171576,Sant Andreu Salou,2,2009,8,6
656,171833,Sant Aniol de Finestres,14,2009,27,13
657,081982,Sant Antoni de Vilamajor,26,2009,386,360
658,081995,Sant Bartomeu del Grau,7,2009,89,82
659,082009,Sant Boi de Llobregat,4,2009,3908,3904
660,082016,Sant Boi de Lluçanès,8,2009,33,25
661,431362,Sant Carles de la Ràpita,66,2009,1042,976
662,082037,Sant Cebrià de Vallalta,43,2009,270,227
663,082021,Sant Celoni,-64,2009,920,984
664,082042,Sant Climent de Llobregat,12,2009,177,165
665,171582,Sant Climent Sescebes,5,2009,49,44
666,082055,Sant Cugat del Vallès,1829,2009,5517,3688
667,082068,Sant Cugat Sesgarrigues,29,2009,73,44
668,251961,Sant Esteve de la Sarga,1,2009,9,8
669,082074,Sant Esteve de Palautordera,32,2009,202,170
670,082080,Sant Esteve Sesrovires,77,2009,426,349
671,171595,Sant Feliu de Buixalleu,-20,2009,25,45
672,082107,Sant Feliu de Codines,113,2009,434,321
673,171609,Sant Feliu de Guíxols,-56,2009,1344,1400
674,082114,Sant Feliu de Llobregat,85,2009,1714,1629
675,171616,Sant Feliu de Pallerols,-31,2009,60,91
676,082129,Sant Feliu Sasserra,22,2009,37,15
677,171621,Sant Ferriol,22,2009,35,13
678,082093,Sant Fost de Campsentelles,129,2009,543,414
679,082135,Sant Fruitós de Bages,162,2009,559,397
680,171637,Sant Gregori,48,2009,176,128
681,251924,Sant Guim de Freixenet,-18,2009,36,54
682,251977,Sant Guim de la Plana,6,2009,9,3
683,171642,Sant Hilari Sacalm,-32,2009,215,247
684,082153,Sant Hipòlit de Voltregà,81,2009,241,160
685,081939,Sant Iscle de Vallalta,11,2009,93,82
686,439023,Sant Jaume d'Enveja,12,2009,143,131
687,082166,Sant Jaume de Frontanyà,-3,2009,0,3
688,171655,Sant Jaume de Llierca,-23,2009,17,40
689,431378,Sant Jaume dels Domenys,48,2009,159,111
690,171674,Sant Joan de les Abadesses,-3,2009,98,101
691,171680,Sant Joan de Mollet,-9,2009,28,37
692,082188,Sant Joan de Vilatorrada,21,2009,457,436
693,082172,Sant Joan Despí,102,2009,1615,1513
694,171851,Sant Joan les Fonts,47,2009,174,127
695,171668,Sant Jordi Desvalls,13,2009,41,28
696,089030,Sant Julià de Cerdanyola,-5,2009,12,17
697,171693,Sant Julià de Ramis,12,2009,222,210
698,082205,Sant Julià de Vilatorta,2,2009,97,95
699,179032,Sant Julià del Llor i Bonmatí,12,2009,88,76
700,082212,Sant Just Desvern,148,2009,955,807
701,082227,Sant Llorenç d'Hortons,-18,2009,153,171
702,171714,Sant Llorenç de la Muga,4,2009,16,12
703,251930,Sant Llorenç de Morunys,5,2009,58,53
704,082233,Sant Llorenç Savall,2,2009,119,117
705,082251,Sant Martí d'Albars,-5,2009,3,8
706,082248,Sant Martí de Centelles,31,2009,115,84
707,171729,Sant Martí de Llémena,20,2009,38,18
708,259025,Sant Martí de Riucorb,-11,2009,15,26
709,082264,Sant Martí de Tous,-1,2009,31,32
710,082270,Sant Martí Sarroca,30,2009,216,186
711,082286,Sant Martí Sesgueioles,9,2009,20,11
712,171735,Sant Martí Vell,8,2009,19,11
713,082299,Sant Mateu de Bages,5,2009,15,10
714,171740,Sant Miquel de Campmajor,-12,2009,11,23
715,171753,Sant Miquel de Fluvià,-32,2009,32,64
716,171766,Sant Mori,-12,2009,5,17
717,171772,Sant Pau de Segúries,10,2009,46,36
718,082310,Sant Pere de Ribes,-172,2009,1790,1962
719,082325,Sant Pere de Riudebitlles,-13,2009,102,115
720,082331,Sant Pere de Torelló,27,2009,113,86
721,082346,Sant Pere de Vilamajor,88,2009,307,219
722,171788,Sant Pere Pescador,-14,2009,164,178
723,081897,Sant Pere Sallavinera,-1,2009,6,7
724,082359,Sant Pol de Mar,16,2009,290,274
725,082362,Sant Quintí de Mediona,17,2009,133,116
726,082378,Sant Quirze de Besora,-16,2009,83,99
727,082384,Sant Quirze del Vallès,96,2009,867,771
728,082397,Sant Quirze Safaja,-10,2009,50,60
729,251945,Sant Ramon,11,2009,29,18
730,082401,Sant Sadurní d'Anoia,49,2009,553,504
731,082418,Sant Sadurní d'Osormort,-6,2009,1,7
732,080983,Sant Salvador de Guardiola,5,2009,176,171
733,082628,Sant Vicenç de Castellet,121,2009,565,444
734,082649,Sant Vicenç de Montalt,146,2009,493,347
735,082652,Sant Vicenç de Torelló,25,2009,89,64
736,082634,Sant Vicenç dels Horts,267,2009,1378,1111
737,431384,Santa Bàrbara,34,2009,226,192
738,082439,Santa Cecília de Voltregà,-5,2009,5,10
739,082444,Santa Coloma de Cervelló,7,2009,355,348
740,171805,Santa Coloma de Farners,262,2009,718,456
741,082457,Santa Coloma de Gramenet,1175,2009,10204,9029
742,431397,Santa Coloma de Queralt,-10,2009,150,160
743,171812,Santa Cristina d'Aro,25,2009,439,414
744,082460,Santa Eugènia de Berga,24,2009,129,105
745,082476,Santa Eulàlia de Riuprimer,18,2009,64,46
746,082482,Santa Eulàlia de Ronçana,9,2009,372,363
747,082495,Santa Fe del Penedès,-4,2009,7,11
748,171827,Santa Llogaia d'Àlguema,-3,2009,31,34
749,082508,Santa Margarida de Montbui,-93,2009,501,594
750,082515,Santa Margarida i els Monjos,-97,2009,476,573
751,082589,Santa Maria d'Oló,-9,2009,50,59
752,082536,Santa Maria de Besora,3,2009,17,14
753,082567,Santa Maria de Martorelles,-12,2009,59,71
754,082554,Santa Maria de Merlès,3,2009,9,6
755,082573,Santa Maria de Miralles,4,2009,10,6
756,082592,Santa Maria de Palautordera,178,2009,638,460
757,431401,Santa Oliva,78,2009,297,219
758,171848,Santa Pau,0,2009,62,62
759,082606,Santa Perpètua de Mogoda,-18,2009,1379,1397
760,082613,Santa Susanna,53,2009,286,233
761,081923,Santpedor,139,2009,377,238
762,431423,Sarral,0,2009,85,85
763,171864,Sarrià de Ter,110,2009,386,276
764,252017,Sarroca de Bellera,6,2009,9,3
765,252000,Sarroca de Lleida,5,2009,16,11
766,171870,"Saus, Camallera i Llampaies",-7,2009,34,41
767,431439,Savallà del Comtat,0,2009,3,3
768,431444,"Secuita, la",18,2009,87,69
769,171886,"Selva de Mar, la",-5,2009,10,15
770,431457,"Selva del Camp, la",94,2009,245,151
771,431460,Senan,-1,2009,3,4
772,430445,"Sénia, la",-146,2009,255,401
773,252022,Senterada,-2,2009,10,12
774,250352,"Sentiu de Sió, la",5,2009,20,15
775,082671,Sentmenat,195,2009,515,320
776,171903,Serinyà,-2,2009,48,50
777,252043,Seròs,13,2009,111,98
778,171910,Serra de Daró,17,2009,25,8
779,171925,Setcases,10,2009,19,9
780,252038,"Seu d'Urgell, la",28,2009,650,622
781,082690,Seva,39,2009,176,137
782,252056,Sidamon,-1,2009,21,22
783,171931,Sils,189,2009,496,307
784,082704,Sitges,386,2009,2092,1706
785,170524,Siurana,-8,2009,6,14
786,082711,Sobremunt,-1,2009,10,11
787,252069,"Soleràs, el",-13,2009,11,24
788,431476,Solivella,-1,2009,28,29
789,252075,Solsona,-86,2009,370,456
790,082726,Sora,11,2009,14,3
791,252081,Soriguera,11,2009,25,14
792,252094,Sort,-5,2009,124,129
793,252108,Soses,34,2009,102,68
794,082732,Subirats,-3,2009,163,166
795,252115,Sudanell,-9,2009,35,44
796,252120,Sunyer,8,2009,21,13
797,082747,Súria,-57,2009,189,246
798,171946,Susqueda,-11,2009,4,15
799,082763,Tagamanent,-6,2009,14,20
800,082779,Talamanca,-18,2009,13,31
801,252154,Talarn,-3,2009,34,37
802,252167,Talavera,3,2009,15,12
803,171959,"Tallada d'Empordà, la",21,2009,39,18
804,082785,Taradell,94,2009,269,175
805,431482,Tarragona,-429,2009,6478,6907
806,252173,Tàrrega,230,2009,986,756
807,252189,Tarrés,4,2009,6,2
808,252192,Tarroja de Segarra,-8,2009,0,8
809,082750,Tavèrnoles,6,2009,18,12
810,082802,Tavertet,-5,2009,9,14
811,082819,Teià,14,2009,281,267
812,252206,Térmens,0,2009,76,76
813,171962,Terrades,17,2009,26,9
814,082798,Terrassa,602,2009,9635,9033
815,082824,Tiana,145,2009,430,285
816,252213,Tírvia,17,2009,24,7
817,252228,Tiurana,-1,2009,0,1
818,431495,Tivenys,-11,2009,29,40
819,431508,Tivissa,-6,2009,68,74
820,082830,Tona,2,2009,317,315
821,252234,Torà,3,2009,54,51
822,082845,Tordera,227,2009,1195,968
823,082858,Torelló,73,2009,592,519
824,252249,"Torms, els",-2,2009,6,8
825,252252,Tornabous,4,2009,55,51
826,252271,"Torre de Cabdella, la",-19,2009,28,47
827,082861,"Torre de Claramunt, la",12,2009,211,199
828,431515,"Torre de Fontaubella, la",0,2009,15,15
829,431520,"Torre de l'Espanyol, la",14,2009,36,22
830,252265,Torrebesses,0,2009,6,6
831,431536,Torredembarra,80,2009,1107,1027
832,252287,Torrefarrera,189,2009,373,184
833,259078,Torrefeta i Florejacs,-16,2009,20,36
834,252304,Torregrossa,11,2009,70,59
835,252311,Torrelameu,15,2009,42,27
836,082877,Torrelavit,5,2009,57,52
837,082883,Torrelles de Foix,73,2009,262,189
838,082896,Torrelles de Llobregat,63,2009,328,265
839,171978,Torrent,4,2009,9,5
840,252326,Torres de Segre,33,2009,137,104
841,252332,Torre-serona,-9,2009,10,19
842,171984,Torroella de Fluvià,10,2009,71,61
843,171997,Torroella de Montgrí,-123,2009,786,909
844,431541,Torroja del Priorat,2,2009,8,6
845,172001,Tortellà,20,2009,39,19
846,431554,Tortosa,-1372,2009,1370,2742
847,172018,Toses,1,2009,10,9
848,172023,Tossa de Mar,11,2009,280,269
849,252347,Tremp,69,2009,408,339
850,172044,Ullà,-49,2009,124,173
851,082900,Ullastrell,4,2009,91,87
852,172057,Ullastret,5,2009,20,15
853,431567,Ulldecona,23,2009,351,328
854,431573,Ulldemolins,-2,2009,33,35
855,172039,Ultramort,12,2009,17,5
856,172060,Urús,8,2009,13,5
857,082917,Vacarisses,22,2009,314,292
858,170144,"Vajol, la",-1,2009,9,10
859,172076,"Vall d'en Bas, la",42,2009,123,81
860,172082,"Vall de Bianya, la",-3,2009,66,69
861,250432,"Vall de Boí, la",-11,2009,64,75
862,259010,Vall de Cardós,1,2009,20,19
863,082922,Vallbona d'Anoia,-6,2009,52,58
864,252385,Vallbona de les Monges,6,2009,16,10
865,082938,Vallcebre,4,2009,16,12
866,431589,Vallclara,-2,2009,2,4
867,252402,Vallfogona de Balaguer,16,2009,93,77
868,171707,Vallfogona de Ripollès,12,2009,21,9
869,431592,Vallfogona de Riucorb,2,2009,10,8
870,082943,Vallgorguina,100,2009,229,129
871,082956,Vallirana,78,2009,734,656
872,172095,Vall-llobrega,18,2009,49,31
873,431606,Vallmoll,0,2009,112,112
874,082969,Vallromanes,59,2009,168,109
875,431613,Valls,17,2009,1257,1240
876,259062,"Valls d'Aguilar, les",1,2009,15,14
877,252398,"Valls de Valira, les",2,2009,42,40
878,431628,Vandellòs i l'Hospitalet de l'Infant,92,2009,457,365
879,259097,"Vansa i Fórnols, la",6,2009,13,7
880,082975,Veciana,1,2009,4,3
881,431634,"Vendrell, el",196,2009,2469,2273
882,172109,Ventalló,-3,2009,53,56
883,252424,Verdú,-5,2009,45,50
884,172116,Verges,4,2009,54,50
885,431649,Vespella de Gaià,10,2009,41,31
886,082981,Vic,242,2009,2404,2162
887,172121,Vidrà,-6,2009,4,10
888,172137,Vidreres,136,2009,608,472
889,252430,Vielha e Mijaran,-102,2009,465,567
890,431652,Vilabella,18,2009,40,22
891,172142,Vilabertran,24,2009,53,29
892,172155,Vilablareix,1,2009,79,78
893,082994,Vilada,1,2009,18,17
894,172174,Viladamat,-6,2009,24,30
895,172168,Viladasens,2,2009,10,8
896,083015,Viladecans,360,2009,2995,2635
897,083008,Viladecavalls,-27,2009,345,372
898,172180,Vilademuls,-22,2009,26,48
899,172207,Viladrau,-6,2009,53,59
900,172214,Vilafant,3,2009,296,293
901,083054,Vilafranca del Penedès,-362,2009,2240,2602
902,252445,Vilagrassa,6,2009,28,22
903,172235,Vilajuïga,15,2009,65,50
904,431750,Vilalba dels Arcs,4,2009,17,13
905,083067,Vilalba Sasserra,37,2009,92,55
906,252458,Vilaller,-15,2009,25,40
907,172240,Vilallonga de Ter,-2,2009,30,32
908,431665,Vilallonga del Camp,88,2009,185,97
909,172253,Vilamacolum,3,2009,35,32
910,172266,Vilamalla,-51,2009,65,116
911,172272,Vilamaniscle,9,2009,14,5
912,252477,Vilamòs,28,2009,40,12
913,172288,Vilanant,11,2009,27,16
914,431671,Vilanova d'Escornalbou,17,2009,46,29
915,252483,Vilanova de Bellpuig,21,2009,55,34
916,252496,Vilanova de l'Aguda,1,2009,2,1
917,252542,Vilanova de la Barca,-36,2009,100,136
918,252509,Vilanova de Meià,0,2009,18,18
919,431687,Vilanova de Prades,-3,2009,13,16
920,083036,Vilanova de Sau,-9,2009,13,22
921,252516,Vilanova de Segrià,16,2009,72,56
922,083020,Vilanova del Camí,-69,2009,644,713
923,089024,Vilanova del Vallès,98,2009,287,189
924,083073,Vilanova i la Geltrú,522,2009,3563,3041
925,431690,Vilaplana,14,2009,38,24
926,431704,Vila-rodona,-5,2009,78,83
927,172305,Vila-sacra,26,2009,50,24
928,252521,Vila-sana,4,2009,25,21
929,431711,Vila-seca,301,2009,1816,1515
930,082140,Vilassar de Dalt,39,2009,447,408
931,082191,Vilassar de Mar,91,2009,1165,1074
932,172229,Vilaür,3,2009,11,8
933,431726,Vilaverd,10,2009,38,28
934,431732,"Vilella Alta, la",5,2009,7,2
935,431747,"Vilella Baixa, la",4,2009,12,8
936,172333,Vilobí d'Onyar,31,2009,186,155
937,083041,Vilobí del Penedès,16,2009,71,55
938,172327,Vilopriu,-12,2009,23,35
939,252537,"Vilosell, el",-3,2009,11,14
940,431763,Vimbodí i Poblet,-32,2009,28,60
941,252555,Vinaixa,3,2009,21,18
942,431779,Vinebre,-10,2009,27,37
943,431785,Vinyols i els Arcs,59,2009,167,108
944,083089,Viver i Serrateix,6,2009,11,5
945,430521,Xerta,13,2009,54,41
0,250019,Abella de la Conca,0,2010,12,12
1,080018,Abrera,30,2010,682,652
2,250024,Àger,12,2010,37,25
3,250030,Agramunt,17,2010,239,222
4,080023,Aguilar de Segarra,-11,2010,2,13
5,170010,Agullana,3,2010,63,60
6,080142,Aiguafreda,-22,2010,120,142
7,430017,Aiguamúrcia,10,2010,64,54
8,170025,Aiguaviva,21,2010,47,26
9,250387,Aitona,31,2010,147,116
10,250045,"Alamús, els",8,2010,39,31
11,250058,Alàs i Cerc,-5,2010,17,22
12,250061,"Albagés, l'",-6,2010,17,23
13,170031,Albanyà,1,2010,11,10
14,250077,Albatàrrec,47,2010,187,140
15,250083,Albesa,-17,2010,70,87
16,250096,"Albi, l'",15,2010,39,24
17,430022,Albinyana,27,2010,175,148
18,430038,"Albiol, l'",31,2010,50,19
19,170046,Albons,-8,2010,34,42
20,430043,Alcanar,57,2010,536,479
21,250100,Alcanó,-1,2010,6,7
22,250117,Alcarràs,294,2010,746,452
23,250122,Alcoletge,198,2010,343,145
24,430056,Alcover,-9,2010,272,281
25,439044,"Aldea, l'",75,2010,289,214
26,430069,Aldover,11,2010,43,32
27,430075,"Aleixar, l'",9,2010,49,40
28,080039,Alella,0,2010,593,593
29,430081,Alfara de Carles,8,2010,14,6
30,250138,Alfarràs,-49,2010,122,171
31,250143,Alfés,-3,2010,11,14
32,430094,Alforja,27,2010,122,95
33,250156,Algerri,-3,2010,15,18
34,250169,Alguaire,-37,2010,171,208
35,250175,Alins,-7,2010,4,11
36,430108,Alió,-2,2010,22,24
37,250194,Almacelles,31,2010,305,274
38,250208,Almatret,-15,2010,8,23
39,250215,Almenar,-6,2010,153,159
40,430115,Almoster,-19,2010,47,66
41,250220,Alòs de Balaguer,-4,2010,8,12
42,170062,Alp,-6,2010,137,143
43,080044,Alpens,-2,2010,11,13
44,250236,Alpicat,31,2010,286,255
45,250241,Alt Àneu,6,2010,30,24
46,430120,Altafulla,35,2010,354,319
47,170078,Amer,-18,2010,85,103
48,430136,"Ametlla de Mar, l'",39,2010,354,315
49,080057,"Ametlla del Vallès, l'",-4,2010,421,425
50,439060,"Ampolla, l'",22,2010,223,201
51,430141,Amposta,21,2010,1035,1014
52,170084,Anglès,63,2010,350,287
53,250273,Anglesola,35,2010,71,36
54,250292,Arbeca,15,2010,94,79
55,430167,"Arboç, l'",49,2010,372,323
56,430154,Arbolí,0,2010,9,9
57,170097,Arbúcies,-27,2010,359,386
58,080060,Arenys de Mar,167,2010,1021,854
59,080076,Arenys de Munt,128,2010,472,344
60,170101,Argelaguer,7,2010,26,19
61,080082,Argençola,-11,2010,10,21
62,430173,"Argentera, l'",23,2010,31,8
63,080095,Argentona,35,2010,529,494
64,170118,"Armentera, l'",-5,2010,61,66
65,430189,Arnes,-10,2010,16,26
66,250313,Arres,2,2010,5,3
67,250328,Arsèguel,-3,2010,8,11
68,080109,Artés,60,2010,328,268
69,250334,Artesa de Lleida,-7,2010,65,72
70,250349,Artesa de Segre,-19,2010,200,219
71,430192,Ascó,50,2010,105,55
72,250365,Aspa,-6,2010,3,9
73,250371,"Avellanes i Santa Linya, les",3,2010,33,30
74,080116,Avià,21,2010,124,103
75,080121,Avinyó,-11,2010,87,98
76,170123,Avinyonet de Puigventós,-26,2010,87,113
77,080137,Avinyonet del Penedès,12,2010,121,109
78,080155,Badalona,268,2010,15288,15020
79,089045,Badia del Vallès,-118,2010,557,675
80,080168,Bagà,10,2010,126,116
81,250390,Baix Pallars,-19,2010,16,35
82,250404,Balaguer,2,2010,978,976
83,080174,Balenyà,-27,2010,167,194
84,080180,Balsareny,29,2010,140,111
85,430206,Banyeres del Penedès,41,2010,221,180
86,170157,Banyoles,268,2010,991,723
87,250411,Barbens,4,2010,57,53
88,430213,Barberà de la Conca,5,2010,50,45
89,082520,Barberà del Vallès,99,2010,1751,1652
90,080193,Barcelona,-1922,2010,102925,104847
91,250426,"Baronia de Rialb, la",-4,2010,8,12
92,170160,Bàscara,20,2010,64,44
93,250447,Bassella,-4,2010,15,19
94,430228,Batea,-15,2010,31,46
95,250450,Bausen,-1,2010,0,1
96,080207,Begues,43,2010,406,363
97,170139,Begur,-4,2010,236,240
98,250463,Belianes,0,2010,22,22
99,251706,Bellaguarda,-6,2010,3,9
100,170182,Bellcaire d'Empordà,-9,2010,42,51
101,250479,Bellcaire d'Urgell,23,2010,68,45
102,250485,Bell-lloc d'Urgell,0,2010,105,105
103,250498,Bellmunt d'Urgell,-7,2010,3,10
104,430234,Bellmunt del Priorat,-6,2010,16,22
105,080214,Bellprat,-3,2010,2,5
106,250501,Bellpuig,74,2010,299,225
107,430249,Bellvei,-46,2010,148,194
108,250518,Bellver de Cerdanya,20,2010,149,129
109,250523,Bellvís,-98,2010,111,209
110,250539,Benavent de Segrià,18,2010,76,58
111,430252,Benifallet,18,2010,26,8
112,430265,Benissanet,-2,2010,88,90
113,080229,Berga,-134,2010,700,834
114,170195,Besalú,17,2010,142,125
115,170209,Bescanó,29,2010,248,219
116,170216,Beuda,1,2010,23,22
117,080235,Bigues i Riells del Fai,50,2010,470,420
118,250557,Biosca,11,2010,14,3
119,170221,"Bisbal d'Empordà, la",-107,2010,543,650
120,430271,"Bisbal de Falset, la",-9,2010,7,16
121,430287,"Bisbal del Penedès, la",-29,2010,219,248
122,172348,Biure,2,2010,9,7
123,430290,Blancafort,-13,2010,17,30
124,170237,Blanes,-119,2010,2202,2321
125,170293,Boadella i les Escaules,0,2010,10,10
126,170242,Bolvir,-3,2010,37,40
127,430304,Bonastre,8,2010,49,41
128,250576,"Bòrdes, Es",-6,2010,21,27
129,170255,Bordils,17,2010,118,101
130,250582,"Borges Blanques, les",0,2010,288,288
131,430311,"Borges del Camp, les",-4,2010,101,105
132,170268,Borrassà,13,2010,41,28
133,080240,Borredà,-2,2010,43,45
134,250595,Bossòst,-11,2010,79,90
135,430326,Bot,16,2010,40,24
136,430332,Botarell,20,2010,71,51
137,250560,Bovera,-6,2010,8,14
138,430347,Bràfim,-14,2010,49,63
139,170274,Breda,23,2010,201,178
140,080253,"Bruc, el",18,2010,169,151
141,080266,"Brull, el",-6,2010,7,13
142,170280,Brunyola i Sant Martí Sapresa,22,2010,38,16
143,430350,Cabacés,-3,2010,12,15
144,250609,Cabanabona,2,2010,8,6
145,170314,Cabanelles,3,2010,27,24
146,170307,Cabanes,10,2010,62,52
147,080272,"Cabanyes, les",16,2010,50,34
148,250616,Cabó,-1,2010,4,5
149,430363,Cabra del Camp,9,2010,99,90
150,080288,Cabrera d'Anoia,14,2010,109,95
151,080291,Cabrera de Mar,-5,2010,271,276
152,080305,Cabrils,53,2010,435,382
153,170329,Cadaqués,-11,2010,138,149
154,080312,Calaf,-91,2010,136,227
155,430379,Calafell,376,2010,2547,2171
156,080348,Calders,14,2010,60,46
157,080327,Caldes d'Estrac,22,2010,286,264
158,170335,Caldes de Malavella,57,2010,503,446
159,080333,Caldes de Montbui,109,2010,863,754
160,080351,Calella,102,2010,1487,1385
161,080370,Calldetenes,-14,2010,129,143
162,080386,Callús,83,2010,166,83
163,080364,Calonge de Segarra,7,2010,9,2
164,170340,Calonge i Sant Antoni,12,2010,842,830
165,250621,Camarasa,-19,2010,30,49
166,439039,Camarles,-20,2010,102,122
167,430385,Cambrils,451,2010,2458,2007
168,170353,Camós,10,2010,30,20
169,170366,Campdevànol,9,2010,122,113
170,170372,Campelles,13,2010,18,5
171,080399,Campins,59,2010,92,33
172,170388,Campllong,22,2010,55,33
173,170391,Camprodon,-16,2010,124,140
174,250637,Canejan,3,2010,7,4
175,170405,Canet d'Adri,-11,2010,30,41
176,080403,Canet de Mar,57,2010,724,667
177,439076,"Canonja, la",0,2010,0,0
178,080410,Canovelles,-434,2010,997,1431
179,080425,Cànoves i Samalús,-9,2010,158,167
180,170412,Cantallops,5,2010,25,20
181,080431,Canyelles,82,2010,343,261
182,430398,Capafonts,0,2010,5,5
183,430402,Capçanes,-8,2010,17,25
184,080446,Capellades,-30,2010,248,278
185,170427,Capmany,-6,2010,42,48
186,080459,Capolat,3,2010,8,5
187,080462,Cardedeu,179,2010,1001,822
188,080478,Cardona,-38,2010,114,152
189,080484,Carme,3,2010,34,31
190,430419,Caseres,0,2010,12,12
191,170448,Cassà de la Selva,116,2010,511,395
192,080497,Casserres,15,2010,77,62
193,080575,Castell de l'Areny,-4,2010,1,5
194,259046,Castell de Mur,0,2010,12,12
195,250642,Castellar de la Ribera,-2,2010,6,8
196,080522,Castellar de n'Hug,-18,2010,10,28
197,080500,Castellar del Riu,11,2010,22,11
198,080517,Castellar del Vallès,36,2010,964,928
199,080538,Castellbell i el Vilar,-46,2010,213,259
200,080543,Castellbisbal,-41,2010,535,576
201,080556,Castellcir,-4,2010,47,51
202,250674,Castelldans,-5,2010,53,58
203,080569,Castelldefels,696,2010,4980,4284
204,080581,Castellet i la Gornal,-7,2010,155,162
205,170464,Castellfollit de la Roca,-40,2010,38,78
206,080608,Castellfollit de Riubregós,-5,2010,3,8
207,080594,Castellfollit del Boix,-4,2010,18,22
208,080615,Castellgalí,12,2010,141,129
209,080620,Castellnou de Bages,17,2010,64,47
210,250680,Castellnou de Seana,-12,2010,17,29
211,170470,Castelló d'Empúries,-368,2010,1006,1374
212,250693,Castelló de Farfanya,-6,2010,35,41
213,080636,Castellolí,28,2010,46,18
214,170486,Castell-Platja d'Aro,-73,2010,1038,1111
215,250707,Castellserà,4,2010,39,35
216,080641,Castellterçol,-1,2010,118,119
217,430424,Castellvell del Camp,13,2010,138,125
218,080654,Castellví de la Marca,10,2010,84,74
219,080667,Castellví de Rosanes,48,2010,140,92
220,430430,"Catllar, el",11,2010,225,214
221,250714,Cava,1,2010,1,0
222,171899,"Cellera de Ter, la",-36,2010,69,105
223,170499,Celrà,72,2010,315,243
224,080673,Centelles,37,2010,304,267
225,082687,Cercs,-11,2010,53,64
226,082665,Cerdanyola del Vallès,-261,2010,3043,3304
227,080689,Cervelló,37,2010,540,503
228,250729,Cervera,-3,2010,410,413
229,250735,Cervià de les Garrigues,7,2010,44,37
230,170502,Cervià de Ter,-5,2010,35,40
231,170519,Cistella,1,2010,19,18
232,250740,Ciutadilla,-10,2010,12,22
233,250753,Clariana de Cardener,6,2010,13,7
234,250766,"Cogul, el",-4,2010,11,15
235,170545,Colera,21,2010,59,38
236,250772,Coll de Nargó,0,2010,23,23
237,080692,Collbató,113,2010,317,204
238,430458,Colldejou,0,2010,8,8
239,080706,Collsuspina,4,2010,15,11
240,170558,Colomers,-4,2010,7,11
241,251636,"Coma i la Pedra, la",7,2010,22,15
242,251615,Conca de Dalt,12,2010,26,14
243,430461,Conesa,10,2010,21,11
244,430477,Constantí,114,2010,480,366
245,080713,Copons,11,2010,17,6
246,430483,Corbera d'Ebre,26,2010,70,44
247,080728,Corbera de Llobregat,-11,2010,675,686
248,250788,Corbins,-6,2010,70,76
249,170577,Corçà,13,2010,76,63
250,080734,Cornellà de Llobregat,-458,2010,4884,5342
251,170561,Cornellà del Terri,17,2010,132,115
252,430496,Cornudella de Montsant,20,2010,62,42
253,430509,Creixell,31,2010,324,293
254,170583,Crespià,1,2010,15,14
255,179011,"Cruïlles, Monells i Sant Sadurní de l'Heura",31,2010,107,76
256,080749,Cubelles,227,2010,1300,1073
257,250791,Cubells,-6,2010,12,18
258,430516,Cunit,130,2010,1261,1131
259,170600,Darnius,2,2010,30,28
260,170617,Das,-4,2010,14,18
261,439018,Deltebre,165,2010,500,335
262,080752,Dosrius,67,2010,347,280
263,430537,Duesaigües,3,2010,18,15
264,170622,"Escala, l'",166,2010,683,517
265,080765,Esparreguera,-107,2010,1111,1218
266,170638,Espinelves,5,2010,25,20
267,250812,"Espluga Calba, l'",7,2010,31,24
268,430542,"Espluga de Francolí, l'",-26,2010,176,202
269,080771,Esplugues de Llobregat,36,2010,3323,3287
270,170643,Espolla,13,2010,26,13
271,170656,Esponellà,-14,2010,19,33
272,250827,Espot,-9,2010,15,24
273,080787,"Espunyola, l'",8,2010,13,5
274,082541,"Esquirol, l'",-42,2010,78,120
275,250886,Estamariu,4,2010,4,0
276,080790,"Estany, l'",0,2010,14,14
277,250851,Estaràs,-8,2010,7,15
278,250864,Esterri d'Àneu,-18,2010,105,123
279,250870,Esterri de Cardós,2,2010,5,3
280,430555,Falset,13,2010,128,115
281,170059,"Far d'Empordà, el",4,2010,37,33
282,250899,Farrera,4,2010,6,2
283,430568,"Fatarella, la",-5,2010,20,25
284,430574,"Febró, la",9,2010,10,1
285,081347,Figaró-Montmany,34,2010,109,75
286,080804,Fígols,0,2010,4,4
287,259084,Fígols i Alinyà,-4,2010,8,12
288,430580,"Figuera, la",0,2010,8,8
289,170669,Figueres,134,2010,2843,2709
290,430593,Figuerola del Camp,6,2010,18,12
291,170675,Flaçà,-9,2010,55,64
292,430607,Flix,-39,2010,141,180
293,250925,"Floresta, la",-9,2010,5,14
294,080826,Fogars de la Selva,-20,2010,106,126
295,080811,Fogars de Montclús,-2,2010,30,32
296,170681,Foixà,-9,2010,3,12
297,080832,Folgueroles,-4,2010,70,74
298,250931,Fondarella,-4,2010,52,56
299,080847,Fonollosa,17,2010,71,54
300,170694,Fontanals de Cerdanya,9,2010,29,20
301,170708,Fontanilles,9,2010,14,5
302,170715,Fontcoberta,67,2010,119,52
303,080850,Font-rubí,9,2010,74,65
304,250946,Foradada,-1,2010,6,7
305,179026,Forallac,14,2010,142,128
306,430614,Forès,15,2010,18,3
307,170736,Fornells de la Selva,21,2010,115,94
308,170741,Fortià,14,2010,48,34
309,080863,"Franqueses del Vallès, les",400,2010,1388,988
310,430629,Freginals,28,2010,38,10
311,250962,"Fuliola, la",18,2010,69,51
312,250978,Fulleda,2,2010,11,9
313,080902,Gaià,-7,2010,13,20
314,430635,"Galera, la",-47,2010,39,86
315,080879,Gallifa,-11,2010,3,14
316,430640,Gandesa,7,2010,111,104
317,430653,Garcia,-2,2010,33,35
318,430666,"Garidells, els",-10,2010,5,15
319,080885,"Garriga, la",55,2010,745,690
320,170754,Garrigàs,-4,2010,12,16
321,170767,Garrigoles,7,2010,12,5
322,170773,Garriguella,10,2010,68,58
323,080898,Gavà,-365,2010,2597,2962
324,250984,Gavet de la Conca,-4,2010,19,23
325,080919,Gelida,89,2010,433,344
326,170789,Ger,5,2010,31,26
327,259123,Gimenells i el Pla de la Font,-10,2010,46,56
328,430672,Ginestar,-20,2010,27,47
329,170792,Girona,-455,2010,6637,7092
330,080924,Gironella,45,2010,253,208
331,080930,Gisclareny,-2,2010,2,4
332,430688,Godall,13,2010,28,15
333,250997,Golmés,11,2010,120,109
334,170806,Gombrèn,-16,2010,11,27
335,251001,Gósol,5,2010,15,10
336,080945,"Granada, la",28,2010,129,101
337,251018,"Granadella, la",-4,2010,28,32
338,080958,Granera,1,2010,4,3
339,251023,"Granja d'Escarp, la",-4,2010,51,55
340,080961,Granollers,61,2010,4063,4002
341,251039,Granyanella,-5,2010,6,11
342,251057,Granyena de les Garrigues,-6,2010,13,19
343,251044,Granyena de Segarra,-2,2010,3,5
344,430691,Gratallops,0,2010,12,12
345,080977,Gualba,58,2010,146,88
346,170813,Gualta,-5,2010,61,66
347,080996,Guardiola de Berguedà,10,2010,58,48
348,430705,"Guiamets, els",2,2010,14,12
349,170828,Guils de Cerdanya,42,2010,71,29
350,251095,Guimerà,-4,2010,19,23
351,259031,"Guingueta d'Àneu, la",-4,2010,27,31
352,251109,Guissona,227,2010,635,408
353,251116,Guixers,1,2010,6,5
354,081000,Gurb,1,2010,89,88
355,430712,Horta de Sant Joan,-9,2010,28,37
356,081017,"Hospitalet de Llobregat, l'",585,2010,19594,19009
357,081629,"Hostalets de Pierola, els",40,2010,248,208
358,170834,Hostalric,-9,2010,248,257
359,081022,Igualada,-118,2010,2017,2135
360,251155,Isona i Conca Dellà,-33,2010,30,63
361,170849,Isòvol,7,2010,37,30
362,251137,Ivars d'Urgell,-12,2010,75,87
363,251121,Ivars de Noguera,1,2010,21,20
364,251142,Ivorra,-1,2010,5,6
365,170852,Jafre,-7,2010,20,27
366,170865,"Jonquera, la",-18,2010,311,329
367,081038,Jorba,-6,2010,43,49
368,259101,Josa i Tuixén,-4,2010,11,15
369,170871,Juià,17,2010,58,41
370,251180,Juncosa,3,2010,22,19
371,251193,Juneda,22,2010,142,120
372,251214,Les,14,2010,95,81
373,251229,Linyola,-38,2010,103,141
374,081043,"Llacuna, la",6,2010,58,52
375,170887,Lladó,11,2010,59,48
376,251235,Lladorre,11,2010,16,5
377,251240,Lladurs,8,2010,12,4
378,081056,"Llagosta, la",-51,2010,755,806
379,170890,Llagostera,106,2010,547,441
380,170904,Llambilles,20,2010,37,17
381,170911,Llanars,-9,2010,43,52
382,170926,Llançà,-90,2010,300,390
383,251253,Llardecans,-1,2010,8,9
384,251266,Llavorsí,-3,2010,25,28
385,251207,Lleida,595,2010,7235,6640
386,170932,Llers,23,2010,88,65
387,251272,Lles de Cerdanya,0,2010,16,16
388,081075,Lliçà d'Amunt,58,2010,728,670
389,081081,Lliçà de Vall,29,2010,308,279
390,251288,Llimiana,10,2010,19,9
391,081069,Llinars del Vallès,90,2010,644,554
392,170947,Llívia,54,2010,160,106
393,430727,"Lloar, el",-2,2010,3,5
394,251291,Llobera,7,2010,11,4
395,430733,Llorac,7,2010,21,14
396,430748,Llorenç del Penedès,18,2010,143,125
397,170950,Lloret de Mar,268,2010,3221,2953
398,170963,"Llosses, les",-2,2010,14,16
399,081094,Lluçà,-5,2010,11,16
400,171024,Maçanet de Cabrenys,14,2010,46,32
401,171030,Maçanet de la Selva,71,2010,462,391
402,170979,Madremanya,10,2010,22,12
403,170985,Maià de Montcal,0,2010,18,18
404,251333,Maials,-21,2010,36,57
405,251305,Maldà,-2,2010,8,10
406,081108,Malgrat de Mar,-167,2010,1029,1196
407,081115,Malla,7,2010,16,9
408,081120,Manlleu,-114,2010,851,965
409,081136,Manresa,43,2010,3592,3549
410,430764,Marçà,-6,2010,30,36
411,430751,Margalef,1,2010,8,7
412,082423,Marganell,-7,2010,23,30
413,081141,Martorell,259,2010,1764,1505
414,081154,Martorelles,-19,2010,263,282
415,430770,Mas de Barberans,0,2010,18,18
416,171002,Masarac,18,2010,33,15
417,430786,Masdenverge,-1,2010,55,56
418,081167,"Masies de Roda, les",1,2010,53,52
419,081173,"Masies de Voltregà, les",-63,2010,95,158
420,430799,Masllorenç,5,2010,44,39
421,081189,"Masnou, el",-27,2010,1232,1259
422,430803,"Masó, la",-8,2010,5,13
423,430810,Maspujols,21,2010,50,29
424,081192,Masquefa,-29,2010,460,489
425,430825,"Masroig, el",6,2010,31,25
426,251312,Massalcoreig,-3,2010,25,28
427,171019,Massanes,-21,2010,46,67
428,251327,Massoteres,-12,2010,15,27
429,081206,Matadepera,-65,2010,369,434
430,081213,Mataró,284,2010,5569,5285
431,081228,Mediona,3,2010,181,178
432,251348,Menàrguens,40,2010,75,35
433,170998,Meranges,-2,2010,9,11
434,171058,Mieres,7,2010,25,18
435,430831,"Milà, el",4,2010,13,9
436,251351,Miralcamp,1,2010,75,74
437,430846,Miravet,-23,2010,31,54
438,081385,Moià,24,2010,287,263
439,430859,"Molar, el",6,2010,23,17
440,081234,Molins de Rei,-18,2010,993,1011
441,251370,Mollerussa,-76,2010,750,826
442,171061,Mollet de Peralada,7,2010,13,6
443,081249,Mollet del Vallès,-379,2010,2601,2980
444,171077,Molló,8,2010,19,11
445,251364,"Molsosa, la",-1,2010,2,3
446,081287,Monistrol de Calders,-3,2010,32,35
447,081271,Monistrol de Montserrat,-42,2010,182,224
448,171096,Montagut i Oix,-4,2010,51,55
449,430862,Montblanc,24,2010,361,337
450,430884,Montbrió del Camp,142,2010,309,167
451,081252,Montcada i Reixac,352,2010,2283,1931
452,081304,Montclar,2,2010,3,1
453,251399,Montellà i Martinet,22,2010,47,25
454,081311,Montesquiu,11,2010,63,52
455,251403,Montferrer i Castellbò,-6,2010,65,71
456,430897,Montferri,18,2010,42,24
457,251386,Montgai,5,2010,20,15
458,081265,Montgat,91,2010,699,608
459,081326,Montmajor,-6,2010,17,23
460,081332,Montmaneu,14,2010,18,4
461,430901,"Montmell, el",50,2010,158,108
462,081350,Montmeló,-124,2010,369,493
463,251425,Montoliu de Lleida,13,2010,28,15
464,251410,Montoliu de Segarra,-1,2010,6,7
465,251431,Montornès de Segarra,-6,2010,1,7
466,081363,Montornès del Vallès,127,2010,1051,924
467,430918,Mont-ral,2,2010,15,13
468,171100,Mont-ras,7,2010,108,101
469,430923,Mont-roig del Camp,268,2010,1218,950
470,081379,Montseny,7,2010,29,22
471,430939,Móra d'Ebre,-92,2010,293,385
472,430944,Móra la Nova,24,2010,139,115
473,430957,"Morell, el",34,2010,309,275
474,430960,"Morera de Montsant, la",6,2010,21,15
475,081290,Muntanyola,-22,2010,34,56
476,081398,Mura,-2,2010,10,12
477,251459,Nalec,2,2010,5,3
478,250254,Naut Aran,21,2010,110,89
479,081402,Navarcles,19,2010,265,246
480,081419,Navàs,-27,2010,188,215
481,171117,Navata,69,2010,117,48
482,251462,Navès,-3,2010,13,16
483,081424,"Nou de Berguedà, la",-6,2010,2,8
484,430976,"Nou de Gaià, la",17,2010,40,23
485,430982,Nulles,12,2010,44,32
486,251484,Odèn,8,2010,18,10
487,081430,Òdena,12,2010,212,200
488,171122,Ogassa,-5,2010,7,12
489,081458,Olèrdola,18,2010,231,213
490,081461,Olesa de Bonesvalls,59,2010,171,112
491,081477,Olesa de Montserrat,153,2010,1222,1069
492,251497,Oliana,17,2010,120,103
493,251500,Oliola,0,2010,5,5
494,251517,Olius,23,2010,57,34
495,081483,Olivella,157,2010,442,285
496,081496,Olost,-7,2010,35,42
497,171143,Olot,105,2010,1488,1383
498,251522,"Oluges, les",-3,2010,2,5
499,081445,Olvan,13,2010,60,47
500,251538,"Omellons, els",-12,2010,1,13
501,251543,"Omells de na Gaia, els",0,2010,5,5
502,171156,Ordis,-6,2010,14,20
503,251556,Organyà,8,2010,49,41
504,081509,Orís,-1,2010,12,13
505,081516,Oristà,-5,2010,23,28
506,081521,Orpí,-5,2010,9,14
507,081537,Òrrius,-10,2010,37,47
508,251569,Os de Balaguer,7,2010,51,44
509,171169,Osor,14,2010,29,15
510,251575,Ossó de Sió,-6,2010,2,8
511,081542,Pacs del Penedès,-7,2010,43,50
512,081555,Palafolls,123,2010,594,471
513,171175,Palafrugell,4,2010,1097,1093
514,171181,Palamós,-103,2010,1094,1197
515,251581,"Palau d'Anglesola, el",30,2010,128,98
516,171194,Palau de Santa Eulàlia,-1,2010,4,5
517,171215,Palau-sator,7,2010,18,11
518,171208,Palau-saverdera,12,2010,164,152
519,081568,Palau-solità i Plegamans,145,2010,778,633
520,431009,"Pallaresos, els",88,2010,289,201
521,081574,Pallejà,-39,2010,533,572
522,430995,"Palma d'Ebre, la",-3,2010,25,28
523,089058,"Palma de Cervelló, la",-11,2010,170,181
524,171236,Palol de Revardit,-15,2010,8,23
525,171241,Pals,-12,2010,157,169
526,081580,"Papiol, el",-18,2010,196,214
527,171254,Pardines,-2,2010,11,13
528,081593,Parets del Vallès,246,2010,1040,794
529,171267,Parlavà,-17,2010,12,29
530,431016,Passanant i Belltall,11,2010,19,8
531,171289,Pau,19,2010,43,24
532,431021,Paüls,6,2010,20,14
533,171292,Pedret i Marzà,0,2010,9,9
534,251641,Penelles,1,2010,36,35
535,171306,"Pera, la",-10,2010,24,34
536,081607,Perafita,4,2010,28,24
537,431037,Perafort,-8,2010,70,78
538,171328,Peralada,27,2010,116,89
539,251654,Peramola,4,2010,30,26
540,431042,"Perelló, el",40,2010,142,102
541,081614,Piera,244,2010,1022,778
542,431055,"Piles, les",-5,2010,10,15
543,081635,Pineda de Mar,9,2010,1607,1598
544,431068,"Pinell de Brai, el",2,2010,27,25
545,251667,Pinell de Solsonès,2,2010,5,3
546,251673,Pinós,-6,2010,7,13
547,431074,Pira,5,2010,22,17
548,431080,"Pla de Santa Maria, el",16,2010,151,135
549,081640,"Pla del Penedès, el",31,2010,98,67
550,171334,"Planes d'Hostoles, les",-1,2010,65,66
551,171349,Planoles,24,2010,41,17
552,259118,"Plans de Sió, els",0,2010,23,23
553,251689,"Poal, el",24,2010,35,11
554,251692,"Pobla de Cérvoles, la",5,2010,16,11
555,081653,"Pobla de Claramunt, la",-30,2010,120,150
556,081666,"Pobla de Lillet, la",19,2010,55,36
557,431093,"Pobla de Mafumet, la",147,2010,333,186
558,431107,"Pobla de Massaluca, la",2,2010,27,25
559,431114,"Pobla de Montornès, la",3,2010,239,236
560,251713,"Pobla de Segur, la",11,2010,224,213
561,431129,Poboleda,1,2010,19,18
562,081672,Polinyà,98,2010,484,386
563,431135,"Pont d'Armentera, el",-6,2010,23,29
564,250306,"Pont de Bar, el",-4,2010,10,14
565,171352,Pont de Molins,7,2010,41,34
566,251734,"Pont de Suert, el",-7,2010,132,139
567,081825,"Pont de Vilomara i Rocafort, el",-30,2010,174,204
568,431418,Pontils,1,2010,19,18
569,081688,Pontons,38,2010,92,54
570,171365,Pontós,-16,2010,7,23
571,251728,Ponts,-23,2010,160,183
572,171371,Porqueres,-8,2010,166,174
573,431140,Porrera,-11,2010,7,18
574,171404,"Port de la Selva, el",15,2010,89,74
575,171387,Portbou,1,2010,66,65
576,251749,"Portella, la",-23,2010,49,72
577,431153,Pradell de la Teixeta,11,2010,16,5
578,431166,Prades,11,2010,47,36
579,431172,Prat de Comte,-4,2010,7,11
580,081691,"Prat de Llobregat, el",-211,2010,2203,2414
581,431188,Pratdip,21,2010,64,43
582,081712,Prats de Lluçanès,-58,2010,75,133
583,081705,"Prats de Rei, els",-9,2010,22,31
584,251752,Prats i Sansor,35,2010,51,16
585,251765,Preixana,-8,2010,12,20
586,251771,Preixens,1,2010,18,17
587,082303,Premià de Dalt,103,2010,697,594
588,081727,Premià de Mar,-189,2010,1606,1795
589,171390,"Preses, les",4,2010,85,81
590,251790,Prullans,-16,2010,6,22
591,171411,Puigcerdà,57,2010,512,455
592,081748,Puigdàlber,1,2010,40,39
593,251804,Puiggròs,1,2010,7,6
594,431191,Puigpelat,6,2010,69,63
595,081751,Puig-reig,36,2010,232,196
596,251811,Puigverd d'Agramunt,5,2010,14,9
597,251826,Puigverd de Lleida,31,2010,100,69
598,081764,Pujalt,4,2010,7,3
599,081770,"Quar, la",5,2010,7,2
600,171426,Quart,137,2010,271,134
601,170433,Queralbs,-2,2010,7,9
602,431205,Querol,13,2010,52,39
603,171432,Rabós,4,2010,9,5
604,081786,Rajadell,13,2010,41,28
605,431212,Rasquera,-6,2010,24,30
606,171447,Regencós,-20,2010,20,40
607,081799,Rellinars,10,2010,52,42
608,431227,Renau,30,2010,34,4
609,431233,Reus,-617,2010,4710,5327
610,251832,Rialp,1,2010,40,39
611,431248,"Riba, la",-13,2010,46,59
612,431251,Riba-roja d'Ebre,-14,2010,53,67
613,259059,Ribera d'Ondara,2,2010,20,18
614,251850,Ribera d'Urgellet,-4,2010,86,90
615,171450,Ribes de Freser,23,2010,92,69
616,171463,Riells i Viabrea,108,2010,350,242
617,431264,"Riera de Gaià, la",-11,2010,85,96
618,251863,Riner,-3,2010,22,25
619,171479,Ripoll,-23,2010,358,381
620,081803,Ripollet,-6,2010,2101,2107
621,259139,Riu de Cerdanya,1,2010,6,5
622,171485,Riudarenes,55,2010,176,121
623,171498,Riudaura,-3,2010,14,17
624,431270,Riudecanyes,22,2010,68,46
625,431286,Riudecols,13,2010,68,55
626,171501,Riudellots de la Selva,31,2010,124,93
627,431299,Riudoms,-6,2010,300,306
628,171518,Riumors,23,2010,33,10
629,081810,"Roca del Vallès, la",-47,2010,536,583
630,431303,Rocafort de Queralt,-14,2010,14,28
631,431310,Roda de Berà,108,2010,535,427
632,081831,Roda de Ter,-8,2010,245,253
633,431325,Rodonyà,-26,2010,32,58
634,431331,Roquetes,-29,2010,461,490
635,171523,Roses,-877,2010,1209,2086
636,251898,Rosselló,70,2010,223,153
637,431346,"Rourell, el",4,2010,23,19
638,081846,Rubí,264,2010,3506,3242
639,081859,Rubió,3,2010,15,12
640,171539,Rupià,-1,2010,13,14
641,089019,Rupit i Pruit,-1,2010,8,9
642,081878,Sabadell,-157,2010,8790,8947
643,081884,Sagàs,0,2010,2,2
644,251902,Salàs de Pallars,16,2010,29,13
645,081901,Saldes,-10,2010,17,27
646,171544,Sales de Llierca,8,2010,10,2
647,081918,Sallent,-103,2010,190,293
648,431359,Salomó,19,2010,39,20
649,439057,Salou,-907,2010,3001,3908
650,171557,Salt,32,2010,2517,2485
651,251919,Sanaüja,8,2010,19,11
652,081944,Sant Adrià de Besòs,12,2010,2397,2385
653,081957,Sant Agustí de Lluçanès,-4,2010,2,6
654,081960,Sant Andreu de la Barca,186,2010,1627,1441
655,081976,Sant Andreu de Llavaneres,107,2010,712,605
656,171576,Sant Andreu Salou,-4,2010,1,5
657,171833,Sant Aniol de Finestres,0,2010,19,19
658,081982,Sant Antoni de Vilamajor,53,2010,413,360
659,081995,Sant Bartomeu del Grau,-8,2010,62,70
660,082009,Sant Boi de Llobregat,143,2010,3714,3571
661,082016,Sant Boi de Lluçanès,-24,2010,23,47
662,431362,Sant Carles de la Ràpita,-240,2010,802,1042
663,082037,Sant Cebrià de Vallalta,1,2010,219,218
664,082021,Sant Celoni,-46,2010,961,1007
665,082042,Sant Climent de Llobregat,59,2010,191,132
666,171582,Sant Climent Sescebes,24,2010,66,42
667,082055,Sant Cugat del Vallès,890,2010,5736,4846
668,082068,Sant Cugat Sesgarrigues,15,2010,41,26
669,251961,Sant Esteve de la Sarga,-6,2010,4,10
670,082074,Sant Esteve de Palautordera,-7,2010,171,178
671,082080,Sant Esteve Sesrovires,103,2010,494,391
672,171595,Sant Feliu de Buixalleu,-20,2010,21,41
673,082107,Sant Feliu de Codines,147,2010,540,393
674,171609,Sant Feliu de Guíxols,-159,2010,1227,1386
675,082114,Sant Feliu de Llobregat,-298,2010,1719,2017
676,171616,Sant Feliu de Pallerols,-29,2010,56,85
677,082129,Sant Feliu Sasserra,9,2010,34,25
678,171621,Sant Ferriol,-13,2010,27,40
679,082093,Sant Fost de Campsentelles,186,2010,559,373
680,082135,Sant Fruitós de Bages,-58,2010,390,448
681,171637,Sant Gregori,21,2010,156,135
682,251924,Sant Guim de Freixenet,-4,2010,50,54
683,251977,Sant Guim de la Plana,6,2010,14,8
684,171642,Sant Hilari Sacalm,2,2010,201,199
685,082153,Sant Hipòlit de Voltregà,31,2010,210,179
686,081939,Sant Iscle de Vallalta,-9,2010,73,82
687,439023,Sant Jaume d'Enveja,-6,2010,121,127
688,082166,Sant Jaume de Frontanyà,-5,2010,1,6
689,171655,Sant Jaume de Llierca,2,2010,49,47
690,431378,Sant Jaume dels Domenys,21,2010,198,177
691,171674,Sant Joan de les Abadesses,-14,2010,94,108
692,171680,Sant Joan de Mollet,12,2010,26,14
693,082188,Sant Joan de Vilatorrada,-96,2010,420,516
694,082172,Sant Joan Despí,145,2010,1665,1520
695,171851,Sant Joan les Fonts,28,2010,176,148
696,171668,Sant Jordi Desvalls,17,2010,55,38
697,089030,Sant Julià de Cerdanyola,-3,2010,20,23
698,171693,Sant Julià de Ramis,61,2010,247,186
699,082205,Sant Julià de Vilatorta,5,2010,113,108
700,179032,Sant Julià del Llor i Bonmatí,-24,2010,65,89
701,082212,Sant Just Desvern,363,2010,1178,815
702,082227,Sant Llorenç d'Hortons,54,2010,178,124
703,171714,Sant Llorenç de la Muga,1,2010,22,21
704,251930,Sant Llorenç de Morunys,-35,2010,35,70
705,082233,Sant Llorenç Savall,14,2010,129,115
706,082251,Sant Martí d'Albars,1,2010,7,6
707,082248,Sant Martí de Centelles,30,2010,114,84
708,171729,Sant Martí de Llémena,26,2010,51,25
709,259025,Sant Martí de Riucorb,3,2010,18,15
710,082264,Sant Martí de Tous,9,2010,46,37
711,082270,Sant Martí Sarroca,34,2010,229,195
712,082286,Sant Martí Sesgueioles,-3,2010,7,10
713,171735,Sant Martí Vell,-3,2010,18,21
714,082299,Sant Mateu de Bages,-14,2010,15,29
715,171740,Sant Miquel de Campmajor,-10,2010,13,23
716,171753,Sant Miquel de Fluvià,-3,2010,43,46
717,171766,Sant Mori,31,2010,36,5
718,171772,Sant Pau de Segúries,-10,2010,30,40
719,082310,Sant Pere de Ribes,5,2010,1879,1874
720,082325,Sant Pere de Riudebitlles,-6,2010,116,122
721,082331,Sant Pere de Torelló,-1,2010,126,127
722,082346,Sant Pere de Vilamajor,72,2010,301,229
723,171788,Sant Pere Pescador,74,2010,236,162
724,081897,Sant Pere Sallavinera,-2,2010,4,6
725,082359,Sant Pol de Mar,13,2010,297,284
726,082362,Sant Quintí de Mediona,-51,2010,102,153
727,082378,Sant Quirze de Besora,-28,2010,79,107
728,082384,Sant Quirze del Vallès,239,2010,1027,788
729,082397,Sant Quirze Safaja,12,2010,65,53
730,251945,Sant Ramon,-11,2010,19,30
731,082401,Sant Sadurní d'Anoia,-31,2010,542,573
732,082418,Sant Sadurní d'Osormort,1,2010,2,1
733,080983,Sant Salvador de Guardiola,46,2010,233,187
734,082628,Sant Vicenç de Castellet,137,2010,636,499
735,082649,Sant Vicenç de Montalt,99,2010,428,329
736,082652,Sant Vicenç de Torelló,18,2010,81,63
737,082634,Sant Vicenç dels Horts,-93,2010,1297,1390
738,431384,Santa Bàrbara,37,2010,211,174
739,082439,Santa Cecília de Voltregà,0,2010,5,5
740,082444,Santa Coloma de Cervelló,23,2010,367,344
741,171805,Santa Coloma de Farners,58,2010,635,577
742,082457,Santa Coloma de Gramenet,-58,2010,9605,9663
743,431397,Santa Coloma de Queralt,-30,2010,107,137
744,171812,Santa Cristina d'Aro,-24,2010,345,369
745,082460,Santa Eugènia de Berga,30,2010,120,90
746,082476,Santa Eulàlia de Riuprimer,49,2010,87,38
747,082482,Santa Eulàlia de Ronçana,46,2010,391,345
748,082495,Santa Fe del Penedès,23,2010,28,5
749,171827,Santa Llogaia d'Àlguema,10,2010,33,23
750,082508,Santa Margarida de Montbui,-114,2010,440,554
751,082515,Santa Margarida i els Monjos,30,2010,477,447
752,082589,Santa Maria d'Oló,-10,2010,28,38
753,082536,Santa Maria de Besora,-8,2010,3,11
754,082567,Santa Maria de Martorelles,5,2010,45,40
755,082554,Santa Maria de Merlès,8,2010,15,7
756,082573,Santa Maria de Miralles,6,2010,8,2
757,082592,Santa Maria de Palautordera,80,2010,512,432
758,431401,Santa Oliva,47,2010,275,228
759,171848,Santa Pau,1,2010,53,52
760,082606,Santa Perpètua de Mogoda,-136,2010,1254,1390
761,082613,Santa Susanna,5,2010,291,286
762,081923,Santpedor,83,2010,359,276
763,431423,Sarral,-25,2010,80,105
764,171864,Sarrià de Ter,80,2010,328,248
765,252017,Sarroca de Bellera,-8,2010,3,11
766,252000,Sarroca de Lleida,6,2010,23,17
767,171870,"Saus, Camallera i Llampaies",16,2010,68,52
768,431439,Savallà del Comtat,-1,2010,2,3
769,431444,"Secuita, la",23,2010,107,84
770,171886,"Selva de Mar, la",-9,2010,3,12
771,431457,"Selva del Camp, la",88,2010,254,166
772,431460,Senan,-1,2010,0,1
773,430445,"Sénia, la",-47,2010,258,305
774,252022,Senterada,-5,2010,5,10
775,250352,"Sentiu de Sió, la",-8,2010,16,24
776,082671,Sentmenat,222,2010,557,335
777,171903,Serinyà,13,2010,62,49
778,252043,Seròs,39,2010,124,85
779,171910,Serra de Daró,-1,2010,5,6
780,171925,Setcases,-2,2010,4,6
781,252038,"Seu d'Urgell, la",-41,2010,717,758
782,082690,Seva,-6,2010,185,191
783,252056,Sidamon,-24,2010,20,44
784,171931,Sils,116,2010,432,316
785,082704,Sitges,394,2010,2195,1801
786,170524,Siurana,-18,2010,8,26
787,082711,Sobremunt,-4,2010,3,7
788,252069,"Soleràs, el",-7,2010,9,16
789,431476,Solivella,15,2010,44,29
790,252075,Solsona,18,2010,389,371
791,082726,Sora,-9,2010,3,12
792,252081,Soriguera,-3,2010,23,26
793,252094,Sort,-22,2010,151,173
794,252108,Soses,-2,2010,88,90
795,082732,Subirats,3,2010,162,159
796,252115,Sudanell,7,2010,39,32
797,252120,Sunyer,0,2010,8,8
798,082747,Súria,-75,2010,164,239
799,171946,Susqueda,1,2010,13,12
800,082763,Tagamanent,6,2010,25,19
801,082779,Talamanca,11,2010,21,10
802,252154,Talarn,130,2010,166,36
803,252167,Talavera,-12,2010,5,17
804,171959,"Tallada d'Empordà, la",12,2010,45,33
805,082785,Taradell,65,2010,256,191
806,431482,Tarragona,-235,2010,6878,7113
807,252173,Tàrrega,-147,2010,851,998
808,252189,Tarrés,0,2010,2,2
809,252192,Tarroja de Segarra,7,2010,9,2
810,082750,Tavèrnoles,1,2010,15,14
811,082802,Tavertet,-5,2010,10,15
812,082819,Teià,49,2010,325,276
813,252206,Térmens,4,2010,98,94
814,171962,Terrades,-4,2010,17,21
815,082798,Terrassa,56,2010,9263,9207
816,082824,Tiana,170,2010,454,284
817,252213,Tírvia,-1,2010,9,10
818,252228,Tiurana,1,2010,5,4
819,431495,Tivenys,6,2010,24,18
820,431508,Tivissa,-11,2010,77,88
821,082830,Tona,89,2010,433,344
822,252234,Torà,-10,2010,72,82
823,082845,Tordera,318,2010,1183,865
824,082858,Torelló,-32,2010,583,615
825,252249,"Torms, els",-1,2010,3,4
826,252252,Tornabous,14,2010,64,50
827,252271,"Torre de Cabdella, la",-22,2010,22,44
828,082861,"Torre de Claramunt, la",14,2010,235,221
829,431515,"Torre de Fontaubella, la",-2,2010,5,7
830,431520,"Torre de l'Espanyol, la",-16,2010,45,61
831,252265,Torrebesses,4,2010,9,5
832,431536,Torredembarra,51,2010,1178,1127
833,252287,Torrefarrera,110,2010,358,248
834,259078,Torrefeta i Florejacs,21,2010,37,16
835,252304,Torregrossa,18,2010,89,71
836,252311,Torrelameu,18,2010,47,29
837,082877,Torrelavit,20,2010,75,55
838,082883,Torrelles de Foix,-81,2010,169,250
839,082896,Torrelles de Llobregat,77,2010,329,252
840,171978,Torrent,0,2010,9,9
841,252326,Torres de Segre,79,2010,181,102
842,252332,Torre-serona,-2,2010,15,17
843,171984,Torroella de Fluvià,-8,2010,76,84
844,171997,Torroella de Montgrí,-176,2010,708,884
845,431541,Torroja del Priorat,6,2010,12,6
846,172001,Tortellà,-1,2010,34,35
847,431554,Tortosa,-92,2010,1553,1645
848,172018,Toses,4,2010,9,5
849,172023,Tossa de Mar,10,2010,294,284
850,252347,Tremp,361,2010,783,422
851,172044,Ullà,42,2010,143,101
852,082900,Ullastrell,14,2010,106,92
853,172057,Ullastret,14,2010,30,16
854,431567,Ulldecona,-4,2010,481,485
855,431573,Ulldemolins,-13,2010,25,38
856,172039,Ultramort,5,2010,15,10
857,172060,Urús,-1,2010,13,14
858,082917,Vacarisses,119,2010,400,281
859,170144,"Vajol, la",4,2010,10,6
860,172076,"Vall d'en Bas, la",51,2010,135,84
861,172082,"Vall de Bianya, la",-7,2010,77,84
862,250432,"Vall de Boí, la",4,2010,61,57
863,259010,Vall de Cardós,-17,2010,18,35
864,082922,Vallbona d'Anoia,8,2010,73,65
865,252385,Vallbona de les Monges,18,2010,24,6
866,082938,Vallcebre,2,2010,18,16
867,431589,Vallclara,7,2010,10,3
868,252402,Vallfogona de Balaguer,46,2010,125,79
869,171707,Vallfogona de Ripollès,-9,2010,7,16
870,431592,Vallfogona de Riucorb,3,2010,8,5
871,082943,Vallgorguina,-3,2010,196,199
872,082956,Vallirana,144,2010,818,674
873,172095,Vall-llobrega,3,2010,45,42
874,431606,Vallmoll,14,2010,115,101
875,082969,Vallromanes,19,2010,133,114
876,431613,Valls,-221,2010,1032,1253
877,259062,"Valls d'Aguilar, les",5,2010,18,13
878,252398,"Valls de Valira, les",63,2010,104,41
879,431628,Vandellòs i l'Hospitalet de l'Infant,54,2010,473,419
880,259097,"Vansa i Fórnols, la",-3,2010,8,11
881,082975,Veciana,0,2010,9,9
882,431634,"Vendrell, el",169,2010,2583,2414
883,172109,Ventalló,6,2010,52,46
884,252424,Verdú,13,2010,52,39
885,172116,Verges,40,2010,96,56
886,431649,Vespella de Gaià,-7,2010,30,37
887,082981,Vic,299,2010,2485,2186
888,172121,Vidrà,-2,2010,10,12
889,172137,Vidreres,53,2010,570,517
890,252430,Vielha e Mijaran,-41,2010,459,500
891,431652,Vilabella,6,2010,34,28
892,172142,Vilabertran,-7,2010,62,69
893,172155,Vilablareix,98,2010,154,56
894,082994,Vilada,-5,2010,11,16
895,172174,Viladamat,1,2010,22,21
896,172168,Viladasens,-6,2010,13,19
897,083015,Viladecans,205,2010,3171,2966
898,083008,Viladecavalls,24,2010,416,392
899,172180,Vilademuls,14,2010,59,45
900,172207,Viladrau,-4,2010,50,54
901,172214,Vilafant,26,2010,292,266
902,083054,Vilafranca del Penedès,346,2010,2252,1906
903,252445,Vilagrassa,22,2010,55,33
904,172235,Vilajuïga,-3,2010,54,57
905,431750,Vilalba dels Arcs,-7,2010,5,12
906,083067,Vilalba Sasserra,-25,2010,65,90
907,252458,Vilaller,0,2010,33,33
908,172240,Vilallonga de Ter,0,2010,17,17
909,431665,Vilallonga del Camp,109,2010,213,104
910,172253,Vilamacolum,-27,2010,19,46
911,172266,Vilamalla,6,2010,73,67
912,172272,Vilamaniscle,-3,2010,12,15
913,252477,Vilamòs,-10,2010,17,27
914,172288,Vilanant,-4,2010,33,37
915,431671,Vilanova d'Escornalbou,-8,2010,34,42
916,252483,Vilanova de Bellpuig,9,2010,47,38
917,252496,Vilanova de l'Aguda,4,2010,13,9
918,252542,Vilanova de la Barca,-49,2010,60,109
919,252509,Vilanova de Meià,9,2010,27,18
920,431687,Vilanova de Prades,-10,2010,11,21
921,083036,Vilanova de Sau,8,2010,27,19
922,252516,Vilanova de Segrià,14,2010,74,60
923,083020,Vilanova del Camí,-171,2010,580,751
924,089024,Vilanova del Vallès,141,2010,342,201
925,083073,Vilanova i la Geltrú,169,2010,3424,3255
926,431690,Vilaplana,10,2010,29,19
927,431704,Vila-rodona,-23,2010,77,100
928,172305,Vila-sacra,27,2010,78,51
929,252521,Vila-sana,4,2010,30,26
930,431711,Vila-seca,156,2010,1712,1556
931,082140,Vilassar de Dalt,36,2010,412,376
932,082191,Vilassar de Mar,115,2010,1086,971
933,172229,Vilaür,3,2010,13,10
934,431726,Vilaverd,3,2010,29,26
935,431732,"Vilella Alta, la",4,2010,7,3
936,431747,"Vilella Baixa, la",-1,2010,8,9
937,172333,Vilobí d'Onyar,-23,2010,135,158
938,083041,Vilobí del Penedès,-36,2010,20,56
939,172327,Vilopriu,5,2010,21,16
940,252537,"Vilosell, el",5,2010,15,10
941,431763,Vimbodí i Poblet,-20,2010,37,57
942,252555,Vinaixa,-24,2010,14,38
943,431779,Vinebre,-3,2010,26,29
944,431785,Vinyols i els Arcs,23,2010,167,144
945,083089,Viver i Serrateix,-12,2010,4,16
946,430521,Xerta,3,2010,54,51
0,250019,Abella de la Conca,-6,2011,6,12
1,080018,Abrera,173,2011,668,495
2,250024,Àger,5,2011,34,29
3,250030,Agramunt,-32,2011,210,242
4,080023,Aguilar de Segarra,9,2011,14,5
5,170010,Agullana,21,2011,70,49
6,080142,Aiguafreda,-11,2011,130,141
7,430017,Aiguamúrcia,-25,2011,59,84
8,170025,Aiguaviva,8,2011,42,34
9,250387,Aitona,21,2011,130,109
10,250045,"Alamús, els",8,2011,43,35
11,250058,Alàs i Cerc,11,2011,26,15
12,250061,"Albagés, l'",-15,2011,14,29
13,170031,Albanyà,2,2011,14,12
14,250077,Albatàrrec,28,2011,151,123
15,250083,Albesa,-5,2011,69,74
16,250096,"Albi, l'",-7,2011,21,28
17,430022,Albinyana,20,2011,147,127
18,430038,"Albiol, l'",10,2011,22,12
19,170046,Albons,-5,2011,47,52
20,430043,Alcanar,99,2011,587,488
21,250100,Alcanó,1,2011,5,4
22,250117,Alcarràs,301,2011,807,506
23,250122,Alcoletge,156,2011,299,143
24,430056,Alcover,-5,2011,244,249
25,439044,"Aldea, l'",-90,2011,234,324
26,430069,Aldover,-10,2011,30,40
27,430075,"Aleixar, l'",12,2011,57,45
28,080039,Alella,43,2011,556,513
29,430081,Alfara de Carles,4,2011,18,14
30,250138,Alfarràs,-20,2011,107,127
31,250143,Alfés,10,2011,25,15
32,430094,Alforja,-14,2011,90,104
33,250156,Algerri,-5,2011,14,19
34,250169,Alguaire,-4,2011,138,142
35,250175,Alins,6,2011,7,1
36,430108,Alió,12,2011,21,9
37,250194,Almacelles,43,2011,297,254
38,250208,Almatret,-17,2011,8,25
39,250215,Almenar,69,2011,198,129
40,430115,Almoster,16,2011,64,48
41,250220,Alòs de Balaguer,-3,2011,5,8
42,170062,Alp,-8,2011,125,133
43,080044,Alpens,-2,2011,9,11
44,250236,Alpicat,4,2011,233,229
45,250241,Alt Àneu,-2,2011,22,24
46,430120,Altafulla,45,2011,368,323
47,170078,Amer,6,2011,111,105
48,430136,"Ametlla de Mar, l'",43,2011,322,279
49,080057,"Ametlla del Vallès, l'",60,2011,488,428
50,439060,"Ampolla, l'",-18,2011,246,264
51,430141,Amposta,-21,2011,1029,1050
52,170084,Anglès,66,2011,323,257
53,250273,Anglesola,5,2011,60,55
54,250292,Arbeca,19,2011,99,80
55,430167,"Arboç, l'",-61,2011,272,333
56,430154,Arbolí,0,2011,8,8
57,170097,Arbúcies,5,2011,361,356
58,080060,Arenys de Mar,204,2011,972,768
59,080076,Arenys de Munt,8,2011,406,398
60,170101,Argelaguer,1,2011,21,20
61,080082,Argençola,7,2011,20,13
62,430173,"Argentera, l'",-2,2011,12,14
63,080095,Argentona,133,2011,608,475
64,170118,"Armentera, l'",-2,2011,43,45
65,430189,Arnes,0,2011,20,20
66,250313,Arres,1,2011,3,2
67,250328,Arsèguel,-8,2011,7,15
68,080109,Artés,26,2011,264,238
69,250334,Artesa de Lleida,-12,2011,63,75
70,250349,Artesa de Segre,-46,2011,178,224
71,430192,Ascó,21,2011,64,43
72,250365,Aspa,-2,2011,3,5
73,250371,"Avellanes i Santa Linya, les",-3,2011,26,29
74,080116,Avià,18,2011,103,85
75,080121,Avinyó,11,2011,92,81
76,170123,Avinyonet de Puigventós,17,2011,84,67
77,080137,Avinyonet del Penedès,10,2011,99,89
78,080155,Badalona,1002,2011,14021,13019
79,089045,Badia del Vallès,-115,2011,522,637
80,080168,Bagà,39,2011,134,95
81,250390,Baix Pallars,-10,2011,9,19
82,250404,Balaguer,34,2011,947,913
83,080174,Balenyà,4,2011,190,186
84,080180,Balsareny,6,2011,133,127
85,430206,Banyeres del Penedès,0,2011,185,185
86,170157,Banyoles,159,2011,950,791
87,250411,Barbens,50,2011,96,46
88,430213,Barberà de la Conca,-9,2011,24,33
89,082520,Barberà del Vallès,161,2011,1692,1531
90,080193,Barcelona,8304,2011,99326,91022
91,250426,"Baronia de Rialb, la",-2,2011,11,13
92,170160,Bàscara,-13,2011,44,57
93,250447,Bassella,-6,2011,4,10
94,430228,Batea,4,2011,51,47
95,250450,Bausen,0,2011,2,2
96,080207,Begues,67,2011,417,350
97,170139,Begur,4,2011,239,235
98,250463,Belianes,-8,2011,12,20
99,251706,Bellaguarda,10,2011,12,2
100,170182,Bellcaire d'Empordà,12,2011,47,35
101,250479,Bellcaire d'Urgell,20,2011,83,63
102,250485,Bell-lloc d'Urgell,-20,2011,69,89
103,250498,Bellmunt d'Urgell,-2,2011,4,6
104,430234,Bellmunt del Priorat,1,2011,20,19
105,080214,Bellprat,-2,2011,4,6
106,250501,Bellpuig,24,2011,271,247
107,430249,Bellvei,20,2011,156,136
108,250518,Bellver de Cerdanya,39,2011,148,109
109,250523,Bellvís,-6,2011,115,121
110,250539,Benavent de Segrià,-15,2011,46,61
111,430252,Benifallet,-16,2011,11,27
112,430265,Benissanet,37,2011,75,38
113,080229,Berga,-135,2011,603,738
114,170195,Besalú,52,2011,145,93
115,170209,Bescanó,98,2011,276,178
116,170216,Beuda,-5,2011,10,15
117,080235,Bigues i Riells del Fai,-8,2011,453,461
118,250557,Biosca,-4,2011,5,9
119,170221,"Bisbal d'Empordà, la",76,2011,601,525
120,430271,"Bisbal de Falset, la",3,2011,13,10
121,430287,"Bisbal del Penedès, la",1,2011,258,257
122,172348,Biure,5,2011,16,11
123,430290,Blancafort,10,2011,32,22
124,170237,Blanes,-79,2011,2387,2466
125,170293,Boadella i les Escaules,-1,2011,18,19
126,170242,Bolvir,6,2011,51,45
127,430304,Bonastre,14,2011,65,51
128,250576,"Bòrdes, Es",-1,2011,20,21
129,170255,Bordils,0,2011,125,125
130,250582,"Borges Blanques, les",46,2011,306,260
131,430311,"Borges del Camp, les",-6,2011,105,111
132,170268,Borrassà,0,2011,44,44
133,080240,Borredà,5,2011,41,36
134,250595,Bossòst,8,2011,88,80
135,430326,Bot,-7,2011,17,24
136,430332,Botarell,14,2011,70,56
137,250560,Bovera,-13,2011,4,17
138,430347,Bràfim,2,2011,38,36
139,170274,Breda,-6,2011,145,151
140,080253,"Bruc, el",20,2011,145,125
141,080266,"Brull, el",10,2011,16,6
142,170280,Brunyola i Sant Martí Sapresa,8,2011,23,15
143,430350,Cabacés,8,2011,19,11
144,250609,Cabanabona,-3,2011,0,3
145,170314,Cabanelles,-1,2011,19,20
146,170307,Cabanes,8,2011,75,67
147,080272,"Cabanyes, les",10,2011,65,55
148,250616,Cabó,3,2011,5,2
149,430363,Cabra del Camp,0,2011,86,86
150,080288,Cabrera d'Anoia,22,2011,119,97
151,080291,Cabrera de Mar,6,2011,250,244
152,080305,Cabrils,-65,2011,382,447
153,170329,Cadaqués,2,2011,152,150
154,080312,Calaf,3,2011,182,179
155,430379,Calafell,-381,2011,2184,2565
156,080348,Calders,-4,2011,44,48
157,080327,Caldes d'Estrac,23,2011,272,249
158,170335,Caldes de Malavella,36,2011,473,437
159,080333,Caldes de Montbui,27,2011,782,755
160,080351,Calella,-111,2011,1317,1428
161,080370,Calldetenes,-6,2011,118,124
162,080386,Callús,-34,2011,79,113
163,080364,Calonge de Segarra,6,2011,10,4
164,170340,Calonge i Sant Antoni,99,2011,883,784
165,250621,Camarasa,-1,2011,39,40
166,439039,Camarles,2,2011,110,108
167,430385,Cambrils,393,2011,2341,1948
168,170353,Camós,-2,2011,18,20
169,170366,Campdevànol,-4,2011,133,137
170,170372,Campelles,1,2011,10,9
171,080399,Campins,15,2011,46,31
172,170388,Campllong,21,2011,38,17
173,170391,Camprodon,33,2011,163,130
174,250637,Canejan,6,2011,7,1
175,170405,Canet d'Adri,16,2011,39,23
176,080403,Canet de Mar,161,2011,874,713
177,439076,"Canonja, la",0,2011,0,0
178,080410,Canovelles,174,2011,1216,1042
179,080425,Cànoves i Samalús,32,2011,162,130
180,170412,Cantallops,16,2011,28,12
181,080431,Canyelles,-34,2011,258,292
182,430398,Capafonts,-2,2011,6,8
183,430402,Capçanes,0,2011,15,15
184,080446,Capellades,-61,2011,234,295
185,170427,Capmany,4,2011,30,26
186,080459,Capolat,1,2011,8,7
187,080462,Cardedeu,101,2011,833,732
188,080478,Cardona,-21,2011,117,138
189,080484,Carme,-5,2011,31,36
190,430419,Caseres,-3,2011,10,13
191,170448,Cassà de la Selva,25,2011,547,522
192,080497,Casserres,0,2011,60,60
193,080575,Castell de l'Areny,2,2011,5,3
194,259046,Castell de Mur,-8,2011,6,14
195,250642,Castellar de la Ribera,3,2011,7,4
196,080522,Castellar de n'Hug,6,2011,21,15
197,080500,Castellar del Riu,2,2011,7,5
198,080517,Castellar del Vallès,31,2011,944,913
199,080538,Castellbell i el Vilar,-68,2011,197,265
200,080543,Castellbisbal,38,2011,507,469
201,080556,Castellcir,10,2011,55,45
202,250674,Castelldans,23,2011,55,32
203,080569,Castelldefels,-20,2011,4680,4700
204,080581,Castellet i la Gornal,12,2011,172,160
205,170464,Castellfollit de la Roca,6,2011,54,48
206,080608,Castellfollit de Riubregós,-1,2011,6,7
207,080594,Castellfollit del Boix,11,2011,22,11
208,080615,Castellgalí,28,2011,148,120
209,080620,Castellnou de Bages,83,2011,133,50
210,250680,Castellnou de Seana,27,2011,49,22
211,170470,Castelló d'Empúries,-88,2011,982,1070
212,250693,Castelló de Farfanya,1,2011,28,27
213,080636,Castellolí,8,2011,19,11
214,170486,Castell-Platja d'Aro,81,2011,1027,946
215,250707,Castellserà,-9,2011,30,39
216,080641,Castellterçol,25,2011,152,127
217,430424,Castellvell del Camp,41,2011,126,85
218,080654,Castellví de la Marca,-3,2011,65,68
219,080667,Castellví de Rosanes,-30,2011,90,120
220,430430,"Catllar, el",26,2011,249,223
221,250714,Cava,1,2011,4,3
222,171899,"Cellera de Ter, la",-44,2011,48,92
223,170499,Celrà,112,2011,379,267
224,080673,Centelles,-17,2011,291,308
225,082687,Cercs,16,2011,76,60
226,082665,Cerdanyola del Vallès,-342,2011,2899,3241
227,080689,Cervelló,17,2011,528,511
228,250729,Cervera,-1,2011,489,490
229,250735,Cervià de les Garrigues,-39,2011,21,60
230,170502,Cervià de Ter,14,2011,55,41
231,170519,Cistella,10,2011,25,15
232,250740,Ciutadilla,-1,2011,9,10
233,250753,Clariana de Cardener,-16,2011,2,18
234,250766,"Cogul, el",9,2011,19,10
235,170545,Colera,-14,2011,28,42
236,250772,Coll de Nargó,-6,2011,17,23
237,080692,Collbató,26,2011,234,208
238,430458,Colldejou,-5,2011,5,10
239,080706,Collsuspina,-3,2011,15,18
240,170558,Colomers,10,2011,13,3
241,251636,"Coma i la Pedra, la",2,2011,15,13
242,251615,Conca de Dalt,16,2011,32,16
243,430461,Conesa,0,2011,10,10
244,430477,Constantí,24,2011,506,482
245,080713,Copons,-9,2011,8,17
246,430483,Corbera d'Ebre,40,2011,68,28
247,080728,Corbera de Llobregat,67,2011,802,735
248,250788,Corbins,24,2011,87,63
249,170577,Corçà,-38,2011,52,90
250,080734,Cornellà de Llobregat,364,2011,5011,4647
251,170561,Cornellà del Terri,20,2011,140,120
252,430496,Cornudella de Montsant,4,2011,53,49
253,430509,Creixell,11,2011,275,264
254,170583,Crespià,12,2011,25,13
255,179011,"Cruïlles, Monells i Sant Sadurní de l'Heura",-27,2011,66,93
256,080749,Cubelles,61,2011,1159,1098
257,250791,Cubells,6,2011,15,9
258,430516,Cunit,95,2011,1259,1164
259,170600,Darnius,3,2011,36,33
260,170617,Das,8,2011,15,7
261,439018,Deltebre,81,2011,491,410
262,080752,Dosrius,38,2011,374,336
263,430537,Duesaigües,2,2011,19,17
264,170622,"Escala, l'",48,2011,560,512
265,080765,Esparreguera,-202,2011,937,1139
266,170638,Espinelves,0,2011,7,7
267,250812,"Espluga Calba, l'",-30,2011,25,55
268,430542,"Espluga de Francolí, l'",-2,2011,142,144
269,080771,Esplugues de Llobregat,58,2011,3045,2987
270,170643,Espolla,7,2011,18,11
271,170656,Esponellà,-2,2011,37,39
272,250827,Espot,0,2011,11,11
273,080787,"Espunyola, l'",-7,2011,11,18
274,082541,"Esquirol, l'",-30,2011,72,102
275,250886,Estamariu,0,2011,3,3
276,080790,"Estany, l'",8,2011,21,13
277,250851,Estaràs,1,2011,2,1
278,250864,Esterri d'Àneu,-23,2011,79,102
279,250870,Esterri de Cardós,-1,2011,3,4
280,430555,Falset,-10,2011,102,112
281,170059,"Far d'Empordà, el",-1,2011,25,26
282,250899,Farrera,0,2011,4,4
283,430568,"Fatarella, la",-10,2011,18,28
284,430574,"Febró, la",-1,2011,2,3
285,081347,Figaró-Montmany,5,2011,85,80
286,080804,Fígols,-3,2011,1,4
287,259084,Fígols i Alinyà,1,2011,5,4
288,430580,"Figuera, la",-1,2011,9,10
289,170669,Figueres,246,2011,2962,2716
290,430593,Figuerola del Camp,-1,2011,17,18
291,170675,Flaçà,14,2011,76,62
292,430607,Flix,24,2011,155,131
293,250925,"Floresta, la",-4,2011,8,12
294,080826,Fogars de la Selva,25,2011,110,85
295,080811,Fogars de Montclús,-8,2011,33,41
296,170681,Foixà,-6,2011,8,14
297,080832,Folgueroles,-9,2011,77,86
298,250931,Fondarella,-3,2011,37,40
299,080847,Fonollosa,16,2011,80,64
300,170694,Fontanals de Cerdanya,12,2011,45,33
301,170708,Fontanilles,-8,2011,6,14
302,170715,Fontcoberta,31,2011,83,52
303,080850,Font-rubí,-27,2011,50,77
304,250946,Foradada,3,2011,12,9
305,179026,Forallac,-44,2011,113,157
306,430614,Forès,-8,2011,2,10
307,170736,Fornells de la Selva,41,2011,136,95
308,170741,Fortià,18,2011,45,27
309,080863,"Franqueses del Vallès, les",154,2011,1340,1186
310,430629,Freginals,12,2011,27,15
311,250962,"Fuliola, la",41,2011,92,51
312,250978,Fulleda,-2,2011,2,4
313,080902,Gaià,-5,2011,4,9
314,430635,"Galera, la",1,2011,31,30
315,080879,Gallifa,-6,2011,11,17
316,430640,Gandesa,-59,2011,97,156
317,430653,Garcia,6,2011,34,28
318,430666,"Garidells, els",3,2011,8,5
319,080885,"Garriga, la",152,2011,746,594
320,170754,Garrigàs,-4,2011,35,39
321,170767,Garrigoles,3,2011,12,9
322,170773,Garriguella,-7,2011,66,73
323,080898,Gavà,285,2011,2809,2524
324,250984,Gavet de la Conca,10,2011,16,6
325,080919,Gelida,22,2011,359,337
326,170789,Ger,5,2011,33,28
327,259123,Gimenells i el Pla de la Font,1,2011,52,51
328,430672,Ginestar,-39,2011,26,65
329,170792,Girona,-325,2011,6793,7118
330,080924,Gironella,-46,2011,181,227
331,080930,Gisclareny,0,2011,2,2
332,430688,Godall,1,2011,19,18
333,250997,Golmés,40,2011,123,83
334,170806,Gombrèn,-3,2011,10,13
335,251001,Gósol,-6,2011,12,18
336,080945,"Granada, la",42,2011,121,79
337,251018,"Granadella, la",-4,2011,20,24
338,080958,Granera,3,2011,7,4
339,251023,"Granja d'Escarp, la",23,2011,63,40
340,080961,Granollers,-166,2011,3857,4023
341,251039,Granyanella,1,2011,4,3
342,251057,Granyena de les Garrigues,6,2011,12,6
343,251044,Granyena de Segarra,-3,2011,4,7
344,430691,Gratallops,-3,2011,15,18
345,080977,Gualba,55,2011,133,78
346,170813,Gualta,7,2011,62,55
347,080996,Guardiola de Berguedà,-26,2011,44,70
348,430705,"Guiamets, els",-10,2011,11,21
349,170828,Guils de Cerdanya,-9,2011,34,43
350,251095,Guimerà,-8,2011,17,25
351,259031,"Guingueta d'Àneu, la",-7,2011,14,21
352,251109,Guissona,155,2011,479,324
353,251116,Guixers,0,2011,7,7
354,081000,Gurb,34,2011,118,84
355,430712,Horta de Sant Joan,-5,2011,36,41
356,081017,"Hospitalet de Llobregat, l'",-811,2011,19462,20273
357,081629,"Hostalets de Pierola, els",30,2011,234,204
358,170834,Hostalric,-39,2011,273,312
359,081022,Igualada,54,2011,2089,2035
360,251155,Isona i Conca Dellà,5,2011,36,31
361,170849,Isòvol,7,2011,37,30
362,251137,Ivars d'Urgell,-30,2011,51,81
363,251121,Ivars de Noguera,8,2011,26,18
364,251142,Ivorra,-1,2011,2,3
365,170852,Jafre,16,2011,33,17
366,170865,"Jonquera, la",98,2011,337,239
367,081038,Jorba,10,2011,54,44
368,259101,Josa i Tuixén,5,2011,13,8
369,170871,Juià,16,2011,52,36
370,251180,Juncosa,-6,2011,15,21
371,251193,Juneda,39,2011,141,102
372,251214,Les,3,2011,76,73
373,251229,Linyola,-56,2011,94,150
374,081043,"Llacuna, la",2,2011,51,49
375,170887,Lladó,29,2011,57,28
376,251235,Lladorre,1,2011,8,7
377,251240,Lladurs,-15,2011,4,19
378,081056,"Llagosta, la",-103,2011,640,743
379,170890,Llagostera,-17,2011,461,478
380,170904,Llambilles,-7,2011,14,21
381,170911,Llanars,-24,2011,30,54
382,170926,Llançà,7,2011,265,258
383,251253,Llardecans,-3,2011,12,15
384,251266,Llavorsí,-16,2011,26,42
385,251207,Lleida,367,2011,6823,6456
386,170932,Llers,6,2011,68,62
387,251272,Lles de Cerdanya,2,2011,11,9
388,081075,Lliçà d'Amunt,100,2011,759,659
389,081081,Lliçà de Vall,-27,2011,305,332
390,251288,Llimiana,2,2011,9,7
391,081069,Llinars del Vallès,133,2011,683,550
392,170947,Llívia,31,2011,150,119
393,430727,"Lloar, el",1,2011,5,4
394,251291,Llobera,-6,2011,1,7
395,430733,Llorac,7,2011,17,10
396,430748,Llorenç del Penedès,42,2011,139,97
397,170950,Lloret de Mar,415,2011,3153,2738
398,170963,"Llosses, les",3,2011,16,13
399,081094,Lluçà,-2,2011,7,9
400,171024,Maçanet de Cabrenys,9,2011,39,30
401,171030,Maçanet de la Selva,24,2011,463,439
402,170979,Madremanya,8,2011,20,12
403,170985,Maià de Montcal,13,2011,33,20
404,251333,Maials,16,2011,47,31
405,251305,Maldà,-6,2011,4,10
406,081108,Malgrat de Mar,69,2011,997,928
407,081115,Malla,7,2011,17,10
408,081120,Manlleu,-52,2011,772,824
409,081136,Manresa,41,2011,3541,3500
410,430764,Marçà,7,2011,42,35
411,430751,Margalef,-2,2011,3,5
412,082423,Marganell,5,2011,20,15
413,081141,Martorell,284,2011,1762,1478
414,081154,Martorelles,14,2011,307,293
415,430770,Mas de Barberans,2,2011,19,17
416,171002,Masarac,-6,2011,12,18
417,430786,Masdenverge,-7,2011,57,64
418,081167,"Masies de Roda, les",-5,2011,38,43
419,081173,"Masies de Voltregà, les",-31,2011,112,143
420,430799,Masllorenç,-3,2011,47,50
421,081189,"Masnou, el",18,2011,1130,1112
422,430803,"Masó, la",2,2011,21,19
423,430810,Maspujols,16,2011,41,25
424,081192,Masquefa,50,2011,471,421
425,430825,"Masroig, el",5,2011,18,13
426,251312,Massalcoreig,2,2011,36,34
427,171019,Massanes,4,2011,55,51
428,251327,Massoteres,1,2011,16,15
429,081206,Matadepera,11,2011,349,338
430,081213,Mataró,-191,2011,5284,5475
431,081228,Mediona,20,2011,183,163
432,251348,Menàrguens,-11,2011,44,55
433,170998,Meranges,-7,2011,7,14
434,171058,Mieres,3,2011,23,20
435,430831,"Milà, el",-7,2011,4,11
436,251351,Miralcamp,14,2011,96,82
437,430846,Miravet,19,2011,51,32
438,081385,Moià,25,2011,282,257
439,430859,"Molar, el",-6,2011,9,15
440,081234,Molins de Rei,-143,2011,961,1104
441,251370,Mollerussa,98,2011,865,767
442,171061,Mollet de Peralada,3,2011,15,12
443,081249,Mollet del Vallès,-334,2011,2408,2742
444,171077,Molló,1,2011,19,18
445,251364,"Molsosa, la",1,2011,2,1
446,081287,Monistrol de Calders,16,2011,45,29
447,081271,Monistrol de Montserrat,-22,2011,214,236
448,171096,Montagut i Oix,0,2011,72,72
449,430862,Montblanc,41,2011,335,294
450,430884,Montbrió del Camp,32,2011,203,171
451,081252,Montcada i Reixac,340,2011,2182,1842
452,081304,Montclar,4,2011,6,2
453,251399,Montellà i Martinet,5,2011,47,42
454,081311,Montesquiu,21,2011,74,53
455,251403,Montferrer i Castellbò,-51,2011,51,102
456,430897,Montferri,-12,2011,34,46
457,251386,Montgai,-10,2011,21,31
458,081265,Montgat,46,2011,625,579
459,081326,Montmajor,-1,2011,17,18
460,081332,Montmaneu,-12,2011,3,15
461,430901,"Montmell, el",-3,2011,126,129
462,081350,Montmeló,-90,2011,343,433
463,251425,Montoliu de Lleida,12,2011,28,16
464,251410,Montoliu de Segarra,3,2011,12,9
465,251431,Montornès de Segarra,-3,2011,2,5
466,081363,Montornès del Vallès,-3,2011,896,899
467,430918,Mont-ral,-7,2011,4,11
468,171100,Mont-ras,-15,2011,86,101
469,430923,Mont-roig del Camp,129,2011,1094,965
470,081379,Montseny,-13,2011,13,26
471,430939,Móra d'Ebre,17,2011,285,268
472,430944,Móra la Nova,13,2011,156,143
473,430957,"Morell, el",40,2011,345,305
474,430960,"Morera de Montsant, la",6,2011,12,6
475,081290,Muntanyola,26,2011,40,14
476,081398,Mura,-2,2011,9,11
477,251459,Nalec,-1,2011,4,5
478,250254,Naut Aran,-7,2011,98,105
479,081402,Navarcles,23,2011,239,216
480,081419,Navàs,-22,2011,216,238
481,171117,Navata,27,2011,98,71
482,251462,Navès,-5,2011,15,20
483,081424,"Nou de Berguedà, la",8,2011,9,1
484,430976,"Nou de Gaià, la",15,2011,36,21
485,430982,Nulles,-9,2011,39,48
486,251484,Odèn,-4,2011,7,11
487,081430,Òdena,95,2011,241,146
488,171122,Ogassa,-6,2011,11,17
489,081458,Olèrdola,6,2011,206,200
490,081461,Olesa de Bonesvalls,-15,2011,100,115
491,081477,Olesa de Montserrat,-196,2011,1163,1359
492,251497,Oliana,-1,2011,83,84
493,251500,Oliola,-8,2011,1,9
494,251517,Olius,2,2011,45,43
495,081483,Olivella,60,2011,321,261
496,081496,Olost,2,2011,46,44
497,171143,Olot,94,2011,1442,1348
498,251522,"Oluges, les",-1,2011,6,7
499,081445,Olvan,-4,2011,50,54
500,251538,"Omellons, els",4,2011,17,13
501,251543,"Omells de na Gaia, els",6,2011,8,2
502,171156,Ordis,10,2011,21,11
503,251556,Organyà,-15,2011,32,47
504,081509,Orís,3,2011,15,12
505,081516,Oristà,1,2011,28,27
506,081521,Orpí,-8,2011,6,14
507,081537,Òrrius,5,2011,39,34
508,251569,Os de Balaguer,10,2011,54,44
509,171169,Osor,-10,2011,17,27
510,251575,Ossó de Sió,3,2011,10,7
511,081542,Pacs del Penedès,16,2011,60,44
512,081555,Palafolls,22,2011,500,478
513,171175,Palafrugell,46,2011,1070,1024
514,171181,Palamós,-50,2011,1057,1107
515,251581,"Palau d'Anglesola, el",24,2011,90,66
516,171194,Palau de Santa Eulàlia,-7,2011,4,11
517,171215,Palau-sator,1,2011,22,21
518,171208,Palau-saverdera,2,2011,129,127
519,081568,Palau-solità i Plegamans,96,2011,706,610
520,431009,"Pallaresos, els",98,2011,247,149
521,081574,Pallejà,-14,2011,518,532
522,430995,"Palma d'Ebre, la",-15,2011,11,26
523,089058,"Palma de Cervelló, la",-4,2011,142,146
524,171236,Palol de Revardit,8,2011,20,12
525,171241,Pals,30,2011,177,147
526,081580,"Papiol, el",62,2011,221,159
527,171254,Pardines,-3,2011,6,9
528,081593,Parets del Vallès,310,2011,1113,803
529,171267,Parlavà,-1,2011,21,22
530,431016,Passanant i Belltall,-4,2011,10,14
531,171289,Pau,5,2011,35,30
532,431021,Paüls,-1,2011,11,12
533,171292,Pedret i Marzà,6,2011,13,7
534,251641,Penelles,19,2011,41,22
535,171306,"Pera, la",-9,2011,19,28
536,081607,Perafita,9,2011,22,13
537,431037,Perafort,27,2011,96,69
538,171328,Peralada,41,2011,136,95
539,251654,Peramola,-7,2011,15,22
540,431042,"Perelló, el",69,2011,174,105
541,081614,Piera,69,2011,874,805
542,431055,"Piles, les",-6,2011,10,16
543,081635,Pineda de Mar,-3,2011,1467,1470
544,431068,"Pinell de Brai, el",-1,2011,22,23
545,251667,Pinell de Solsonès,-4,2011,4,8
546,251673,Pinós,-4,2011,13,17
547,431074,Pira,1,2011,20,19
548,431080,"Pla de Santa Maria, el",-4,2011,140,144
549,081640,"Pla del Penedès, el",45,2011,105,60
550,171334,"Planes d'Hostoles, les",4,2011,64,60
551,171349,Planoles,-1,2011,25,26
552,259118,"Plans de Sió, els",8,2011,39,31
553,251689,"Poal, el",5,2011,22,17
554,251692,"Pobla de Cérvoles, la",4,2011,11,7
555,081653,"Pobla de Claramunt, la",-20,2011,130,150
556,081666,"Pobla de Lillet, la",-12,2011,32,44
557,431093,"Pobla de Mafumet, la",120,2011,362,242
558,431107,"Pobla de Massaluca, la",-6,2011,9,15
559,431114,"Pobla de Montornès, la",-38,2011,199,237
560,251713,"Pobla de Segur, la",-76,2011,154,230
561,431129,Poboleda,-11,2011,19,30
562,081672,Polinyà,2,2011,401,399
563,431135,"Pont d'Armentera, el",24,2011,46,22
564,250306,"Pont de Bar, el",-7,2011,8,15
565,171352,Pont de Molins,27,2011,47,20
566,251734,"Pont de Suert, el",-20,2011,141,161
567,081825,"Pont de Vilomara i Rocafort, el",18,2011,182,164
568,431418,Pontils,1,2011,16,15
569,081688,Pontons,-41,2011,28,69
570,171365,Pontós,3,2011,19,16
571,251728,Ponts,-4,2011,118,122
572,171371,Porqueres,41,2011,211,170
573,431140,Porrera,-4,2011,7,11
574,171404,"Port de la Selva, el",4,2011,63,59
575,171387,Portbou,16,2011,72,56
576,251749,"Portella, la",33,2011,64,31
577,431153,Pradell de la Teixeta,-3,2011,4,7
578,431166,Prades,-10,2011,36,46
579,431172,Prat de Comte,-7,2011,6,13
580,081691,"Prat de Llobregat, el",-394,2011,2258,2652
581,431188,Pratdip,5,2011,62,57
582,081712,Prats de Lluçanès,-6,2011,71,77
583,081705,"Prats de Rei, els",-2,2011,15,17
584,251752,Prats i Sansor,9,2011,23,14
585,251765,Preixana,-16,2011,3,19
586,251771,Preixens,-2,2011,17,19
587,082303,Premià de Dalt,93,2011,655,562
588,081727,Premià de Mar,-97,2011,1459,1556
589,171390,"Preses, les",11,2011,80,69
590,251790,Prullans,9,2011,23,14
591,171411,Puigcerdà,150,2011,620,470
592,081748,Puigdàlber,-2,2011,23,25
593,251804,Puiggròs,-3,2011,10,13
594,431191,Puigpelat,-6,2011,69,75
595,081751,Puig-reig,4,2011,206,202
596,251811,Puigverd d'Agramunt,-5,2011,11,16
597,251826,Puigverd de Lleida,26,2011,67,41
598,081764,Pujalt,-5,2011,5,10
599,081770,"Quar, la",-2,2011,2,4
600,171426,Quart,83,2011,226,143
601,170433,Queralbs,-4,2011,4,8
602,431205,Querol,16,2011,55,39
603,171432,Rabós,7,2011,11,4
604,081786,Rajadell,22,2011,44,22
605,431212,Rasquera,-12,2011,15,27
606,171447,Regencós,-4,2011,14,18
607,081799,Rellinars,-14,2011,51,65
608,431227,Renau,-6,2011,9,15
609,431233,Reus,117,2011,4661,4544
610,251832,Rialp,11,2011,44,33
611,431248,"Riba, la",-17,2011,51,68
612,431251,Riba-roja d'Ebre,6,2011,46,40
613,259059,Ribera d'Ondara,1,2011,18,17
614,251850,Ribera d'Urgellet,28,2011,86,58
615,171450,Ribes de Freser,-15,2011,73,88
616,171463,Riells i Viabrea,-15,2011,251,266
617,431264,"Riera de Gaià, la",2,2011,89,87
618,251863,Riner,16,2011,23,7
619,171479,Ripoll,7,2011,395,388
620,081803,Ripollet,-119,2011,2109,2228
621,259139,Riu de Cerdanya,3,2011,9,6
622,171485,Riudarenes,2,2011,177,175
623,171498,Riudaura,2,2011,25,23
624,431270,Riudecanyes,21,2011,97,76
625,431286,Riudecols,-13,2011,67,80
626,171501,Riudellots de la Selva,-3,2011,110,113
627,431299,Riudoms,32,2011,274,242
628,171518,Riumors,7,2011,23,16
629,081810,"Roca del Vallès, la",30,2011,524,494
630,431303,Rocafort de Queralt,5,2011,20,15
631,431310,Roda de Berà,21,2011,525,504
632,081831,Roda de Ter,23,2011,269,246
633,431325,Rodonyà,7,2011,39,32
634,431331,Roquetes,22,2011,428,406
635,171523,Roses,49,2011,1337,1288
636,251898,Rosselló,41,2011,167,126
637,431346,"Rourell, el",16,2011,28,12
638,081846,Rubí,-20,2011,3413,3433
639,081859,Rubió,3,2011,11,8
640,171539,Rupià,6,2011,23,17
641,089019,Rupit i Pruit,-4,2011,10,14
642,081878,Sabadell,-334,2011,8862,9196
643,081884,Sagàs,6,2011,12,6
644,251902,Salàs de Pallars,17,2011,30,13
645,081901,Saldes,-8,2011,21,29
646,171544,Sales de Llierca,1,2011,9,8
647,081918,Sallent,-12,2011,224,236
648,431359,Salomó,7,2011,27,20
649,439057,Salou,338,2011,3102,2764
650,171557,Salt,-901,2011,2361,3262
651,251919,Sanaüja,4,2011,21,17
652,081944,Sant Adrià de Besòs,262,2011,2636,2374
653,081957,Sant Agustí de Lluçanès,0,2011,2,2
654,081960,Sant Andreu de la Barca,122,2011,1514,1392
655,081976,Sant Andreu de Llavaneres,136,2011,752,616
656,171576,Sant Andreu Salou,5,2011,11,6
657,171833,Sant Aniol de Finestres,2,2011,13,11
658,081982,Sant Antoni de Vilamajor,125,2011,426,301
659,081995,Sant Bartomeu del Grau,-50,2011,38,88
660,082009,Sant Boi de Llobregat,-168,2011,3385,3553
661,082016,Sant Boi de Lluçanès,36,2011,57,21
662,431362,Sant Carles de la Ràpita,-58,2011,714,772
663,082037,Sant Cebrià de Vallalta,-80,2011,200,280
664,082021,Sant Celoni,112,2011,1005,893
665,082042,Sant Climent de Llobregat,-46,2011,136,182
666,171582,Sant Climent Sescebes,27,2011,101,74
667,082055,Sant Cugat del Vallès,1055,2011,5171,4116
668,082068,Sant Cugat Sesgarrigues,2,2011,31,29
669,251961,Sant Esteve de la Sarga,1,2011,5,4
670,082074,Sant Esteve de Palautordera,39,2011,174,135
671,082080,Sant Esteve Sesrovires,107,2011,476,369
672,171595,Sant Feliu de Buixalleu,4,2011,43,39
673,082107,Sant Feliu de Codines,75,2011,484,409
674,171609,Sant Feliu de Guíxols,134,2011,1387,1253
675,082114,Sant Feliu de Llobregat,433,2011,1917,1484
676,171616,Sant Feliu de Pallerols,19,2011,68,49
677,082129,Sant Feliu Sasserra,-12,2011,17,29
678,171621,Sant Ferriol,-5,2011,16,21
679,082093,Sant Fost de Campsentelles,107,2011,485,378
680,082135,Sant Fruitós de Bages,-14,2011,425,439
681,171637,Sant Gregori,56,2011,175,119
682,251924,Sant Guim de Freixenet,-2,2011,43,45
683,251977,Sant Guim de la Plana,0,2011,16,16
684,171642,Sant Hilari Sacalm,13,2011,164,151
685,082153,Sant Hipòlit de Voltregà,27,2011,215,188
686,081939,Sant Iscle de Vallalta,42,2011,102,60
687,439023,Sant Jaume d'Enveja,14,2011,131,117
688,082166,Sant Jaume de Frontanyà,9,2011,9,0
689,171655,Sant Jaume de Llierca,-8,2011,26,34
690,431378,Sant Jaume dels Domenys,-17,2011,134,151
691,171674,Sant Joan de les Abadesses,-3,2011,95,98
692,171680,Sant Joan de Mollet,2,2011,18,16
693,082188,Sant Joan de Vilatorrada,-8,2011,447,455
694,082172,Sant Joan Despí,22,2011,1609,1587
695,171851,Sant Joan les Fonts,9,2011,138,129
696,171668,Sant Jordi Desvalls,35,2011,87,52
697,089030,Sant Julià de Cerdanyola,-4,2011,6,10
698,171693,Sant Julià de Ramis,81,2011,259,178
699,082205,Sant Julià de Vilatorta,25,2011,119,94
700,179032,Sant Julià del Llor i Bonmatí,-35,2011,62,97
701,082212,Sant Just Desvern,-250,2011,504,754
702,082227,Sant Llorenç d'Hortons,22,2011,166,144
703,171714,Sant Llorenç de la Muga,22,2011,32,10
704,251930,Sant Llorenç de Morunys,25,2011,64,39
705,082233,Sant Llorenç Savall,24,2011,145,121
706,082251,Sant Martí d'Albars,-2,2011,5,7
707,082248,Sant Martí de Centelles,20,2011,87,67
708,171729,Sant Martí de Llémena,0,2011,39,39
709,259025,Sant Martí de Riucorb,15,2011,35,20
710,082264,Sant Martí de Tous,3,2011,39,36
711,082270,Sant Martí Sarroca,23,2011,195,172
712,082286,Sant Martí Sesgueioles,-2,2011,10,12
713,171735,Sant Martí Vell,5,2011,14,9
714,082299,Sant Mateu de Bages,4,2011,21,17
715,171740,Sant Miquel de Campmajor,-1,2011,11,12
716,171753,Sant Miquel de Fluvià,25,2011,67,42
717,171766,Sant Mori,0,2011,14,14
718,171772,Sant Pau de Segúries,-17,2011,21,38
719,082310,Sant Pere de Ribes,337,2011,1916,1579
720,082325,Sant Pere de Riudebitlles,-14,2011,96,110
721,082331,Sant Pere de Torelló,49,2011,154,105
722,082346,Sant Pere de Vilamajor,13,2011,286,273
723,171788,Sant Pere Pescador,59,2011,225,166
724,081897,Sant Pere Sallavinera,-1,2011,7,8
725,082359,Sant Pol de Mar,8,2011,323,315
726,082362,Sant Quintí de Mediona,-10,2011,120,130
727,082378,Sant Quirze de Besora,-9,2011,92,101
728,082384,Sant Quirze del Vallès,-93,2011,715,808
729,082397,Sant Quirze Safaja,-15,2011,47,62
730,251945,Sant Ramon,-1,2011,15,16
731,082401,Sant Sadurní d'Anoia,97,2011,630,533
732,082418,Sant Sadurní d'Osormort,-1,2011,4,5
733,080983,Sant Salvador de Guardiola,-12,2011,161,173
734,082628,Sant Vicenç de Castellet,150,2011,644,494
735,082649,Sant Vicenç de Montalt,1,2011,399,398
736,082652,Sant Vicenç de Torelló,-11,2011,88,99
737,082634,Sant Vicenç dels Horts,-98,2011,1134,1232
738,431384,Santa Bàrbara,-84,2011,157,241
739,082439,Santa Cecília de Voltregà,-3,2011,5,8
740,082444,Santa Coloma de Cervelló,-33,2011,359,392
741,171805,Santa Coloma de Farners,85,2011,663,578
742,082457,Santa Coloma de Gramenet,-1412,2011,9385,10797
743,431397,Santa Coloma de Queralt,-20,2011,96,116
744,171812,Santa Cristina d'Aro,11,2011,370,359
745,082460,Santa Eugènia de Berga,-28,2011,117,145
746,082476,Santa Eulàlia de Riuprimer,60,2011,111,51
747,082482,Santa Eulàlia de Ronçana,81,2011,398,317
748,082495,Santa Fe del Penedès,-24,2011,8,32
749,171827,Santa Llogaia d'Àlguema,7,2011,22,15
750,082508,Santa Margarida de Montbui,-140,2011,408,548
751,082515,Santa Margarida i els Monjos,27,2011,522,495
752,082589,Santa Maria d'Oló,-14,2011,31,45
753,082536,Santa Maria de Besora,-1,2011,8,9
754,082567,Santa Maria de Martorelles,24,2011,67,43
755,082554,Santa Maria de Merlès,3,2011,15,12
756,082573,Santa Maria de Miralles,-6,2011,1,7
757,082592,Santa Maria de Palautordera,-51,2011,521,572
758,431401,Santa Oliva,5,2011,252,247
759,171848,Santa Pau,-1,2011,58,59
760,082606,Santa Perpètua de Mogoda,141,2011,1368,1227
761,082613,Santa Susanna,2,2011,290,288
762,081923,Santpedor,-36,2011,329,365
763,431423,Sarral,-37,2011,67,104
764,171864,Sarrià de Ter,47,2011,313,266
765,252017,Sarroca de Bellera,1,2011,7,6
766,252000,Sarroca de Lleida,-23,2011,3,26
767,171870,"Saus, Camallera i Llampaies",18,2011,52,34
768,431439,Savallà del Comtat,-1,2011,1,2
769,431444,"Secuita, la",22,2011,117,95
770,171886,"Selva de Mar, la",-1,2011,7,8
771,431457,"Selva del Camp, la",28,2011,205,177
772,431460,Senan,3,2011,9,6
773,430445,"Sénia, la",-86,2011,208,294
774,252022,Senterada,-1,2011,17,18
775,250352,"Sentiu de Sió, la",-14,2011,5,19
776,082671,Sentmenat,45,2011,471,426
777,171903,Serinyà,0,2011,48,48
778,252043,Seròs,6,2011,88,82
779,171910,Serra de Daró,-1,2011,7,8
780,171925,Setcases,12,2011,17,5
781,252038,"Seu d'Urgell, la",-431,2011,598,1029
782,082690,Seva,16,2011,169,153
783,252056,Sidamon,-4,2011,22,26
784,171931,Sils,173,2011,543,370
785,082704,Sitges,557,2011,2216,1659
786,170524,Siurana,-11,2011,2,13
787,082711,Sobremunt,5,2011,9,4
788,252069,"Soleràs, el",3,2011,15,12
789,431476,Solivella,-25,2011,17,42
790,252075,Solsona,-108,2011,342,450
791,082726,Sora,2,2011,13,11
792,252081,Soriguera,9,2011,29,20
793,252094,Sort,-29,2011,111,140
794,252108,Soses,5,2011,92,87
795,082732,Subirats,13,2011,137,124
796,252115,Sudanell,-2,2011,37,39
797,252120,Sunyer,-4,2011,13,17
798,082747,Súria,-22,2011,176,198
799,171946,Susqueda,-5,2011,6,11
800,082763,Tagamanent,10,2011,35,25
801,082779,Talamanca,1,2011,19,18
802,252154,Talarn,48,2011,203,155
803,252167,Talavera,1,2011,14,13
804,171959,"Tallada d'Empordà, la",14,2011,49,35
805,082785,Taradell,-4,2011,247,251
806,431482,Tarragona,109,2011,6396,6287
807,252173,Tàrrega,-445,2011,777,1222
808,252189,Tarrés,-2,2011,5,7
809,252192,Tarroja de Segarra,1,2011,7,6
810,082750,Tavèrnoles,4,2011,16,12
811,082802,Tavertet,-5,2011,3,8
812,082819,Teià,35,2011,325,290
813,252206,Térmens,55,2011,175,120
814,171962,Terrades,0,2011,13,13
815,082798,Terrassa,931,2011,9293,8362
816,082824,Tiana,157,2011,458,301
817,252213,Tírvia,-2,2011,12,14
818,252228,Tiurana,-2,2011,4,6
819,431495,Tivenys,6,2011,33,27
820,431508,Tivissa,0,2011,78,78
821,082830,Tona,-28,2011,374,402
822,252234,Torà,2,2011,63,61
823,082845,Tordera,290,2011,1248,958
824,082858,Torelló,-66,2011,460,526
825,252249,"Torms, els",-1,2011,2,3
826,252252,Tornabous,52,2011,94,42
827,252271,"Torre de Cabdella, la",-5,2011,31,36
828,082861,"Torre de Claramunt, la",59,2011,270,211
829,431515,"Torre de Fontaubella, la",-6,2011,11,17
830,431520,"Torre de l'Espanyol, la",-2,2011,32,34
831,252265,Torrebesses,1,2011,8,7
832,431536,Torredembarra,-152,2011,1039,1191
833,252287,Torrefarrera,32,2011,302,270
834,259078,Torrefeta i Florejacs,-14,2011,16,30
835,252304,Torregrossa,23,2011,84,61
836,252311,Torrelameu,32,2011,54,22
837,082877,Torrelavit,-3,2011,62,65
838,082883,Torrelles de Foix,-41,2011,179,220
839,082896,Torrelles de Llobregat,21,2011,298,277
840,171978,Torrent,1,2011,6,5
841,252326,Torres de Segre,37,2011,167,130
842,252332,Torre-serona,9,2011,19,10
843,171984,Torroella de Fluvià,6,2011,65,59
844,171997,Torroella de Montgrí,71,2011,769,698
845,431541,Torroja del Priorat,2,2011,9,7
846,172001,Tortellà,38,2011,58,20
847,431554,Tortosa,-44,2011,1458,1502
848,172018,Toses,-5,2011,10,15
849,172023,Tossa de Mar,54,2011,280,226
850,252347,Tremp,-152,2011,559,711
851,172044,Ullà,-50,2011,94,144
852,082900,Ullastrell,58,2011,119,61
853,172057,Ullastret,13,2011,20,7
854,431567,Ulldecona,-8,2011,474,482
855,431573,Ulldemolins,-7,2011,17,24
856,172039,Ultramort,-3,2011,8,11
857,172060,Urús,-1,2011,11,12
858,082917,Vacarisses,2,2011,359,357
859,170144,"Vajol, la",-8,2011,6,14
860,172076,"Vall d'en Bas, la",39,2011,140,101
861,172082,"Vall de Bianya, la",15,2011,72,57
862,250432,"Vall de Boí, la",-25,2011,61,86
863,259010,Vall de Cardós,5,2011,16,11
864,082922,Vallbona d'Anoia,-16,2011,64,80
865,252385,Vallbona de les Monges,-8,2011,7,15
866,082938,Vallcebre,6,2011,18,12
867,431589,Vallclara,-1,2011,5,6
868,252402,Vallfogona de Balaguer,-7,2011,107,114
869,171707,Vallfogona de Ripollès,0,2011,8,8
870,431592,Vallfogona de Riucorb,7,2011,20,13
871,082943,Vallgorguina,18,2011,208,190
872,082956,Vallirana,97,2011,797,700
873,172095,Vall-llobrega,16,2011,58,42
874,431606,Vallmoll,26,2011,113,87
875,082969,Vallromanes,71,2011,149,78
876,431613,Valls,67,2011,1161,1094
877,259062,"Valls d'Aguilar, les",-1,2011,13,14
878,252398,"Valls de Valira, les",16,2011,87,71
879,431628,Vandellòs i l'Hospitalet de l'Infant,39,2011,434,395
880,259097,"Vansa i Fórnols, la",-8,2011,10,18
881,082975,Veciana,-5,2011,2,7
882,431634,"Vendrell, el",76,2011,2422,2346
883,172109,Ventalló,17,2011,71,54
884,252424,Verdú,11,2011,46,35
885,172116,Verges,-20,2011,55,75
886,431649,Vespella de Gaià,-25,2011,27,52
887,082981,Vic,225,2011,2532,2307
888,172121,Vidrà,-3,2011,5,8
889,172137,Vidreres,26,2011,529,503
890,252430,Vielha e Mijaran,-176,2011,372,548
891,431652,Vilabella,1,2011,29,28
892,172142,Vilabertran,11,2011,55,44
893,172155,Vilablareix,21,2011,116,95
894,082994,Vilada,-18,2011,13,31
895,172174,Viladamat,-9,2011,20,29
896,172168,Viladasens,-4,2011,13,17
897,083015,Viladecans,26,2011,2782,2756
898,083008,Viladecavalls,8,2011,362,354
899,172180,Vilademuls,7,2011,53,46
900,172207,Viladrau,-18,2011,41,59
901,172214,Vilafant,63,2011,343,280
902,083054,Vilafranca del Penedès,-42,2011,2073,2115
903,252445,Vilagrassa,27,2011,66,39
904,172235,Vilajuïga,6,2011,72,66
905,431750,Vilalba dels Arcs,16,2011,21,5
906,083067,Vilalba Sasserra,31,2011,90,59
907,252458,Vilaller,-21,2011,28,49
908,172240,Vilallonga de Ter,-4,2011,18,22
909,431665,Vilallonga del Camp,-12,2011,140,152
910,172253,Vilamacolum,-18,2011,26,44
911,172266,Vilamalla,-7,2011,71,78
912,172272,Vilamaniscle,1,2011,12,11
913,252477,Vilamòs,-8,2011,26,34
914,172288,Vilanant,-7,2011,30,37
915,431671,Vilanova d'Escornalbou,1,2011,48,47
916,252483,Vilanova de Bellpuig,16,2011,56,40
917,252496,Vilanova de l'Aguda,4,2011,6,2
918,252542,Vilanova de la Barca,-17,2011,67,84
919,252509,Vilanova de Meià,4,2011,17,13
920,431687,Vilanova de Prades,-5,2011,2,7
921,083036,Vilanova de Sau,-9,2011,19,28
922,252516,Vilanova de Segrià,26,2011,63,37
923,083020,Vilanova del Camí,-83,2011,563,646
924,089024,Vilanova del Vallès,41,2011,300,259
925,083073,Vilanova i la Geltrú,-220,2011,2933,3153
926,431690,Vilaplana,-2,2011,25,27
927,431704,Vila-rodona,-4,2011,77,81
928,172305,Vila-sacra,10,2011,48,38
929,252521,Vila-sana,2,2011,29,27
930,431711,Vila-seca,61,2011,1673,1612
931,082140,Vilassar de Dalt,61,2011,436,375
932,082191,Vilassar de Mar,76,2011,997,921
933,172229,Vilaür,-8,2011,7,15
934,431726,Vilaverd,-15,2011,37,52
935,431732,"Vilella Alta, la",2,2011,4,2
936,431747,"Vilella Baixa, la",13,2011,17,4
937,172333,Vilobí d'Onyar,1,2011,179,178
938,083041,Vilobí del Penedès,6,2011,52,46
939,172327,Vilopriu,9,2011,22,13
940,252537,"Vilosell, el",-1,2011,8,9
941,431763,Vimbodí i Poblet,-9,2011,28,37
942,252555,Vinaixa,-2,2011,22,24
943,431779,Vinebre,28,2011,53,25
944,431785,Vinyols i els Arcs,19,2011,153,134
945,083089,Viver i Serrateix,4,2011,5,1
946,430521,Xerta,-10,2011,42,52
0,250019,Abella de la Conca,-5,2012,10,15
1,080018,Abrera,103,2012,606,503
2,250024,Àger,11,2012,30,19
3,250030,Agramunt,-38,2012,196,234
4,080023,Aguilar de Segarra,0,2012,9,9
5,170010,Agullana,-1,2012,45,46
6,080142,Aiguafreda,29,2012,154,125
7,430017,Aiguamúrcia,10,2012,55,45
8,170025,Aiguaviva,13,2012,32,19
9,250387,Aitona,-15,2012,120,135
10,250045,"Alamús, els",3,2012,54,51
11,250058,Alàs i Cerc,-5,2012,13,18
12,250061,"Albagés, l'",4,2012,17,13
13,170031,Albanyà,20,2012,28,8
14,250077,Albatàrrec,-15,2012,131,146
15,250083,Albesa,-9,2012,46,55
16,250096,"Albi, l'",-4,2012,21,25
17,430022,Albinyana,-6,2012,147,153
18,430038,"Albiol, l'",6,2012,18,12
19,170046,Albons,29,2012,61,32
20,430043,Alcanar,-256,2012,386,642
21,250100,Alcanó,8,2012,15,7
22,250117,Alcarràs,166,2012,717,551
23,250122,Alcoletge,0,2012,214,214
24,430056,Alcover,-12,2012,208,220
25,439044,"Aldea, l'",-134,2012,224,358
26,430069,Aldover,9,2012,38,29
27,430075,"Aleixar, l'",-11,2012,39,50
28,080039,Alella,85,2012,583,498
29,430081,Alfara de Carles,-4,2012,12,16
30,250138,Alfarràs,-50,2012,96,146
31,250143,Alfés,-17,2012,10,27
32,430094,Alforja,5,2012,106,101
33,250156,Algerri,0,2012,32,32
34,250169,Alguaire,-6,2012,116,122
35,250175,Alins,2,2012,13,11
36,430108,Alió,18,2012,36,18
37,250194,Almacelles,35,2012,270,235
38,250208,Almatret,3,2012,13,10
39,250215,Almenar,-27,2012,128,155
40,430115,Almoster,21,2012,60,39
41,250220,Alòs de Balaguer,1,2012,8,7
42,170062,Alp,-38,2012,97,135
43,080044,Alpens,0,2012,8,8
44,250236,Alpicat,42,2012,278,236
45,250241,Alt Àneu,-18,2012,11,29
46,430120,Altafulla,69,2012,372,303
47,170078,Amer,8,2012,107,99
48,430136,"Ametlla de Mar, l'",35,2012,331,296
49,080057,"Ametlla del Vallès, l'",68,2012,449,381
50,439060,"Ampolla, l'",68,2012,253,185
51,430141,Amposta,74,2012,1021,947
52,170084,Anglès,-50,2012,239,289
53,250273,Anglesola,4,2012,49,45
54,250292,Arbeca,-24,2012,61,85
55,430167,"Arboç, l'",27,2012,369,342
56,430154,Arbolí,-1,2012,12,13
57,170097,Arbúcies,-232,2012,195,427
58,080060,Arenys de Mar,216,2012,984,768
59,080076,Arenys de Munt,34,2012,441,407
60,170101,Argelaguer,1,2012,20,19
61,080082,Argençola,-7,2012,2,9
62,430173,"Argentera, l'",-2,2012,7,9
63,080095,Argentona,-2,2012,569,571
64,170118,"Armentera, l'",3,2012,48,45
65,430189,Arnes,-3,2012,13,16
66,250313,Arres,-5,2012,1,6
67,250328,Arsèguel,-3,2012,4,7
68,080109,Artés,27,2012,290,263
69,250334,Artesa de Lleida,8,2012,67,59
70,250349,Artesa de Segre,-37,2012,121,158
71,430192,Ascó,9,2012,70,61
72,250365,Aspa,0,2012,7,7
73,250371,"Avellanes i Santa Linya, les",17,2012,41,24
74,080116,Avià,31,2012,117,86
75,080121,Avinyó,-5,2012,81,86
76,170123,Avinyonet de Puigventós,35,2012,90,55
77,080137,Avinyonet del Penedès,-8,2012,86,94
78,080155,Badalona,-1792,2012,11684,13476
79,089045,Badia del Vallès,4,2012,590,586
80,080168,Bagà,-80,2012,58,138
81,250390,Baix Pallars,5,2012,21,16
82,250404,Balaguer,-179,2012,728,907
83,080174,Balenyà,21,2012,204,183
84,080180,Balsareny,16,2012,135,119
85,430206,Banyeres del Penedès,17,2012,216,199
86,170157,Banyoles,22,2012,881,859
87,250411,Barbens,-46,2012,32,78
88,430213,Barberà de la Conca,-1,2012,35,36
89,082520,Barberà del Vallès,-40,2012,1489,1529
90,080193,Barcelona,-1454,2012,87001,88455
91,250426,"Baronia de Rialb, la",7,2012,17,10
92,170160,Bàscara,13,2012,60,47
93,250447,Bassella,3,2012,17,14
94,430228,Batea,-12,2012,33,45
95,250450,Bausen,-1,2012,0,1
96,080207,Begues,52,2012,400,348
97,170139,Begur,-53,2012,189,242
98,250463,Belianes,3,2012,18,15
99,251706,Bellaguarda,-12,2012,3,15
100,170182,Bellcaire d'Empordà,4,2012,45,41
101,250479,Bellcaire d'Urgell,-9,2012,40,49
102,250485,Bell-lloc d'Urgell,-73,2012,62,135
103,250498,Bellmunt d'Urgell,1,2012,7,6
104,430234,Bellmunt del Priorat,-11,2012,9,20
105,080214,Bellprat,-2,2012,0,2
106,250501,Bellpuig,32,2012,250,218
107,430249,Bellvei,13,2012,157,144
108,250518,Bellver de Cerdanya,-107,2012,120,227
109,250523,Bellvís,-10,2012,100,110
110,250539,Benavent de Segrià,-17,2012,68,85
111,430252,Benifallet,-13,2012,0,13
112,430265,Benissanet,1,2012,63,62
113,080229,Berga,-174,2012,618,792
114,170195,Besalú,8,2012,107,99
115,170209,Bescanó,106,2012,252,146
116,170216,Beuda,19,2012,24,5
117,080235,Bigues i Riells del Fai,-17,2012,430,447
118,250557,Biosca,-4,2012,1,5
119,170221,"Bisbal d'Empordà, la",26,2012,516,490
120,430271,"Bisbal de Falset, la",-6,2012,7,13
121,430287,"Bisbal del Penedès, la",35,2012,255,220
122,172348,Biure,-4,2012,12,16
123,430290,Blancafort,-1,2012,16,17
124,170237,Blanes,-121,2012,2305,2426
125,170293,Boadella i les Escaules,-8,2012,10,18
126,170242,Bolvir,-25,2012,12,37
127,430304,Bonastre,2,2012,61,59
128,250576,"Bòrdes, Es",-2,2012,13,15
129,170255,Bordils,-3,2012,114,117
130,250582,"Borges Blanques, les",56,2012,283,227
131,430311,"Borges del Camp, les",-9,2012,95,104
132,170268,Borrassà,-3,2012,43,46
133,080240,Borredà,-14,2012,23,37
134,250595,Bossòst,6,2012,70,64
135,430326,Bot,-7,2012,12,19
136,430332,Botarell,-26,2012,37,63
137,250560,Bovera,-13,2012,4,17
138,430347,Bràfim,3,2012,43,40
139,170274,Breda,-10,2012,151,161
140,080253,"Bruc, el",-21,2012,122,143
141,080266,"Brull, el",2,2012,12,10
142,170280,Brunyola i Sant Martí Sapresa,0,2012,23,23
143,430350,Cabacés,-4,2012,11,15
144,250609,Cabanabona,6,2012,8,2
145,170314,Cabanelles,5,2012,18,13
146,170307,Cabanes,-5,2012,69,74
147,080272,"Cabanyes, les",12,2012,58,46
148,250616,Cabó,6,2012,7,1
149,430363,Cabra del Camp,-2,2012,94,96
150,080288,Cabrera d'Anoia,-42,2012,87,129
151,080291,Cabrera de Mar,19,2012,283,264
152,080305,Cabrils,32,2012,424,392
153,170329,Cadaqués,-21,2012,111,132
154,080312,Calaf,-26,2012,152,178
155,430379,Calafell,-158,2012,2050,2208
156,080348,Calders,-2,2012,47,49
157,080327,Caldes d'Estrac,19,2012,276,257
158,170335,Caldes de Malavella,-67,2012,364,431
159,080333,Caldes de Montbui,-211,2012,815,1026
160,080351,Calella,57,2012,1316,1259
161,080370,Calldetenes,23,2012,111,88
162,080386,Callús,-6,2012,111,117
163,080364,Calonge de Segarra,2,2012,4,2
164,170340,Calonge i Sant Antoni,-153,2012,809,962
165,250621,Camarasa,13,2012,55,42
166,439039,Camarles,17,2012,99,82
167,430385,Cambrils,147,2012,2344,2197
168,170353,Camós,21,2012,38,17
169,170366,Campdevànol,-7,2012,101,108
170,170372,Campelles,2,2012,7,5
171,080399,Campins,45,2012,72,27
172,170388,Campllong,-12,2012,22,34
173,170391,Camprodon,8,2012,154,146
174,250637,Canejan,-3,2012,6,9
175,170405,Canet d'Adri,-4,2012,44,48
176,080403,Canet de Mar,7,2012,737,730
177,439076,"Canonja, la",68,2012,323,255
178,080410,Canovelles,-136,2012,1063,1199
179,080425,Cànoves i Samalús,14,2012,173,159
180,170412,Cantallops,3,2012,28,25
181,080431,Canyelles,29,2012,293,264
182,430398,Capafonts,-7,2012,4,11
183,430402,Capçanes,-1,2012,11,12
184,080446,Capellades,-50,2012,217,267
185,170427,Capmany,-24,2012,30,54
186,080459,Capolat,-1,2012,5,6
187,080462,Cardedeu,22,2012,861,839
188,080478,Cardona,-39,2012,95,134
189,080484,Carme,-12,2012,38,50
190,430419,Caseres,-8,2012,7,15
191,170448,Cassà de la Selva,-35,2012,523,558
192,080497,Casserres,22,2012,82,60
193,080575,Castell de l'Areny,-1,2012,8,9
194,259046,Castell de Mur,-3,2012,3,6
195,250642,Castellar de la Ribera,-2,2012,1,3
196,080522,Castellar de n'Hug,-8,2012,9,17
197,080500,Castellar del Riu,-3,2012,7,10
198,080517,Castellar del Vallès,48,2012,957,909
199,080538,Castellbell i el Vilar,-1,2012,184,185
200,080543,Castellbisbal,-61,2012,468,529
201,080556,Castellcir,42,2012,84,42
202,250674,Castelldans,-21,2012,38,59
203,080569,Castelldefels,-99,2012,4239,4338
204,080581,Castellet i la Gornal,18,2012,164,146
205,170464,Castellfollit de la Roca,24,2012,64,40
206,080608,Castellfollit de Riubregós,1,2012,9,8
207,080594,Castellfollit del Boix,4,2012,20,16
208,080615,Castellgalí,10,2012,155,145
209,080620,Castellnou de Bages,23,2012,60,37
210,250680,Castellnou de Seana,4,2012,45,41
211,170470,Castelló d'Empúries,104,2012,998,894
212,250693,Castelló de Farfanya,7,2012,30,23
213,080636,Castellolí,-4,2012,17,21
214,170486,Castell-Platja d'Aro,203,2012,1029,826
215,250707,Castellserà,5,2012,42,37
216,080641,Castellterçol,7,2012,136,129
217,430424,Castellvell del Camp,-18,2012,82,100
218,080654,Castellví de la Marca,-21,2012,73,94
219,080667,Castellví de Rosanes,13,2012,104,91
220,430430,"Catllar, el",1,2012,216,215
221,250714,Cava,-1,2012,2,3
222,171899,"Cellera de Ter, la",2,2012,62,60
223,170499,Celrà,52,2012,387,335
224,080673,Centelles,54,2012,329,275
225,082687,Cercs,-17,2012,56,73
226,082665,Cerdanyola del Vallès,-355,2012,2672,3027
227,080689,Cervelló,101,2012,551,450
228,250729,Cervera,-87,2012,322,409
229,250735,Cervià de les Garrigues,-14,2012,17,31
230,170502,Cervià de Ter,5,2012,40,35
231,170519,Cistella,15,2012,35,20
232,250740,Ciutadilla,1,2012,10,9
233,250753,Clariana de Cardener,-6,2012,9,15
234,250766,"Cogul, el",-1,2012,5,6
235,170545,Colera,-5,2012,25,30
236,250772,Coll de Nargó,-6,2012,17,23
237,080692,Collbató,74,2012,252,178
238,430458,Colldejou,-8,2012,8,16
239,080706,Collsuspina,-6,2012,15,21
240,170558,Colomers,1,2012,10,9
241,251636,"Coma i la Pedra, la",1,2012,18,17
242,251615,Conca de Dalt,20,2012,36,16
243,430461,Conesa,-4,2012,8,12
244,430477,Constantí,-106,2012,381,487
245,080713,Copons,2,2012,7,5
246,430483,Corbera d'Ebre,8,2012,47,39
247,080728,Corbera de Llobregat,-16,2012,740,756
248,250788,Corbins,1,2012,75,74
249,170577,Corçà,-3,2012,93,96
250,080734,Cornellà de Llobregat,-474,2012,4669,5143
251,170561,Cornellà del Terri,20,2012,125,105
252,430496,Cornudella de Montsant,-34,2012,40,74
253,430509,Creixell,67,2012,350,283
254,170583,Crespià,-10,2012,13,23
255,179011,"Cruïlles, Monells i Sant Sadurní de l'Heura",13,2012,84,71
256,080749,Cubelles,93,2012,1114,1021
257,250791,Cubells,13,2012,24,11
258,430516,Cunit,-262,2012,1037,1299
259,170600,Darnius,18,2012,47,29
260,170617,Das,-5,2012,19,24
261,439018,Deltebre,-131,2012,412,543
262,080752,Dosrius,-14,2012,324,338
263,430537,Duesaigües,5,2012,17,12
264,170622,"Escala, l'",41,2012,554,513
265,080765,Esparreguera,-39,2012,1012,1051
266,170638,Espinelves,-3,2012,10,13
267,250812,"Espluga Calba, l'",4,2012,15,11
268,430542,"Espluga de Francolí, l'",8,2012,144,136
269,080771,Esplugues de Llobregat,5,2012,2962,2957
270,170643,Espolla,-4,2012,11,15
271,170656,Esponellà,6,2012,33,27
272,250827,Espot,2,2012,13,11
273,080787,"Espunyola, l'",9,2012,13,4
274,082541,"Esquirol, l'",13,2012,80,67
275,250886,Estamariu,5,2012,9,4
276,080790,"Estany, l'",16,2012,30,14
277,250851,Estaràs,-9,2012,5,14
278,250864,Esterri d'Àneu,-3,2012,58,61
279,250870,Esterri de Cardós,-1,2012,4,5
280,430555,Falset,0,2012,99,99
281,170059,"Far d'Empordà, el",9,2012,33,24
282,250899,Farrera,-9,2012,1,10
283,430568,"Fatarella, la",-20,2012,4,24
284,430574,"Febró, la",0,2012,2,2
285,081347,Figaró-Montmany,15,2012,112,97
286,080804,Fígols,-1,2012,1,2
287,259084,Fígols i Alinyà,-6,2012,12,18
288,430580,"Figuera, la",-5,2012,3,8
289,170669,Figueres,-100,2012,2842,2942
290,430593,Figuerola del Camp,11,2012,26,15
291,170675,Flaçà,-11,2012,67,78
292,430607,Flix,15,2012,159,144
293,250925,"Floresta, la",0,2012,8,8
294,080826,Fogars de la Selva,-41,2012,108,149
295,080811,Fogars de Montclús,29,2012,62,33
296,170681,Foixà,11,2012,22,11
297,080832,Folgueroles,3,2012,80,77
298,250931,Fondarella,-4,2012,21,25
299,080847,Fonollosa,-2,2012,69,71
300,170694,Fontanals de Cerdanya,-11,2012,34,45
301,170708,Fontanilles,1,2012,5,4
302,170715,Fontcoberta,53,2012,89,36
303,080850,Font-rubí,-17,2012,46,63
304,250946,Foradada,4,2012,9,5
305,179026,Forallac,-9,2012,108,117
306,430614,Forès,-1,2012,0,1
307,170736,Fornells de la Selva,-10,2012,104,114
308,170741,Fortià,6,2012,37,31
309,080863,"Franqueses del Vallès, les",-79,2012,1239,1318
310,430629,Freginals,-12,2012,24,36
311,250962,"Fuliola, la",-10,2012,43,53
312,250978,Fulleda,4,2012,8,4
313,080902,Gaià,-4,2012,6,10
314,430635,"Galera, la",-26,2012,39,65
315,080879,Gallifa,0,2012,10,10
316,430640,Gandesa,-5,2012,98,103
317,430653,Garcia,-18,2012,21,39
318,430666,"Garidells, els",-9,2012,2,11
319,080885,"Garriga, la",87,2012,699,612
320,170754,Garrigàs,33,2012,49,16
321,170767,Garrigoles,-8,2012,5,13
322,170773,Garriguella,19,2012,61,42
323,080898,Gavà,-166,2012,2549,2715
324,250984,Gavet de la Conca,-1,2012,14,15
325,080919,Gelida,14,2012,410,396
326,170789,Ger,-21,2012,25,46
327,259123,Gimenells i el Pla de la Font,-23,2012,21,44
328,430672,Ginestar,-25,2012,18,43
329,170792,Girona,-557,2012,5721,6278
330,080924,Gironella,-33,2012,140,173
331,080930,Gisclareny,-2,2012,1,3
332,430688,Godall,-13,2012,12,25
333,250997,Golmés,14,2012,98,84
334,170806,Gombrèn,-10,2012,6,16
335,251001,Gósol,-4,2012,16,20
336,080945,"Granada, la",-3,2012,117,120
337,251018,"Granadella, la",3,2012,33,30
338,080958,Granera,-6,2012,1,7
339,251023,"Granja d'Escarp, la",-3,2012,47,50
340,080961,Granollers,-275,2012,3816,4091
341,251039,Granyanella,-1,2012,2,3
342,251057,Granyena de les Garrigues,-2,2012,9,11
343,251044,Granyena de Segarra,-3,2012,2,5
344,430691,Gratallops,-2,2012,6,8
345,080977,Gualba,35,2012,107,72
346,170813,Gualta,6,2012,63,57
347,080996,Guardiola de Berguedà,-10,2012,56,66
348,430705,"Guiamets, els",-7,2012,13,20
349,170828,Guils de Cerdanya,9,2012,52,43
350,251095,Guimerà,-8,2012,4,12
351,259031,"Guingueta d'Àneu, la",-15,2012,11,26
352,251109,Guissona,-33,2012,339,372
353,251116,Guixers,4,2012,6,2
354,081000,Gurb,-12,2012,81,93
355,430712,Horta de Sant Joan,-19,2012,27,46
356,081017,"Hospitalet de Llobregat, l'",209,2012,18296,18087
357,081629,"Hostalets de Pierola, els",26,2012,240,214
358,170834,Hostalric,-50,2012,252,302
359,081022,Igualada,-228,2012,1821,2049
360,251155,Isona i Conca Dellà,8,2012,48,40
361,170849,Isòvol,-5,2012,16,21
362,251137,Ivars d'Urgell,-17,2012,52,69
363,251121,Ivars de Noguera,-7,2012,22,29
364,251142,Ivorra,3,2012,5,2
365,170852,Jafre,-18,2012,11,29
366,170865,"Jonquera, la",-83,2012,212,295
367,081038,Jorba,15,2012,45,30
368,259101,Josa i Tuixén,1,2012,11,10
369,170871,Juià,7,2012,62,55
370,251180,Juncosa,-12,2012,10,22
371,251193,Juneda,6,2012,113,107
372,251214,Les,-18,2012,65,83
373,251229,Linyola,1,2012,123,122
374,081043,"Llacuna, la",16,2012,58,42
375,170887,Lladó,14,2012,44,30
376,251235,Lladorre,4,2012,9,5
377,251240,Lladurs,8,2012,13,5
378,081056,"Llagosta, la",-145,2012,665,810
379,170890,Llagostera,26,2012,435,409
380,170904,Llambilles,23,2012,55,32
381,170911,Llanars,-15,2012,25,40
382,170926,Llançà,-75,2012,255,330
383,251253,Llardecans,-1,2012,7,8
384,251266,Llavorsí,4,2012,24,20
385,251207,Lleida,153,2012,6356,6203
386,170932,Llers,35,2012,99,64
387,251272,Lles de Cerdanya,-2,2012,12,14
388,081075,Lliçà d'Amunt,63,2012,725,662
389,081081,Lliçà de Vall,28,2012,360,332
390,251288,Llimiana,-12,2012,3,15
391,081069,Llinars del Vallès,98,2012,648,550
392,170947,Llívia,-57,2012,96,153
393,430727,"Lloar, el",-2,2012,4,6
394,251291,Llobera,8,2012,10,2
395,430733,Llorac,-2,2012,13,15
396,430748,Llorenç del Penedès,20,2012,158,138
397,170950,Lloret de Mar,-177,2012,2463,2640
398,170963,"Llosses, les",-4,2012,6,10
399,081094,Lluçà,-21,2012,5,26
400,171024,Maçanet de Cabrenys,15,2012,43,28
401,171030,Maçanet de la Selva,2,2012,434,432
402,170979,Madremanya,15,2012,28,13
403,170985,Maià de Montcal,10,2012,37,27
404,251333,Maials,-4,2012,38,42
405,251305,Maldà,-1,2012,6,7
406,081108,Malgrat de Mar,-48,2012,1057,1105
407,081115,Malla,-7,2012,8,15
408,081120,Manlleu,-62,2012,751,813
409,081136,Manresa,-424,2012,3081,3505
410,430764,Marçà,-9,2012,30,39
411,430751,Margalef,1,2012,6,5
412,082423,Marganell,1,2012,26,25
413,081141,Martorell,-127,2012,1447,1574
414,081154,Martorelles,-77,2012,237,314
415,430770,Mas de Barberans,3,2012,21,18
416,171002,Masarac,6,2012,21,15
417,430786,Masdenverge,13,2012,86,73
418,081167,"Masies de Roda, les",-11,2012,26,37
419,081173,"Masies de Voltregà, les",38,2012,131,93
420,430799,Masllorenç,-3,2012,39,42
421,081189,"Masnou, el",16,2012,1127,1111
422,430803,"Masó, la",-3,2012,18,21
423,430810,Maspujols,14,2012,35,21
424,081192,Masquefa,14,2012,493,479
425,430825,"Masroig, el",2,2012,16,14
426,251312,Massalcoreig,-2,2012,26,28
427,171019,Massanes,-3,2012,54,57
428,251327,Massoteres,4,2012,10,6
429,081206,Matadepera,103,2012,457,354
430,081213,Mataró,-350,2012,5100,5450
431,081228,Mediona,33,2012,203,170
432,251348,Menàrguens,5,2012,43,38
433,170998,Meranges,5,2012,10,5
434,171058,Mieres,7,2012,21,14
435,430831,"Milà, el",-1,2012,6,7
436,251351,Miralcamp,-26,2012,51,77
437,430846,Miravet,0,2012,33,33
438,081385,Moià,-37,2012,300,337
439,430859,"Molar, el",8,2012,13,5
440,081234,Molins de Rei,-37,2012,985,1022
441,251370,Mollerussa,69,2012,783,714
442,171061,Mollet de Peralada,-1,2012,6,7
443,081249,Mollet del Vallès,-426,2012,2387,2813
444,171077,Molló,6,2012,27,21
445,251364,"Molsosa, la",3,2012,4,1
446,081287,Monistrol de Calders,-7,2012,27,34
447,081271,Monistrol de Montserrat,-29,2012,185,214
448,171096,Montagut i Oix,-17,2012,37,54
449,430862,Montblanc,-3,2012,300,303
450,430884,Montbrió del Camp,105,2012,281,176
451,081252,Montcada i Reixac,122,2012,2091,1969
452,081304,Montclar,6,2012,12,6
453,251399,Montellà i Martinet,-19,2012,33,52
454,081311,Montesquiu,-7,2012,46,53
455,251403,Montferrer i Castellbò,-26,2012,64,90
456,430897,Montferri,-21,2012,35,56
457,251386,Montgai,-2,2012,17,19
458,081265,Montgat,133,2012,720,587
459,081326,Montmajor,-4,2012,17,21
460,081332,Montmaneu,-14,2012,4,18
461,430901,"Montmell, el",-33,2012,114,147
462,081350,Montmeló,10,2012,400,390
463,251425,Montoliu de Lleida,1,2012,19,18
464,251410,Montoliu de Segarra,3,2012,8,5
465,251431,Montornès de Segarra,11,2012,14,3
466,081363,Montornès del Vallès,-100,2012,790,890
467,430918,Mont-ral,4,2012,15,11
468,171100,Mont-ras,-33,2012,65,98
469,430923,Mont-roig del Camp,165,2012,1084,919
470,081379,Montseny,16,2012,33,17
471,430939,Móra d'Ebre,-111,2012,227,338
472,430944,Móra la Nova,-20,2012,126,146
473,430957,"Morell, el",-54,2012,267,321
474,430960,"Morera de Montsant, la",-5,2012,10,15
475,081290,Muntanyola,-9,2012,33,42
476,081398,Mura,-20,2012,12,32
477,251459,Nalec,8,2012,8,0
478,250254,Naut Aran,-3,2012,101,104
479,081402,Navarcles,19,2012,270,251
480,081419,Navàs,14,2012,257,243
481,171117,Navata,-12,2012,86,98
482,251462,Navès,-5,2012,8,13
483,081424,"Nou de Berguedà, la",0,2012,2,2
484,430976,"Nou de Gaià, la",7,2012,42,35
485,430982,Nulles,1,2012,35,34
486,251484,Odèn,0,2012,12,12
487,081430,Òdena,30,2012,229,199
488,171122,Ogassa,3,2012,12,9
489,081458,Olèrdola,7,2012,215,208
490,081461,Olesa de Bonesvalls,-27,2012,76,103
491,081477,Olesa de Montserrat,-207,2012,1038,1245
492,251497,Oliana,6,2012,58,52
493,251500,Oliola,11,2012,18,7
494,251517,Olius,16,2012,41,25
495,081483,Olivella,-82,2012,315,397
496,081496,Olost,1,2012,38,37
497,171143,Olot,247,2012,1371,1124
498,251522,"Oluges, les",0,2012,5,5
499,081445,Olvan,-7,2012,34,41
500,251538,"Omellons, els",-1,2012,6,7
501,251543,"Omells de na Gaia, els",-3,2012,2,5
502,171156,Ordis,-6,2012,8,14
503,251556,Organyà,-13,2012,46,59
504,081509,Orís,-14,2012,12,26
505,081516,Oristà,0,2012,31,31
506,081521,Orpí,-6,2012,3,9
507,081537,Òrrius,4,2012,29,25
508,251569,Os de Balaguer,33,2012,71,38
509,171169,Osor,9,2012,30,21
510,251575,Ossó de Sió,-1,2012,4,5
511,081542,Pacs del Penedès,15,2012,45,30
512,081555,Palafolls,8,2012,495,487
513,171175,Palafrugell,3,2012,978,975
514,171181,Palamós,73,2012,1008,935
515,251581,"Palau d'Anglesola, el",-17,2012,76,93
516,171194,Palau de Santa Eulàlia,0,2012,4,4
517,171215,Palau-sator,15,2012,33,18
518,171208,Palau-saverdera,-16,2012,96,112
519,081568,Palau-solità i Plegamans,-23,2012,624,647
520,431009,"Pallaresos, els",29,2012,159,130
521,081574,Pallejà,-69,2012,474,543
522,430995,"Palma d'Ebre, la",-5,2012,11,16
523,089058,"Palma de Cervelló, la",-87,2012,151,238
524,171236,Palol de Revardit,-3,2012,19,22
525,171241,Pals,-48,2012,126,174
526,081580,"Papiol, el",26,2012,214,188
527,171254,Pardines,2,2012,4,2
528,081593,Parets del Vallès,8,2012,908,900
529,171267,Parlavà,21,2012,34,13
530,431016,Passanant i Belltall,-9,2012,7,16
531,171289,Pau,-10,2012,24,34
532,431021,Paüls,-8,2012,12,20
533,171292,Pedret i Marzà,2,2012,8,6
534,251641,Penelles,-9,2012,18,27
535,171306,"Pera, la",14,2012,25,11
536,081607,Perafita,16,2012,21,5
537,431037,Perafort,-9,2012,93,102
538,171328,Peralada,33,2012,127,94
539,251654,Peramola,1,2012,8,7
540,431042,"Perelló, el",27,2012,121,94
541,081614,Piera,57,2012,862,805
542,431055,"Piles, les",0,2012,12,12
543,081635,Pineda de Mar,47,2012,1490,1443
544,431068,"Pinell de Brai, el",-3,2012,18,21
545,251667,Pinell de Solsonès,0,2012,4,4
546,251673,Pinós,-8,2012,11,19
547,431074,Pira,-8,2012,14,22
548,431080,"Pla de Santa Maria, el",-37,2012,113,150
549,081640,"Pla del Penedès, el",8,2012,89,81
550,171334,"Planes d'Hostoles, les",3,2012,76,73
551,171349,Planoles,-2,2012,13,15
552,259118,"Plans de Sió, els",5,2012,24,19
553,251689,"Poal, el",2,2012,21,19
554,251692,"Pobla de Cérvoles, la",-8,2012,7,15
555,081653,"Pobla de Claramunt, la",-33,2012,151,184
556,081666,"Pobla de Lillet, la",-30,2012,29,59
557,431093,"Pobla de Mafumet, la",226,2012,423,197
558,431107,"Pobla de Massaluca, la",7,2012,12,5
559,431114,"Pobla de Montornès, la",1,2012,191,190
560,251713,"Pobla de Segur, la",-54,2012,99,153
561,431129,Poboleda,0,2012,23,23
562,081672,Polinyà,-44,2012,338,382
563,431135,"Pont d'Armentera, el",-5,2012,31,36
564,250306,"Pont de Bar, el",0,2012,9,9
565,171352,Pont de Molins,1,2012,25,24
566,251734,"Pont de Suert, el",-39,2012,89,128
567,081825,"Pont de Vilomara i Rocafort, el",-12,2012,189,201
568,431418,Pontils,-10,2012,10,20
569,081688,Pontons,-20,2012,56,76
570,171365,Pontós,-4,2012,11,15
571,251728,Ponts,5,2012,138,133
572,171371,Porqueres,13,2012,220,207
573,431140,Porrera,6,2012,24,18
574,171404,"Port de la Selva, el",-11,2012,54,65
575,171387,Portbou,-11,2012,61,72
576,251749,"Portella, la",-9,2012,47,56
577,431153,Pradell de la Teixeta,-8,2012,0,8
578,431166,Prades,7,2012,46,39
579,431172,Prat de Comte,-5,2012,4,9
580,081691,"Prat de Llobregat, el",118,2012,2505,2387
581,431188,Pratdip,-6,2012,60,66
582,081712,Prats de Lluçanès,25,2012,89,64
583,081705,"Prats de Rei, els",29,2012,43,14
584,251752,Prats i Sansor,-6,2012,20,26
585,251765,Preixana,-1,2012,16,17
586,251771,Preixens,-4,2012,17,21
587,082303,Premià de Dalt,21,2012,606,585
588,081727,Premià de Mar,-19,2012,1618,1637
589,171390,"Preses, les",32,2012,107,75
590,251790,Prullans,-20,2012,11,31
591,171411,Puigcerdà,-65,2012,460,525
592,081748,Puigdàlber,-11,2012,22,33
593,251804,Puiggròs,-11,2012,21,32
594,431191,Puigpelat,42,2012,80,38
595,081751,Puig-reig,0,2012,220,220
596,251811,Puigverd d'Agramunt,-6,2012,12,18
597,251826,Puigverd de Lleida,4,2012,54,50
598,081764,Pujalt,-6,2012,2,8
599,081770,"Quar, la",0,2012,5,5
600,171426,Quart,65,2012,189,124
601,170433,Queralbs,6,2012,12,6
602,431205,Querol,-11,2012,60,71
603,171432,Rabós,6,2012,12,6
604,081786,Rajadell,-6,2012,29,35
605,431212,Rasquera,5,2012,27,22
606,171447,Regencós,-1,2012,16,17
607,081799,Rellinars,13,2012,55,42
608,431227,Renau,-5,2012,10,15
609,431233,Reus,-817,2012,3999,4816
610,251832,Rialp,5,2012,57,52
611,431248,"Riba, la",-35,2012,10,45
612,431251,Riba-roja d'Ebre,7,2012,41,34
613,259059,Ribera d'Ondara,-11,2012,15,26
614,251850,Ribera d'Urgellet,-31,2012,64,95
615,171450,Ribes de Freser,-5,2012,65,70
616,171463,Riells i Viabrea,-38,2012,258,296
617,431264,"Riera de Gaià, la",-62,2012,65,127
618,251863,Riner,-5,2012,13,18
619,171479,Ripoll,-89,2012,319,408
620,081803,Ripollet,-281,2012,1944,2225
621,259139,Riu de Cerdanya,-1,2012,12,13
622,171485,Riudarenes,-1,2012,134,135
623,171498,Riudaura,16,2012,29,13
624,431270,Riudecanyes,-14,2012,47,61
625,431286,Riudecols,7,2012,63,56
626,171501,Riudellots de la Selva,24,2012,108,84
627,431299,Riudoms,-67,2012,254,321
628,171518,Riumors,-8,2012,10,18
629,081810,"Roca del Vallès, la",-32,2012,544,576
630,431303,Rocafort de Queralt,0,2012,12,12
631,431310,Roda de Berà,99,2012,555,456
632,081831,Roda de Ter,-69,2012,237,306
633,431325,Rodonyà,-13,2012,31,44
634,431331,Roquetes,-66,2012,372,438
635,171523,Roses,-94,2012,1144,1238
636,251898,Rosselló,-16,2012,154,170
637,431346,"Rourell, el",2,2012,16,14
638,081846,Rubí,-207,2012,3282,3489
639,081859,Rubió,-16,2012,9,25
640,171539,Rupià,-9,2012,13,22
641,089019,Rupit i Pruit,-10,2012,11,21
642,081878,Sabadell,-346,2012,8580,8926
643,081884,Sagàs,5,2012,13,8
644,251902,Salàs de Pallars,16,2012,32,16
645,081901,Saldes,-8,2012,5,13
646,171544,Sales de Llierca,-6,2012,1,7
647,081918,Sallent,-21,2012,170,191
648,431359,Salomó,-6,2012,13,19
649,439057,Salou,37,2012,2764,2727
650,171557,Salt,-217,2012,2131,2348
651,251919,Sanaüja,-4,2012,13,17
652,081944,Sant Adrià de Besòs,501,2012,2752,2251
653,081957,Sant Agustí de Lluçanès,-3,2012,0,3
654,081960,Sant Andreu de la Barca,-81,2012,1274,1355
655,081976,Sant Andreu de Llavaneres,10,2012,695,685
656,171576,Sant Andreu Salou,-3,2012,3,6
657,171833,Sant Aniol de Finestres,8,2012,25,17
658,081982,Sant Antoni de Vilamajor,36,2012,394,358
659,081995,Sant Bartomeu del Grau,-24,2012,37,61
660,082009,Sant Boi de Llobregat,-151,2012,3485,3636
661,082016,Sant Boi de Lluçanès,25,2012,45,20
662,431362,Sant Carles de la Ràpita,82,2012,746,664
663,082037,Sant Cebrià de Vallalta,-16,2012,213,229
664,082021,Sant Celoni,165,2012,1044,879
665,082042,Sant Climent de Llobregat,-9,2012,155,164
666,171582,Sant Climent Sescebes,12,2012,81,69
667,082055,Sant Cugat del Vallès,680,2012,4827,4147
668,082068,Sant Cugat Sesgarrigues,-7,2012,33,40
669,251961,Sant Esteve de la Sarga,-7,2012,6,13
670,082074,Sant Esteve de Palautordera,-10,2012,117,127
671,082080,Sant Esteve Sesrovires,27,2012,417,390
672,171595,Sant Feliu de Buixalleu,-1,2012,41,42
673,082107,Sant Feliu de Codines,-81,2012,325,406
674,171609,Sant Feliu de Guíxols,-137,2012,1136,1273
675,082114,Sant Feliu de Llobregat,86,2012,1785,1699
676,171616,Sant Feliu de Pallerols,-6,2012,63,69
677,082129,Sant Feliu Sasserra,-13,2012,16,29
678,171621,Sant Ferriol,10,2012,28,18
679,082093,Sant Fost de Campsentelles,129,2012,513,384
680,082135,Sant Fruitós de Bages,30,2012,390,360
681,171637,Sant Gregori,108,2012,254,146
682,251924,Sant Guim de Freixenet,4,2012,45,41
683,251977,Sant Guim de la Plana,-2,2012,8,10
684,171642,Sant Hilari Sacalm,-26,2012,144,170
685,082153,Sant Hipòlit de Voltregà,-46,2012,144,190
686,081939,Sant Iscle de Vallalta,-6,2012,86,92
687,439023,Sant Jaume d'Enveja,27,2012,151,124
688,082166,Sant Jaume de Frontanyà,-3,2012,0,3
689,171655,Sant Jaume de Llierca,44,2012,86,42
690,431378,Sant Jaume dels Domenys,53,2012,179,126
691,171674,Sant Joan de les Abadesses,-17,2012,82,99
692,171680,Sant Joan de Mollet,6,2012,29,23
693,082188,Sant Joan de Vilatorrada,-11,2012,418,429
694,082172,Sant Joan Despí,-21,2012,1508,1529
695,171851,Sant Joan les Fonts,10,2012,130,120
696,171668,Sant Jordi Desvalls,0,2012,39,39
697,089030,Sant Julià de Cerdanyola,-10,2012,6,16
698,171693,Sant Julià de Ramis,-14,2012,224,238
699,082205,Sant Julià de Vilatorta,41,2012,162,121
700,179032,Sant Julià del Llor i Bonmatí,17,2012,78,61
701,082212,Sant Just Desvern,402,2012,1124,722
702,082227,Sant Llorenç d'Hortons,3,2012,165,162
703,171714,Sant Llorenç de la Muga,2,2012,11,9
704,251930,Sant Llorenç de Morunys,-28,2012,40,68
705,082233,Sant Llorenç Savall,-3,2012,119,122
706,082251,Sant Martí d'Albars,-1,2012,2,3
707,082248,Sant Martí de Centelles,4,2012,116,112
708,171729,Sant Martí de Llémena,20,2012,65,45
709,259025,Sant Martí de Riucorb,7,2012,32,25
710,082264,Sant Martí de Tous,6,2012,43,37
711,082270,Sant Martí Sarroca,-36,2012,130,166
712,082286,Sant Martí Sesgueioles,12,2012,19,7
713,171735,Sant Martí Vell,-20,2012,7,27
714,082299,Sant Mateu de Bages,5,2012,24,19
715,171740,Sant Miquel de Campmajor,-10,2012,3,13
716,171753,Sant Miquel de Fluvià,16,2012,58,42
717,171766,Sant Mori,-2,2012,7,9
718,171772,Sant Pau de Segúries,14,2012,46,32
719,082310,Sant Pere de Ribes,-34,2012,1788,1822
720,082325,Sant Pere de Riudebitlles,-27,2012,81,108
721,082331,Sant Pere de Torelló,-29,2012,85,114
722,082346,Sant Pere de Vilamajor,6,2012,246,240
723,171788,Sant Pere Pescador,-3,2012,141,144
724,081897,Sant Pere Sallavinera,4,2012,8,4
725,082359,Sant Pol de Mar,11,2012,291,280
726,082362,Sant Quintí de Mediona,8,2012,128,120
727,082378,Sant Quirze de Besora,-8,2012,71,79
728,082384,Sant Quirze del Vallès,116,2012,887,771
729,082397,Sant Quirze Safaja,-2,2012,61,63
730,251945,Sant Ramon,-9,2012,13,22
731,082401,Sant Sadurní d'Anoia,48,2012,573,525
732,082418,Sant Sadurní d'Osormort,-4,2012,7,11
733,080983,Sant Salvador de Guardiola,-13,2012,169,182
734,082628,Sant Vicenç de Castellet,-29,2012,586,615
735,082649,Sant Vicenç de Montalt,97,2012,522,425
736,082652,Sant Vicenç de Torelló,-5,2012,67,72
737,082634,Sant Vicenç dels Horts,60,2012,1315,1255
738,431384,Santa Bàrbara,-18,2012,223,241
739,082439,Santa Cecília de Voltregà,1,2012,3,2
740,082444,Santa Coloma de Cervelló,46,2012,385,339
741,171805,Santa Coloma de Farners,52,2012,641,589
742,082457,Santa Coloma de Gramenet,-701,2012,8405,9106
743,431397,Santa Coloma de Queralt,-64,2012,83,147
744,171812,Santa Cristina d'Aro,9,2012,310,301
745,082460,Santa Eugènia de Berga,-28,2012,133,161
746,082476,Santa Eulàlia de Riuprimer,25,2012,69,44
747,082482,Santa Eulàlia de Ronçana,-6,2012,301,307
748,082495,Santa Fe del Penedès,-6,2012,7,13
749,171827,Santa Llogaia d'Àlguema,0,2012,22,22
750,082508,Santa Margarida de Montbui,-25,2012,463,488
751,082515,Santa Margarida i els Monjos,105,2012,496,391
752,082589,Santa Maria d'Oló,9,2012,37,28
753,082536,Santa Maria de Besora,8,2012,14,6
754,082567,Santa Maria de Martorelles,-4,2012,44,48
755,082554,Santa Maria de Merlès,2,2012,8,6
756,082573,Santa Maria de Miralles,0,2012,6,6
757,082592,Santa Maria de Palautordera,45,2012,487,442
758,431401,Santa Oliva,-6,2012,253,259
759,171848,Santa Pau,-10,2012,54,64
760,082606,Santa Perpètua de Mogoda,-277,2012,1132,1409
761,082613,Santa Susanna,-22,2012,237,259
762,081923,Santpedor,110,2012,352,242
763,431423,Sarral,-18,2012,68,86
764,171864,Sarrià de Ter,81,2012,361,280
765,252017,Sarroca de Bellera,-1,2012,3,4
766,252000,Sarroca de Lleida,0,2012,13,13
767,171870,"Saus, Camallera i Llampaies",26,2012,62,36
768,431439,Savallà del Comtat,-3,2012,3,6
769,431444,"Secuita, la",17,2012,95,78
770,171886,"Selva de Mar, la",-8,2012,5,13
771,431457,"Selva del Camp, la",-7,2012,200,207
772,431460,Senan,-5,2012,1,6
773,430445,"Sénia, la",-90,2012,186,276
774,252022,Senterada,8,2012,16,8
775,250352,"Sentiu de Sió, la",3,2012,19,16
776,082671,Sentmenat,98,2012,449,351
777,171903,Serinyà,-23,2012,55,78
778,252043,Seròs,3,2012,93,90
779,171910,Serra de Daró,-1,2012,10,11
780,171925,Setcases,4,2012,14,10
781,252038,"Seu d'Urgell, la",-17,2012,638,655
782,082690,Seva,42,2012,191,149
783,252056,Sidamon,-6,2012,19,25
784,171931,Sils,-44,2012,397,441
785,082704,Sitges,29,2012,2012,1983
786,170524,Siurana,2,2012,12,10
787,082711,Sobremunt,-1,2012,4,5
788,252069,"Soleràs, el",0,2012,18,18
789,431476,Solivella,-6,2012,16,22
790,252075,Solsona,-11,2012,295,306
791,082726,Sora,-9,2012,6,15
792,252081,Soriguera,9,2012,25,16
793,252094,Sort,-33,2012,108,141
794,252108,Soses,-20,2012,53,73
795,082732,Subirats,-30,2012,112,142
796,252115,Sudanell,-6,2012,28,34
797,252120,Sunyer,5,2012,17,12
798,082747,Súria,-49,2012,173,222
799,171946,Susqueda,-3,2012,5,8
800,082763,Tagamanent,-5,2012,27,32
801,082779,Talamanca,-7,2012,9,16
802,252154,Talarn,-124,2012,78,202
803,252167,Talavera,-1,2012,5,6
804,171959,"Tallada d'Empordà, la",-1,2012,37,38
805,082785,Taradell,9,2012,235,226
806,431482,Tarragona,-36,2012,5937,5973
807,252173,Tàrrega,25,2012,768,743
808,252189,Tarrés,0,2012,3,3
809,252192,Tarroja de Segarra,-3,2012,4,7
810,082750,Tavèrnoles,3,2012,14,11
811,082802,Tavertet,-9,2012,6,15
812,082819,Teià,-2,2012,289,291
813,252206,Térmens,-25,2012,58,83
814,171962,Terrades,5,2012,23,18
815,082798,Terrassa,-905,2012,8460,9365
816,082824,Tiana,33,2012,406,373
817,252213,Tírvia,4,2012,9,5
818,252228,Tiurana,-2,2012,4,6
819,431495,Tivenys,7,2012,30,23
820,431508,Tivissa,-1,2012,64,65
821,082830,Tona,-28,2012,337,365
822,252234,Torà,-30,2012,40,70
823,082845,Tordera,122,2012,1214,1092
824,082858,Torelló,14,2012,517,503
825,252249,"Torms, els",-7,2012,0,7
826,252252,Tornabous,14,2012,45,31
827,252271,"Torre de Cabdella, la",6,2012,36,30
828,082861,"Torre de Claramunt, la",-28,2012,213,241
829,431515,"Torre de Fontaubella, la",-3,2012,5,8
830,431520,"Torre de l'Espanyol, la",9,2012,38,29
831,252265,Torrebesses,2,2012,10,8
832,431536,Torredembarra,80,2012,1148,1068
833,252287,Torrefarrera,44,2012,282,238
834,259078,Torrefeta i Florejacs,-2,2012,23,25
835,252304,Torregrossa,-4,2012,97,101
836,252311,Torrelameu,14,2012,39,25
837,082877,Torrelavit,-12,2012,78,90
838,082883,Torrelles de Foix,-39,2012,173,212
839,082896,Torrelles de Llobregat,11,2012,325,314
840,171978,Torrent,-8,2012,5,13
841,252326,Torres de Segre,87,2012,172,85
842,252332,Torre-serona,21,2012,43,22
843,171984,Torroella de Fluvià,19,2012,47,28
844,171997,Torroella de Montgrí,-33,2012,626,659
845,431541,Torroja del Priorat,-6,2012,9,15
846,172001,Tortellà,-17,2012,24,41
847,431554,Tortosa,-732,2012,1358,2090
848,172018,Toses,-5,2012,3,8
849,172023,Tossa de Mar,-11,2012,253,264
850,252347,Tremp,-195,2012,324,519
851,172044,Ullà,14,2012,142,128
852,082900,Ullastrell,42,2012,102,60
853,172057,Ullastret,3,2012,16,13
854,431567,Ulldecona,-102,2012,293,395
855,431573,Ulldemolins,3,2012,23,20
856,172039,Ultramort,4,2012,18,14
857,172060,Urús,-18,2012,6,24
858,082917,Vacarisses,-24,2012,384,408
859,170144,"Vajol, la",0,2012,9,9
860,172076,"Vall d'en Bas, la",31,2012,124,93
861,172082,"Vall de Bianya, la",-21,2012,59,80
862,250432,"Vall de Boí, la",-35,2012,42,77
863,259010,Vall de Cardós,-4,2012,14,18
864,082922,Vallbona d'Anoia,8,2012,54,46
865,252385,Vallbona de les Monges,12,2012,21,9
866,082938,Vallcebre,-10,2012,7,17
867,431589,Vallclara,-9,2012,3,12
868,252402,Vallfogona de Balaguer,11,2012,87,76
869,171707,Vallfogona de Ripollès,6,2012,12,6
870,431592,Vallfogona de Riucorb,-1,2012,4,5
871,082943,Vallgorguina,66,2012,199,133
872,082956,Vallirana,59,2012,766,707
873,172095,Vall-llobrega,4,2012,50,46
874,431606,Vallmoll,-6,2012,82,88
875,082969,Vallromanes,55,2012,171,116
876,431613,Valls,-70,2012,949,1019
877,259062,"Valls d'Aguilar, les",21,2012,31,10
878,252398,"Valls de Valira, les",25,2012,78,53
879,431628,Vandellòs i l'Hospitalet de l'Infant,18,2012,416,398
880,259097,"Vansa i Fórnols, la",4,2012,14,10
881,082975,Veciana,10,2012,13,3
882,431634,"Vendrell, el",-13,2012,2280,2293
883,172109,Ventalló,20,2012,71,51
884,252424,Verdú,-1,2012,43,44
885,172116,Verges,17,2012,61,44
886,431649,Vespella de Gaià,11,2012,37,26
887,082981,Vic,408,2012,2491,2083
888,172121,Vidrà,6,2012,7,1
889,172137,Vidreres,47,2012,500,453
890,252430,Vielha e Mijaran,-16,2012,444,460
891,431652,Vilabella,-19,2012,18,37
892,172142,Vilabertran,2,2012,41,39
893,172155,Vilablareix,50,2012,130,80
894,082994,Vilada,-17,2012,6,23
895,172174,Viladamat,7,2012,33,26
896,172168,Viladasens,10,2012,16,6
897,083015,Viladecans,-23,2012,2837,2860
898,083008,Viladecavalls,-31,2012,340,371
899,172180,Vilademuls,28,2012,63,35
900,172207,Viladrau,-30,2012,34,64
901,172214,Vilafant,35,2012,327,292
902,083054,Vilafranca del Penedès,-206,2012,1946,2152
903,252445,Vilagrassa,21,2012,55,34
904,172235,Vilajuïga,47,2012,107,60
905,431750,Vilalba dels Arcs,-2,2012,5,7
906,083067,Vilalba Sasserra,-24,2012,53,77
907,252458,Vilaller,-32,2012,22,54
908,172240,Vilallonga de Ter,-11,2012,20,31
909,431665,Vilallonga del Camp,9,2012,198,189
910,172253,Vilamacolum,11,2012,26,15
911,172266,Vilamalla,-5,2012,69,74
912,172272,Vilamaniscle,7,2012,15,8
913,252477,Vilamòs,-1,2012,19,20
914,172288,Vilanant,9,2012,37,28
915,431671,Vilanova d'Escornalbou,-5,2012,24,29
916,252483,Vilanova de Bellpuig,-20,2012,25,45
917,252496,Vilanova de l'Aguda,-5,2012,5,10
918,252542,Vilanova de la Barca,-12,2012,58,70
919,252509,Vilanova de Meià,-1,2012,13,14
920,431687,Vilanova de Prades,2,2012,10,8
921,083036,Vilanova de Sau,3,2012,10,7
922,252516,Vilanova de Segrià,8,2012,90,82
923,083020,Vilanova del Camí,-92,2012,532,624
924,089024,Vilanova del Vallès,58,2012,288,230
925,083073,Vilanova i la Geltrú,-196,2012,2880,3076
926,431690,Vilaplana,2,2012,18,16
927,431704,Vila-rodona,-15,2012,56,71
928,172305,Vila-sacra,-16,2012,51,67
929,252521,Vila-sana,10,2012,32,22
930,431711,Vila-seca,89,2012,1524,1435
931,082140,Vilassar de Dalt,26,2012,428,402
932,082191,Vilassar de Mar,123,2012,1098,975
933,172229,Vilaür,7,2012,13,6
934,431726,Vilaverd,17,2012,48,31
935,431732,"Vilella Alta, la",-7,2012,2,9
936,431747,"Vilella Baixa, la",-7,2012,8,15
937,172333,Vilobí d'Onyar,27,2012,180,153
938,083041,Vilobí del Penedès,-6,2012,42,48
939,172327,Vilopriu,-12,2012,15,27
940,252537,"Vilosell, el",2,2012,11,9
941,431763,Vimbodí i Poblet,-26,2012,13,39
942,252555,Vinaixa,-6,2012,12,18
943,431779,Vinebre,-14,2012,37,51
944,431785,Vinyols i els Arcs,6,2012,145,139
945,083089,Viver i Serrateix,-3,2012,3,6
946,430521,Xerta,-7,2012,32,39
0,250019,Abella de la Conca,6,2013,11,5
1,080018,Abrera,-27,2013,571,598
2,250024,Àger,1,2013,30,29
3,250030,Agramunt,-87,2013,165,252
4,080023,Aguilar de Segarra,5,2013,18,13
5,170010,Agullana,-1,2013,53,54
6,080142,Aiguafreda,8,2013,152,144
7,430017,Aiguamúrcia,-7,2013,40,47
8,170025,Aiguaviva,-8,2013,19,27
9,250387,Aitona,21,2013,152,131
10,250045,"Alamús, els",7,2013,37,30
11,250058,Alàs i Cerc,1,2013,16,15
12,250061,"Albagés, l'",-8,2013,11,19
13,170031,Albanyà,-3,2013,9,12
14,250077,Albatàrrec,-11,2013,172,183
15,250083,Albesa,-22,2013,50,72
16,250096,"Albi, l'",-26,2013,12,38
17,430022,Albinyana,-1,2013,145,146
18,430038,"Albiol, l'",-1,2013,23,24
19,170046,Albons,-6,2013,42,48
20,430043,Alcanar,-457,2013,369,826
21,250100,Alcanó,1,2013,4,3
22,250117,Alcarràs,179,2013,725,546
23,250122,Alcoletge,6,2013,214,208
24,430056,Alcover,-18,2013,212,230
25,439044,"Aldea, l'",-102,2013,227,329
26,430069,Aldover,3,2013,38,35
27,430075,"Aleixar, l'",7,2013,61,54
28,080039,Alella,17,2013,520,503
29,430081,Alfara de Carles,-5,2013,10,15
30,250138,Alfarràs,-1,2013,111,112
31,250143,Alfés,-3,2013,9,12
32,430094,Alforja,22,2013,121,99
33,250156,Algerri,1,2013,20,19
34,250169,Alguaire,-10,2013,137,147
35,250175,Alins,-14,2013,9,23
36,430108,Alió,4,2013,28,24
37,250194,Almacelles,-19,2013,223,242
38,250208,Almatret,-9,2013,7,16
39,250215,Almenar,-50,2013,164,214
40,430115,Almoster,9,2013,55,46
41,250220,Alòs de Balaguer,-6,2013,7,13
42,170062,Alp,-52,2013,94,146
43,080044,Alpens,2,2013,14,12
44,250236,Alpicat,-1,2013,229,230
45,250241,Alt Àneu,-4,2013,18,22
46,430120,Altafulla,42,2013,324,282
47,170078,Amer,3,2013,99,96
48,430136,"Ametlla de Mar, l'",13,2013,271,258
49,080057,"Ametlla del Vallès, l'",44,2013,462,418
50,439060,"Ampolla, l'",50,2013,261,211
51,430141,Amposta,-295,2013,728,1023
52,170084,Anglès,-69,2013,220,289
53,250273,Anglesola,-1,2013,55,56
54,250292,Arbeca,-8,2013,83,91
55,430167,"Arboç, l'",-22,2013,326,348
56,430154,Arbolí,-5,2013,5,10
57,170097,Arbúcies,-67,2013,243,310
58,080060,Arenys de Mar,179,2013,993,814
59,080076,Arenys de Munt,65,2013,455,390
60,170101,Argelaguer,2,2013,29,27
61,080082,Argençola,-7,2013,5,12
62,430173,"Argentera, l'",-2,2013,7,9
63,080095,Argentona,94,2013,581,487
64,170118,"Armentera, l'",23,2013,74,51
65,430189,Arnes,-2,2013,12,14
66,250313,Arres,11,2013,12,1
67,250328,Arsèguel,-4,2013,1,5
68,080109,Artés,45,2013,300,255
69,250334,Artesa de Lleida,-1,2013,49,50
70,250349,Artesa de Segre,-20,2013,137,157
71,430192,Ascó,14,2013,55,41
72,250365,Aspa,1,2013,7,6
73,250371,"Avellanes i Santa Linya, les",8,2013,37,29
74,080116,Avià,-29,2013,85,114
75,080121,Avinyó,-14,2013,74,88
76,170123,Avinyonet de Puigventós,11,2013,77,66
77,080137,Avinyonet del Penedès,-18,2013,92,110
78,080155,Badalona,-2640,2013,10550,13190
79,089045,Badia del Vallès,-26,2013,584,610
80,080168,Bagà,-45,2013,66,111
81,250390,Baix Pallars,-6,2013,20,26
82,250404,Balaguer,-200,2013,781,981
83,080174,Balenyà,-11,2013,166,177
84,080180,Balsareny,-7,2013,100,107
85,430206,Banyeres del Penedès,-2,2013,159,161
86,170157,Banyoles,-226,2013,849,1075
87,250411,Barbens,9,2013,43,34
88,430213,Barberà de la Conca,-5,2013,25,30
89,082520,Barberà del Vallès,-155,2013,1431,1586
90,080193,Barcelona,-3192,2013,83342,86534
91,250426,"Baronia de Rialb, la",-22,2013,6,28
92,170160,Bàscara,4,2013,40,36
93,250447,Bassella,-1,2013,7,8
94,430228,Batea,-91,2013,48,139
95,250450,Bausen,-3,2013,0,3
96,080207,Begues,1,2013,364,363
97,170139,Begur,-50,2013,207,257
98,250463,Belianes,0,2013,20,20
99,251706,Bellaguarda,-4,2013,3,7
100,170182,Bellcaire d'Empordà,-20,2013,36,56
101,250479,Bellcaire d'Urgell,9,2013,75,66
102,250485,Bell-lloc d'Urgell,-1,2013,97,98
103,250498,Bellmunt d'Urgell,-4,2013,4,8
104,430234,Bellmunt del Priorat,-3,2013,7,10
105,080214,Bellprat,-10,2013,0,10
106,250501,Bellpuig,-4,2013,231,235
107,430249,Bellvei,49,2013,220,171
108,250518,Bellver de Cerdanya,-72,2013,86,158
109,250523,Bellvís,-10,2013,104,114
110,250539,Benavent de Segrià,-14,2013,77,91
111,430252,Benifallet,-13,2013,0,13
112,430265,Benissanet,-18,2013,58,76
113,080229,Berga,-126,2013,532,658
114,170195,Besalú,3,2013,95,92
115,170209,Bescanó,12,2013,210,198
116,170216,Beuda,11,2013,26,15
117,080235,Bigues i Riells del Fai,62,2013,430,368
118,250557,Biosca,-2,2013,5,7
119,170221,"Bisbal d'Empordà, la",-188,2013,498,686
120,430271,"Bisbal de Falset, la",1,2013,3,2
121,430287,"Bisbal del Penedès, la",29,2013,276,247
122,172348,Biure,3,2013,14,11
123,430290,Blancafort,-5,2013,15,20
124,170237,Blanes,-280,2013,2084,2364
125,170293,Boadella i les Escaules,1,2013,13,12
126,170242,Bolvir,0,2013,34,34
127,430304,Bonastre,-38,2013,35,73
128,250576,"Bòrdes, Es",2,2013,12,10
129,170255,Bordils,-41,2013,118,159
130,250582,"Borges Blanques, les",5,2013,299,294
131,430311,"Borges del Camp, les",-42,2013,78,120
132,170268,Borrassà,16,2013,45,29
133,080240,Borredà,-8,2013,26,34
134,250595,Bossòst,-47,2013,51,98
135,430326,Bot,-25,2013,7,32
136,430332,Botarell,-10,2013,53,63
137,250560,Bovera,5,2013,12,7
138,430347,Bràfim,-14,2013,26,40
139,170274,Breda,19,2013,201,182
140,080253,"Bruc, el",-34,2013,120,154
141,080266,"Brull, el",-3,2013,10,13
142,170280,Brunyola i Sant Martí Sapresa,-1,2013,18,19
143,430350,Cabacés,-3,2013,5,8
144,250609,Cabanabona,-9,2013,6,15
145,170314,Cabanelles,-5,2013,20,25
146,170307,Cabanes,-1,2013,57,58
147,080272,"Cabanyes, les",-14,2013,24,38
148,250616,Cabó,5,2013,12,7
149,430363,Cabra del Camp,-41,2013,70,111
150,080288,Cabrera d'Anoia,31,2013,131,100
151,080291,Cabrera de Mar,-2,2013,257,259
152,080305,Cabrils,29,2013,391,362
153,170329,Cadaqués,-89,2013,126,215
154,080312,Calaf,-42,2013,123,165
155,430379,Calafell,-263,2013,1902,2165
156,080348,Calders,-12,2013,41,53
157,080327,Caldes d'Estrac,6,2013,234,228
158,170335,Caldes de Malavella,98,2013,483,385
159,080333,Caldes de Montbui,-32,2013,772,804
160,080351,Calella,-46,2013,1235,1281
161,080370,Calldetenes,-48,2013,115,163
162,080386,Callús,94,2013,198,104
163,080364,Calonge de Segarra,1,2013,8,7
164,170340,Calonge i Sant Antoni,-6,2013,767,773
165,250621,Camarasa,-24,2013,24,48
166,439039,Camarles,-6,2013,80,86
167,430385,Cambrils,32,2013,2222,2190
168,170353,Camós,-8,2013,17,25
169,170366,Campdevànol,-6,2013,84,90
170,170372,Campelles,-3,2013,8,11
171,080399,Campins,-22,2013,48,70
172,170388,Campllong,3,2013,38,35
173,170391,Camprodon,-69,2013,106,175
174,250637,Canejan,2,2013,4,2
175,170405,Canet d'Adri,19,2013,41,22
176,080403,Canet de Mar,67,2013,722,655
177,439076,"Canonja, la",-10,2013,344,354
178,080410,Canovelles,-74,2013,1065,1139
179,080425,Cànoves i Samalús,-10,2013,174,184
180,170412,Cantallops,3,2013,11,8
181,080431,Canyelles,6,2013,285,279
182,430398,Capafonts,-1,2013,3,4
183,430402,Capçanes,1,2013,12,11
184,080446,Capellades,-74,2013,226,300
185,170427,Capmany,12,2013,45,33
186,080459,Capolat,-1,2013,5,6
187,080462,Cardedeu,97,2013,855,758
188,080478,Cardona,-43,2013,107,150
189,080484,Carme,7,2013,36,29
190,430419,Caseres,-4,2013,7,11
191,170448,Cassà de la Selva,16,2013,505,489
192,080497,Casserres,-3,2013,64,67
193,080575,Castell de l'Areny,3,2013,6,3
194,259046,Castell de Mur,-1,2013,10,11
195,250642,Castellar de la Ribera,-5,2013,4,9
196,080522,Castellar de n'Hug,-6,2013,11,17
197,080500,Castellar del Riu,1,2013,7,6
198,080517,Castellar del Vallès,-76,2013,777,853
199,080538,Castellbell i el Vilar,8,2013,223,215
200,080543,Castellbisbal,0,2013,487,487
201,080556,Castellcir,24,2013,87,63
202,250674,Castelldans,-12,2013,51,63
203,080569,Castelldefels,295,2013,4517,4222
204,080581,Castellet i la Gornal,-21,2013,162,183
205,170464,Castellfollit de la Roca,-1,2013,56,57
206,080608,Castellfollit de Riubregós,-1,2013,5,6
207,080594,Castellfollit del Boix,4,2013,16,12
208,080615,Castellgalí,-6,2013,128,134
209,080620,Castellnou de Bages,14,2013,71,57
210,250680,Castellnou de Seana,-22,2013,16,38
211,170470,Castelló d'Empúries,-464,2013,893,1357
212,250693,Castelló de Farfanya,11,2013,32,21
213,080636,Castellolí,14,2013,35,21
214,170486,Castell-Platja d'Aro,-29,2013,959,988
215,250707,Castellserà,5,2013,41,36
216,080641,Castellterçol,8,2013,144,136
217,430424,Castellvell del Camp,32,2013,134,102
218,080654,Castellví de la Marca,-22,2013,62,84
219,080667,Castellví de Rosanes,27,2013,111,84
220,430430,"Catllar, el",65,2013,254,189
221,250714,Cava,-1,2013,2,3
222,171899,"Cellera de Ter, la",13,2013,71,58
223,170499,Celrà,5,2013,324,319
224,080673,Centelles,13,2013,306,293
225,082687,Cercs,-16,2013,42,58
226,082665,Cerdanyola del Vallès,-319,2013,2702,3021
227,080689,Cervelló,75,2013,580,505
228,250729,Cervera,-144,2013,357,501
229,250735,Cervià de les Garrigues,-10,2013,25,35
230,170502,Cervià de Ter,23,2013,56,33
231,170519,Cistella,-5,2013,21,26
232,250740,Ciutadilla,2,2013,12,10
233,250753,Clariana de Cardener,-2,2013,6,8
234,250766,"Cogul, el",-1,2013,8,9
235,170545,Colera,-6,2013,31,37
236,250772,Coll de Nargó,7,2013,20,13
237,080692,Collbató,53,2013,234,181
238,430458,Colldejou,-1,2013,5,6
239,080706,Collsuspina,-3,2013,23,26
240,170558,Colomers,5,2013,13,8
241,251636,"Coma i la Pedra, la",-4,2013,11,15
242,251615,Conca de Dalt,0,2013,19,19
243,430461,Conesa,-2,2013,4,6
244,430477,Constantí,-48,2013,377,425
245,080713,Copons,0,2013,13,13
246,430483,Corbera d'Ebre,-10,2013,50,60
247,080728,Corbera de Llobregat,-66,2013,680,746
248,250788,Corbins,5,2013,64,59
249,170577,Corçà,-12,2013,67,79
250,080734,Cornellà de Llobregat,-291,2013,4451,4742
251,170561,Cornellà del Terri,-25,2013,97,122
252,430496,Cornudella de Montsant,-17,2013,42,59
253,430509,Creixell,25,2013,339,314
254,170583,Crespià,-1,2013,12,13
255,179011,"Cruïlles, Monells i Sant Sadurní de l'Heura",15,2013,78,63
256,080749,Cubelles,44,2013,1053,1009
257,250791,Cubells,-11,2013,8,19
258,430516,Cunit,-289,2013,885,1174
259,170600,Darnius,1,2013,38,37
260,170617,Das,0,2013,15,15
261,439018,Deltebre,-196,2013,421,617
262,080752,Dosrius,-70,2013,308,378
263,430537,Duesaigües,-4,2013,13,17
264,170622,"Escala, l'",-29,2013,495,524
265,080765,Esparreguera,-261,2013,886,1147
266,170638,Espinelves,3,2013,18,15
267,250812,"Espluga Calba, l'",-1,2013,11,12
268,430542,"Espluga de Francolí, l'",-7,2013,127,134
269,080771,Esplugues de Llobregat,-387,2013,2789,3176
270,170643,Espolla,11,2013,20,9
271,170656,Esponellà,10,2013,29,19
272,250827,Espot,2,2013,13,11
273,080787,"Espunyola, l'",-2,2013,8,10
274,082541,"Esquirol, l'",-3,2013,85,88
275,250886,Estamariu,-6,2013,6,12
276,080790,"Estany, l'",-1,2013,12,13
277,250851,Estaràs,19,2013,22,3
278,250864,Esterri d'Àneu,-16,2013,40,56
279,250870,Esterri de Cardós,0,2013,3,3
280,430555,Falset,-37,2013,54,91
281,170059,"Far d'Empordà, el",-3,2013,35,38
282,250899,Farrera,-4,2013,6,10
283,430568,"Fatarella, la",-1,2013,18,19
284,430574,"Febró, la",-6,2013,2,8
285,081347,Figaró-Montmany,19,2013,92,73
286,080804,Fígols,-1,2013,0,1
287,259084,Fígols i Alinyà,-3,2013,8,11
288,430580,"Figuera, la",8,2013,10,2
289,170669,Figueres,93,2013,2807,2714
290,430593,Figuerola del Camp,-7,2013,9,16
291,170675,Flaçà,-10,2013,62,72
292,430607,Flix,-43,2013,138,181
293,250925,"Floresta, la",0,2013,6,6
294,080826,Fogars de la Selva,31,2013,134,103
295,080811,Fogars de Montclús,5,2013,41,36
296,170681,Foixà,6,2013,14,8
297,080832,Folgueroles,8,2013,64,56
298,250931,Fondarella,23,2013,60,37
299,080847,Fonollosa,-20,2013,71,91
300,170694,Fontanals de Cerdanya,-13,2013,41,54
301,170708,Fontanilles,5,2013,13,8
302,170715,Fontcoberta,1,2013,55,54
303,080850,Font-rubí,-48,2013,41,89
304,250946,Foradada,0,2013,16,16
305,179026,Forallac,34,2013,144,110
306,430614,Forès,-3,2013,2,5
307,170736,Fornells de la Selva,12,2013,97,85
308,170741,Fortià,26,2013,52,26
309,080863,"Franqueses del Vallès, les",-76,2013,1218,1294
310,430629,Freginals,-60,2013,9,69
311,250962,"Fuliola, la",13,2013,65,52
312,250978,Fulleda,-4,2013,5,9
313,080902,Gaià,5,2013,10,5
314,430635,"Galera, la",-1,2013,25,26
315,080879,Gallifa,4,2013,11,7
316,430640,Gandesa,-24,2013,97,121
317,430653,Garcia,7,2013,34,27
318,430666,"Garidells, els",-4,2013,6,10
319,080885,"Garriga, la",85,2013,736,651
320,170754,Garrigàs,-4,2013,34,38
321,170767,Garrigoles,3,2013,10,7
322,170773,Garriguella,3,2013,57,54
323,080898,Gavà,-135,2013,2514,2649
324,250984,Gavet de la Conca,7,2013,17,10
325,080919,Gelida,30,2013,394,364
326,170789,Ger,-26,2013,14,40
327,259123,Gimenells i el Pla de la Font,-5,2013,35,40
328,430672,Ginestar,-76,2013,13,89
329,170792,Girona,-480,2013,5947,6427
330,080924,Gironella,-30,2013,134,164
331,080930,Gisclareny,-3,2013,1,4
332,430688,Godall,-9,2013,13,22
333,250997,Golmés,-33,2013,89,122
334,170806,Gombrèn,-3,2013,6,9
335,251001,Gósol,0,2013,9,9
336,080945,"Granada, la",8,2013,108,100
337,251018,"Granadella, la",-3,2013,19,22
338,080958,Granera,6,2013,7,1
339,251023,"Granja d'Escarp, la",-11,2013,27,38
340,080961,Granollers,79,2013,3801,3722
341,251039,Granyanella,3,2013,5,2
342,251057,Granyena de les Garrigues,-7,2013,3,10
343,251044,Granyena de Segarra,6,2013,9,3
344,430691,Gratallops,-14,2013,3,17
345,080977,Gualba,36,2013,109,73
346,170813,Gualta,-1,2013,68,69
347,080996,Guardiola de Berguedà,-26,2013,40,66
348,430705,"Guiamets, els",-1,2013,10,11
349,170828,Guils de Cerdanya,-26,2013,35,61
350,251095,Guimerà,7,2013,23,16
351,259031,"Guingueta d'Àneu, la",-7,2013,18,25
352,251109,Guissona,-16,2013,388,404
353,251116,Guixers,-3,2013,6,9
354,081000,Gurb,-20,2013,70,90
355,430712,Horta de Sant Joan,-24,2013,32,56
356,081017,"Hospitalet de Llobregat, l'",-785,2013,18119,18904
357,081629,"Hostalets de Pierola, els",17,2013,232,215
358,170834,Hostalric,30,2013,292,262
359,081022,Igualada,-73,2013,1826,1899
360,251155,Isona i Conca Dellà,-19,2013,36,55
361,170849,Isòvol,-12,2013,15,27
362,251137,Ivars d'Urgell,7,2013,69,62
363,251121,Ivars de Noguera,-13,2013,7,20
364,251142,Ivorra,-2,2013,4,6
365,170852,Jafre,3,2013,19,16
366,170865,"Jonquera, la",-18,2013,279,297
367,081038,Jorba,-18,2013,28,46
368,259101,Josa i Tuixén,-11,2013,9,20
369,170871,Juià,-11,2013,59,70
370,251180,Juncosa,0,2013,10,10
371,251193,Juneda,3,2013,127,124
372,251214,Les,-3,2013,53,56
373,251229,Linyola,21,2013,111,90
374,081043,"Llacuna, la",-17,2013,31,48
375,170887,Lladó,16,2013,50,34
376,251235,Lladorre,-6,2013,1,7
377,251240,Lladurs,6,2013,18,12
378,081056,"Llagosta, la",-1,2013,688,689
379,170890,Llagostera,-65,2013,448,513
380,170904,Llambilles,5,2013,21,16
381,170911,Llanars,5,2013,32,27
382,170926,Llançà,-50,2013,224,274
383,251253,Llardecans,1,2013,12,11
384,251266,Llavorsí,6,2013,32,26
385,251207,Lleida,-771,2013,5686,6457
386,170932,Llers,23,2013,97,74
387,251272,Lles de Cerdanya,-4,2013,13,17
388,081075,Lliçà d'Amunt,-29,2013,742,771
389,081081,Lliçà de Vall,-65,2013,282,347
390,251288,Llimiana,-3,2013,7,10
391,081069,Llinars del Vallès,62,2013,612,550
392,170947,Llívia,-46,2013,81,127
393,430727,"Lloar, el",-3,2013,3,6
394,251291,Llobera,-5,2013,3,8
395,430733,Llorac,-4,2013,12,16
396,430748,Llorenç del Penedès,19,2013,147,128
397,170950,Lloret de Mar,-313,2013,2262,2575
398,170963,"Llosses, les",-5,2013,12,17
399,081094,Lluçà,15,2013,28,13
400,171024,Maçanet de Cabrenys,37,2013,62,25
401,171030,Maçanet de la Selva,-148,2013,405,553
402,170979,Madremanya,3,2013,16,13
403,170985,Maià de Montcal,-10,2013,32,42
404,251333,Maials,4,2013,34,30
405,251305,Maldà,-2,2013,7,9
406,081108,Malgrat de Mar,37,2013,1031,994
407,081115,Malla,3,2013,11,8
408,081120,Manlleu,-149,2013,734,883
409,081136,Manresa,-535,2013,2884,3419
410,430764,Marçà,10,2013,48,38
411,430751,Margalef,1,2013,12,11
412,082423,Marganell,-14,2013,16,30
413,081141,Martorell,-125,2013,1428,1553
414,081154,Martorelles,-59,2013,265,324
415,430770,Mas de Barberans,-17,2013,10,27
416,171002,Masarac,-9,2013,19,28
417,430786,Masdenverge,-29,2013,55,84
418,081167,"Masies de Roda, les",-1,2013,33,34
419,081173,"Masies de Voltregà, les",22,2013,125,103
420,430799,Masllorenç,-9,2013,35,44
421,081189,"Masnou, el",61,2013,1198,1137
422,430803,"Masó, la",0,2013,9,9
423,430810,Maspujols,9,2013,41,32
424,081192,Masquefa,-22,2013,484,506
425,430825,"Masroig, el",2,2013,23,21
426,251312,Massalcoreig,7,2013,38,31
427,171019,Massanes,-2,2013,70,72
428,251327,Massoteres,-2,2013,5,7
429,081206,Matadepera,19,2013,438,419
430,081213,Mataró,-41,2013,5000,5041
431,081228,Mediona,-33,2013,118,151
432,251348,Menàrguens,10,2013,54,44
433,170998,Meranges,-2,2013,8,10
434,171058,Mieres,-7,2013,11,18
435,430831,"Milà, el",4,2013,7,3
436,251351,Miralcamp,-21,2013,38,59
437,430846,Miravet,-8,2013,28,36
438,081385,Moià,-16,2013,285,301
439,430859,"Molar, el",-4,2013,7,11
440,081234,Molins de Rei,91,2013,992,901
441,251370,Mollerussa,-42,2013,728,770
442,171061,Mollet de Peralada,10,2013,24,14
443,081249,Mollet del Vallès,-416,2013,2349,2765
444,171077,Molló,-14,2013,16,30
445,251364,"Molsosa, la",-2,2013,1,3
446,081287,Monistrol de Calders,11,2013,28,17
447,081271,Monistrol de Montserrat,-40,2013,180,220
448,171096,Montagut i Oix,12,2013,69,57
449,430862,Montblanc,-23,2013,254,277
450,430884,Montbrió del Camp,-15,2013,211,226
451,081252,Montcada i Reixac,-351,2013,1916,2267
452,081304,Montclar,-1,2013,2,3
453,251399,Montellà i Martinet,-29,2013,27,56
454,081311,Montesquiu,-14,2013,34,48
455,251403,Montferrer i Castellbò,4,2013,79,75
456,430897,Montferri,-2,2013,33,35
457,251386,Montgai,-14,2013,17,31
458,081265,Montgat,160,2013,705,545
459,081326,Montmajor,12,2013,21,9
460,081332,Montmaneu,-3,2013,1,4
461,430901,"Montmell, el",-48,2013,110,158
462,081350,Montmeló,-5,2013,381,386
463,251425,Montoliu de Lleida,11,2013,28,17
464,251410,Montoliu de Segarra,-2,2013,2,4
465,251431,Montornès de Segarra,-1,2013,6,7
466,081363,Montornès del Vallès,-48,2013,777,825
467,430918,Mont-ral,-4,2013,6,10
468,171100,Mont-ras,-37,2013,56,93
469,430923,Mont-roig del Camp,-15,2013,987,1002
470,081379,Montseny,12,2013,35,23
471,430939,Móra d'Ebre,-20,2013,255,275
472,430944,Móra la Nova,13,2013,154,141
473,430957,"Morell, el",17,2013,247,230
474,430960,"Morera de Montsant, la",0,2013,8,8
475,081290,Muntanyola,8,2013,34,26
476,081398,Mura,4,2013,13,9
477,251459,Nalec,-8,2013,1,9
478,250254,Naut Aran,0,2013,82,82
479,081402,Navarcles,50,2013,252,202
480,081419,Navàs,-27,2013,231,258
481,171117,Navata,4,2013,94,90
482,251462,Navès,9,2013,13,4
483,081424,"Nou de Berguedà, la",2,2013,5,3
484,430976,"Nou de Gaià, la",-11,2013,26,37
485,430982,Nulles,1,2013,32,31
486,251484,Odèn,0,2013,10,10
487,081430,Òdena,-5,2013,212,217
488,171122,Ogassa,-5,2013,7,12
489,081458,Olèrdola,-37,2013,196,233
490,081461,Olesa de Bonesvalls,-1,2013,94,95
491,081477,Olesa de Montserrat,-212,2013,996,1208
492,251497,Oliana,5,2013,75,70
493,251500,Oliola,8,2013,11,3
494,251517,Olius,-7,2013,39,46
495,081483,Olivella,-19,2013,283,302
496,081496,Olost,11,2013,43,32
497,171143,Olot,151,2013,1359,1208
498,251522,"Oluges, les",-1,2013,3,4
499,081445,Olvan,-10,2013,40,50
500,251538,"Omellons, els",0,2013,6,6
501,251543,"Omells de na Gaia, els",-1,2013,2,3
502,171156,Ordis,0,2013,8,8
503,251556,Organyà,-14,2013,20,34
504,081509,Orís,19,2013,23,4
505,081516,Oristà,3,2013,15,12
506,081521,Orpí,-6,2013,6,12
507,081537,Òrrius,26,2013,55,29
508,251569,Os de Balaguer,-4,2013,59,63
509,171169,Osor,1,2013,30,29
510,251575,Ossó de Sió,-5,2013,3,8
511,081542,Pacs del Penedès,8,2013,52,44
512,081555,Palafolls,-31,2013,542,573
513,171175,Palafrugell,-41,2013,943,984
514,171181,Palamós,12,2013,1014,1002
515,251581,"Palau d'Anglesola, el",-44,2013,70,114
516,171194,Palau de Santa Eulàlia,-4,2013,9,13
517,171215,Palau-sator,5,2013,20,15
518,171208,Palau-saverdera,15,2013,131,116
519,081568,Palau-solità i Plegamans,14,2013,649,635
520,431009,"Pallaresos, els",-2,2013,165,167
521,081574,Pallejà,3,2013,501,498
522,430995,"Palma d'Ebre, la",-1,2013,7,8
523,089058,"Palma de Cervelló, la",-8,2013,144,152
524,171236,Palol de Revardit,0,2013,18,18
525,171241,Pals,0,2013,138,138
526,081580,"Papiol, el",-16,2013,197,213
527,171254,Pardines,0,2013,3,3
528,081593,Parets del Vallès,49,2013,885,836
529,171267,Parlavà,10,2013,26,16
530,431016,Passanant i Belltall,8,2013,16,8
531,171289,Pau,-14,2013,37,51
532,431021,Paüls,-2,2013,12,14
533,171292,Pedret i Marzà,-5,2013,12,17
534,251641,Penelles,2,2013,23,21
535,171306,"Pera, la",28,2013,44,16
536,081607,Perafita,-9,2013,13,22
537,431037,Perafort,9,2013,66,57
538,171328,Peralada,-14,2013,104,118
539,251654,Peramola,-5,2013,8,13
540,431042,"Perelló, el",-7,2013,121,128
541,081614,Piera,-95,2013,743,838
542,431055,"Piles, les",3,2013,21,18
543,081635,Pineda de Mar,-160,2013,1576,1736
544,431068,"Pinell de Brai, el",-14,2013,15,29
545,251667,Pinell de Solsonès,-4,2013,2,6
546,251673,Pinós,10,2013,23,13
547,431074,Pira,-6,2013,12,18
548,431080,"Pla de Santa Maria, el",6,2013,105,99
549,081640,"Pla del Penedès, el",33,2013,98,65
550,171334,"Planes d'Hostoles, les",1,2013,66,65
551,171349,Planoles,0,2013,23,23
552,259118,"Plans de Sió, els",2,2013,25,23
553,251689,"Poal, el",10,2013,33,23
554,251692,"Pobla de Cérvoles, la",-12,2013,13,25
555,081653,"Pobla de Claramunt, la",-31,2013,124,155
556,081666,"Pobla de Lillet, la",-20,2013,23,43
557,431093,"Pobla de Mafumet, la",168,2013,436,268
558,431107,"Pobla de Massaluca, la",-11,2013,4,15
559,431114,"Pobla de Montornès, la",-26,2013,196,222
560,251713,"Pobla de Segur, la",-41,2013,126,167
561,431129,Poboleda,-1,2013,12,13
562,081672,Polinyà,12,2013,383,371
563,431135,"Pont d'Armentera, el",-16,2013,13,29
564,250306,"Pont de Bar, el",-8,2013,6,14
565,171352,Pont de Molins,-3,2013,49,52
566,251734,"Pont de Suert, el",-31,2013,95,126
567,081825,"Pont de Vilomara i Rocafort, el",13,2013,182,169
568,431418,Pontils,2,2013,11,9
569,081688,Pontons,-25,2013,52,77
570,171365,Pontós,9,2013,24,15
571,251728,Ponts,15,2013,120,105
572,171371,Porqueres,11,2013,200,189
573,431140,Porrera,-5,2013,16,21
574,171404,"Port de la Selva, el",-2,2013,48,50
575,171387,Portbou,-64,2013,69,133
576,251749,"Portella, la",-16,2013,47,63
577,431153,Pradell de la Teixeta,-10,2013,0,10
578,431166,Prades,-28,2013,24,52
579,431172,Prat de Comte,-1,2013,8,9
580,081691,"Prat de Llobregat, el",-461,2013,2043,2504
581,431188,Pratdip,-6,2013,51,57
582,081712,Prats de Lluçanès,-38,2013,65,103
583,081705,"Prats de Rei, els",-15,2013,16,31
584,251752,Prats i Sansor,-25,2013,7,32
585,251765,Preixana,4,2013,17,13
586,251771,Preixens,-5,2013,17,22
587,082303,Premià de Dalt,46,2013,599,553
588,081727,Premià de Mar,115,2013,1565,1450
589,171390,"Preses, les",-7,2013,86,93
590,251790,Prullans,-6,2013,9,15
591,171411,Puigcerdà,18,2013,504,486
592,081748,Puigdàlber,-6,2013,13,19
593,251804,Puiggròs,-1,2013,14,15
594,431191,Puigpelat,4,2013,68,64
595,081751,Puig-reig,-15,2013,167,182
596,251811,Puigverd d'Agramunt,-2,2013,7,9
597,251826,Puigverd de Lleida,-18,2013,49,67
598,081764,Pujalt,5,2013,9,4
599,081770,"Quar, la",-4,2013,3,7
600,171426,Quart,43,2013,205,162
601,170433,Queralbs,-3,2013,3,6
602,431205,Querol,2,2013,53,51
603,171432,Rabós,2,2013,14,12
604,081786,Rajadell,-11,2013,27,38
605,431212,Rasquera,-6,2013,17,23
606,171447,Regencós,4,2013,18,14
607,081799,Rellinars,-24,2013,35,59
608,431227,Renau,3,2013,8,5
609,431233,Reus,-1354,2013,3519,4873
610,251832,Rialp,-11,2013,45,56
611,431248,"Riba, la",-13,2013,30,43
612,431251,Riba-roja d'Ebre,-37,2013,34,71
613,259059,Ribera d'Ondara,6,2013,18,12
614,251850,Ribera d'Urgellet,-3,2013,70,73
615,171450,Ribes de Freser,-8,2013,72,80
616,171463,Riells i Viabrea,41,2013,296,255
617,431264,"Riera de Gaià, la",30,2013,127,97
618,251863,Riner,-3,2013,10,13
619,171479,Ripoll,-19,2013,320,339
620,081803,Ripollet,-92,2013,1933,2025
621,259139,Riu de Cerdanya,-7,2013,4,11
622,171485,Riudarenes,-17,2013,145,162
623,171498,Riudaura,12,2013,28,16
624,431270,Riudecanyes,2,2013,66,64
625,431286,Riudecols,-25,2013,56,81
626,171501,Riudellots de la Selva,-26,2013,99,125
627,431299,Riudoms,61,2013,325,264
628,171518,Riumors,2,2013,30,28
629,081810,"Roca del Vallès, la",65,2013,538,473
630,431303,Rocafort de Queralt,-7,2013,8,15
631,431310,Roda de Berà,-23,2013,444,467
632,081831,Roda de Ter,-12,2013,226,238
633,431325,Rodonyà,19,2013,43,24
634,431331,Roquetes,-18,2013,417,435
635,171523,Roses,-282,2013,1081,1363
636,251898,Rosselló,-61,2013,174,235
637,431346,"Rourell, el",0,2013,20,20
638,081846,Rubí,-293,2013,3006,3299
639,081859,Rubió,13,2013,24,11
640,171539,Rupià,4,2013,20,16
641,089019,Rupit i Pruit,4,2013,20,16
642,081878,Sabadell,-140,2013,8308,8448
643,081884,Sagàs,-3,2013,6,9
644,251902,Salàs de Pallars,-5,2013,13,18
645,081901,Saldes,-14,2013,11,25
646,171544,Sales de Llierca,0,2013,8,8
647,081918,Sallent,0,2013,204,204
648,431359,Salomó,23,2013,34,11
649,439057,Salou,-203,2013,2434,2637
650,171557,Salt,-478,2013,2089,2567
651,251919,Sanaüja,-8,2013,15,23
652,081944,Sant Adrià de Besòs,264,2013,2644,2380
653,081957,Sant Agustí de Lluçanès,-2,2013,2,4
654,081960,Sant Andreu de la Barca,-204,2013,1270,1474
655,081976,Sant Andreu de Llavaneres,22,2013,734,712
656,171576,Sant Andreu Salou,3,2013,11,8
657,171833,Sant Aniol de Finestres,-6,2013,15,21
658,081982,Sant Antoni de Vilamajor,20,2013,395,375
659,081995,Sant Bartomeu del Grau,-12,2013,47,59
660,082009,Sant Boi de Llobregat,-223,2013,3447,3670
661,082016,Sant Boi de Lluçanès,26,2013,50,24
662,431362,Sant Carles de la Ràpita,37,2013,794,757
663,082037,Sant Cebrià de Vallalta,-57,2013,189,246
664,082021,Sant Celoni,-91,2013,815,906
665,082042,Sant Climent de Llobregat,2,2013,146,144
666,171582,Sant Climent Sescebes,17,2013,80,63
667,082055,Sant Cugat del Vallès,598,2013,4914,4316
668,082068,Sant Cugat Sesgarrigues,-4,2013,46,50
669,251961,Sant Esteve de la Sarga,-1,2013,5,6
670,082074,Sant Esteve de Palautordera,-13,2013,153,166
671,082080,Sant Esteve Sesrovires,-9,2013,383,392
672,171595,Sant Feliu de Buixalleu,-7,2013,34,41
673,082107,Sant Feliu de Codines,-105,2013,351,456
674,171609,Sant Feliu de Guíxols,-105,2013,1356,1461
675,082114,Sant Feliu de Llobregat,-7,2013,1674,1681
676,171616,Sant Feliu de Pallerols,13,2013,64,51
677,082129,Sant Feliu Sasserra,-14,2013,14,28
678,171621,Sant Ferriol,9,2013,39,30
679,082093,Sant Fost de Campsentelles,137,2013,575,438
680,082135,Sant Fruitós de Bages,-46,2013,349,395
681,171637,Sant Gregori,-7,2013,168,175
682,251924,Sant Guim de Freixenet,1,2013,54,53
683,251977,Sant Guim de la Plana,-5,2013,7,12
684,171642,Sant Hilari Sacalm,-24,2013,195,219
685,082153,Sant Hipòlit de Voltregà,-68,2013,145,213
686,081939,Sant Iscle de Vallalta,-14,2013,69,83
687,439023,Sant Jaume d'Enveja,-5,2013,150,155
688,082166,Sant Jaume de Frontanyà,-1,2013,0,1
689,171655,Sant Jaume de Llierca,16,2013,78,62
690,431378,Sant Jaume dels Domenys,-66,2013,146,212
691,171674,Sant Joan de les Abadesses,2,2013,95,93
692,171680,Sant Joan de Mollet,-1,2013,34,35
693,082188,Sant Joan de Vilatorrada,-52,2013,423,475
694,082172,Sant Joan Despí,125,2013,1583,1458
695,171851,Sant Joan les Fonts,26,2013,158,132
696,171668,Sant Jordi Desvalls,13,2013,49,36
697,089030,Sant Julià de Cerdanyola,-4,2013,12,16
698,171693,Sant Julià de Ramis,-69,2013,194,263
699,082205,Sant Julià de Vilatorta,36,2013,120,84
700,179032,Sant Julià del Llor i Bonmatí,-5,2013,77,82
701,082212,Sant Just Desvern,108,2013,1015,907
702,082227,Sant Llorenç d'Hortons,-11,2013,116,127
703,171714,Sant Llorenç de la Muga,-8,2013,12,20
704,251930,Sant Llorenç de Morunys,-2,2013,43,45
705,082233,Sant Llorenç Savall,-18,2013,108,126
706,082251,Sant Martí d'Albars,1,2013,4,3
707,082248,Sant Martí de Centelles,-9,2013,85,94
708,171729,Sant Martí de Llémena,12,2013,46,34
709,259025,Sant Martí de Riucorb,8,2013,28,20
710,082264,Sant Martí de Tous,-9,2013,43,52
711,082270,Sant Martí Sarroca,-27,2013,171,198
712,082286,Sant Martí Sesgueioles,16,2013,30,14
713,171735,Sant Martí Vell,3,2013,20,17
714,082299,Sant Mateu de Bages,13,2013,27,14
715,171740,Sant Miquel de Campmajor,12,2013,15,3
716,171753,Sant Miquel de Fluvià,20,2013,82,62
717,171766,Sant Mori,-11,2013,12,23
718,171772,Sant Pau de Segúries,-1,2013,50,51
719,082310,Sant Pere de Ribes,123,2013,1690,1567
720,082325,Sant Pere de Riudebitlles,13,2013,114,101
721,082331,Sant Pere de Torelló,3,2013,101,98
722,082346,Sant Pere de Vilamajor,-42,2013,232,274
723,171788,Sant Pere Pescador,-34,2013,146,180
724,081897,Sant Pere Sallavinera,-2,2013,4,6
725,082359,Sant Pol de Mar,2,2013,274,272
726,082362,Sant Quintí de Mediona,-70,2013,82,152
727,082378,Sant Quirze de Besora,-4,2013,69,73
728,082384,Sant Quirze del Vallès,72,2013,843,771
729,082397,Sant Quirze Safaja,-13,2013,49,62
730,251945,Sant Ramon,-23,2013,13,36
731,082401,Sant Sadurní d'Anoia,-46,2013,433,479
732,082418,Sant Sadurní d'Osormort,-4,2013,2,6
733,080983,Sant Salvador de Guardiola,5,2013,207,202
734,082628,Sant Vicenç de Castellet,-69,2013,518,587
735,082649,Sant Vicenç de Montalt,88,2013,465,377
736,082652,Sant Vicenç de Torelló,-34,2013,68,102
737,082634,Sant Vicenç dels Horts,-119,2013,1260,1379
738,431384,Santa Bàrbara,-49,2013,141,190
739,082439,Santa Cecília de Voltregà,-3,2013,6,9
740,082444,Santa Coloma de Cervelló,-15,2013,339,354
741,171805,Santa Coloma de Farners,-16,2013,545,561
742,082457,Santa Coloma de Gramenet,-1214,2013,7774,8988
743,431397,Santa Coloma de Queralt,-9,2013,104,113
744,171812,Santa Cristina d'Aro,80,2013,383,303
745,082460,Santa Eugènia de Berga,-6,2013,120,126
746,082476,Santa Eulàlia de Riuprimer,37,2013,90,53
747,082482,Santa Eulàlia de Ronçana,55,2013,404,349
748,082495,Santa Fe del Penedès,3,2013,24,21
749,171827,Santa Llogaia d'Àlguema,-3,2013,19,22
750,082508,Santa Margarida de Montbui,-38,2013,471,509
751,082515,Santa Margarida i els Monjos,-10,2013,447,457
752,082589,Santa Maria d'Oló,11,2013,36,25
753,082536,Santa Maria de Besora,-1,2013,11,12
754,082567,Santa Maria de Martorelles,14,2013,72,58
755,082554,Santa Maria de Merlès,1,2013,18,17
756,082573,Santa Maria de Miralles,5,2013,11,6
757,082592,Santa Maria de Palautordera,-39,2013,504,543
758,431401,Santa Oliva,-15,2013,233,248
759,171848,Santa Pau,-13,2013,48,61
760,082606,Santa Perpètua de Mogoda,-148,2013,1279,1427
761,082613,Santa Susanna,-27,2013,244,271
762,081923,Santpedor,25,2013,309,284
763,431423,Sarral,-47,2013,45,92
764,171864,Sarrià de Ter,51,2013,324,273
765,252017,Sarroca de Bellera,-2,2013,7,9
766,252000,Sarroca de Lleida,7,2013,13,6
767,171870,"Saus, Camallera i Llampaies",10,2013,66,56
768,431439,Savallà del Comtat,2,2013,6,4
769,431444,"Secuita, la",21,2013,115,94
770,171886,"Selva de Mar, la",-3,2013,11,14
771,431457,"Selva del Camp, la",-10,2013,198,208
772,431460,Senan,-2,2013,4,6
773,430445,"Sénia, la",-62,2013,213,275
774,252022,Senterada,-9,2013,7,16
775,250352,"Sentiu de Sió, la",-8,2013,17,25
776,082671,Sentmenat,-62,2013,384,446
777,171903,Serinyà,3,2013,61,58
778,252043,Seròs,-25,2013,78,103
779,171910,Serra de Daró,7,2013,20,13
780,171925,Setcases,7,2013,9,2
781,252038,"Seu d'Urgell, la",-77,2013,651,728
782,082690,Seva,13,2013,183,170
783,252056,Sidamon,-11,2013,21,32
784,171931,Sils,157,2013,511,354
785,082704,Sitges,144,2013,2091,1947
786,170524,Siurana,-16,2013,6,22
787,082711,Sobremunt,-7,2013,6,13
788,252069,"Soleràs, el",0,2013,7,7
789,431476,Solivella,-2,2013,21,23
790,252075,Solsona,-77,2013,460,537
791,082726,Sora,-2,2013,13,15
792,252081,Soriguera,10,2013,32,22
793,252094,Sort,-40,2013,126,166
794,252108,Soses,-4,2013,65,69
795,082732,Subirats,-5,2013,147,152
796,252115,Sudanell,-16,2013,28,44
797,252120,Sunyer,7,2013,27,20
798,082747,Súria,-52,2013,125,177
799,171946,Susqueda,-4,2013,0,4
800,082763,Tagamanent,-2,2013,24,26
801,082779,Talamanca,-5,2013,6,11
802,252154,Talarn,-17,2013,57,74
803,252167,Talavera,-9,2013,5,14
804,171959,"Tallada d'Empordà, la",3,2013,30,27
805,082785,Taradell,-13,2013,227,240
806,431482,Tarragona,23,2013,5855,5832
807,252173,Tàrrega,-112,2013,795,907
808,252189,Tarrés,-4,2013,4,8
809,252192,Tarroja de Segarra,3,2013,4,1
810,082750,Tavèrnoles,1,2013,14,13
811,082802,Tavertet,0,2013,7,7
812,082819,Teià,23,2013,351,328
813,252206,Térmens,10,2013,79,69
814,171962,Terrades,2,2013,38,36
815,082798,Terrassa,-491,2013,8070,8561
816,082824,Tiana,91,2013,443,352
817,252213,Tírvia,-6,2013,8,14
818,252228,Tiurana,-1,2013,0,1
819,431495,Tivenys,-4,2013,25,29
820,431508,Tivissa,21,2013,76,55
821,082830,Tona,-82,2013,328,410
822,252234,Torà,-37,2013,37,74
823,082845,Tordera,-10,2013,1111,1121
824,082858,Torelló,-11,2013,501,512
825,252249,"Torms, els",0,2013,0,0
826,252252,Tornabous,-26,2013,27,53
827,252271,"Torre de Cabdella, la",14,2013,45,31
828,082861,"Torre de Claramunt, la",-11,2013,202,213
829,431515,"Torre de Fontaubella, la",-1,2013,12,13
830,431520,"Torre de l'Espanyol, la",-8,2013,26,34
831,252265,Torrebesses,-6,2013,7,13
832,431536,Torredembarra,106,2013,1075,969
833,252287,Torrefarrera,80,2013,334,254
834,259078,Torrefeta i Florejacs,-5,2013,18,23
835,252304,Torregrossa,9,2013,72,63
836,252311,Torrelameu,-8,2013,34,42
837,082877,Torrelavit,-7,2013,66,73
838,082883,Torrelles de Foix,-24,2013,202,226
839,082896,Torrelles de Llobregat,55,2013,335,280
840,171978,Torrent,-11,2013,4,15
841,252326,Torres de Segre,63,2013,241,178
842,252332,Torre-serona,18,2013,30,12
843,171984,Torroella de Fluvià,-13,2013,63,76
844,171997,Torroella de Montgrí,-90,2013,659,749
845,431541,Torroja del Priorat,-8,2013,3,11
846,172001,Tortellà,8,2013,28,20
847,431554,Tortosa,-60,2013,1385,1445
848,172018,Toses,3,2013,14,11
849,172023,Tossa de Mar,-9,2013,251,260
850,252347,Tremp,-143,2013,396,539
851,172044,Ullà,0,2013,127,127
852,082900,Ullastrell,9,2013,92,83
853,172057,Ullastret,3,2013,20,17
854,431567,Ulldecona,-88,2013,218,306
855,431573,Ulldemolins,-10,2013,12,22
856,172039,Ultramort,0,2013,14,14
857,172060,Urús,6,2013,21,15
858,082917,Vacarisses,-48,2013,344,392
859,170144,"Vajol, la",-9,2013,5,14
860,172076,"Vall d'en Bas, la",-12,2013,107,119
861,172082,"Vall de Bianya, la",3,2013,87,84
862,250432,"Vall de Boí, la",-33,2013,45,78
863,259010,Vall de Cardós,-6,2013,13,19
864,082922,Vallbona d'Anoia,-3,2013,48,51
865,252385,Vallbona de les Monges,2,2013,6,4
866,082938,Vallcebre,-5,2013,17,22
867,431589,Vallclara,2,2013,10,8
868,252402,Vallfogona de Balaguer,9,2013,93,84
869,171707,Vallfogona de Ripollès,-6,2013,4,10
870,431592,Vallfogona de Riucorb,-12,2013,4,16
871,082943,Vallgorguina,-57,2013,158,215
872,082956,Vallirana,10,2013,807,797
873,172095,Vall-llobrega,-3,2013,47,50
874,431606,Vallmoll,2,2013,137,135
875,082969,Vallromanes,-16,2013,151,167
876,431613,Valls,36,2013,1041,1005
877,259062,"Valls d'Aguilar, les",-13,2013,6,19
878,252398,"Valls de Valira, les",-30,2013,72,102
879,431628,Vandellòs i l'Hospitalet de l'Infant,61,2013,464,403
880,259097,"Vansa i Fórnols, la",12,2013,21,9
881,082975,Veciana,-2,2013,3,5
882,431634,"Vendrell, el",-143,2013,2376,2519
883,172109,Ventalló,10,2013,78,68
884,252424,Verdú,-25,2013,39,64
885,172116,Verges,-12,2013,47,59
886,431649,Vespella de Gaià,7,2013,36,29
887,082981,Vic,270,2013,2363,2093
888,172121,Vidrà,5,2013,12,7
889,172137,Vidreres,38,2013,539,501
890,252430,Vielha e Mijaran,-66,2013,404,470
891,431652,Vilabella,-4,2013,18,22
892,172142,Vilabertran,7,2013,57,50
893,172155,Vilablareix,20,2013,113,93
894,082994,Vilada,-4,2013,10,14
895,172174,Viladamat,-16,2013,15,31
896,172168,Viladasens,-4,2013,11,15
897,083015,Viladecans,-288,2013,2578,2866
898,083008,Viladecavalls,-9,2013,333,342
899,172180,Vilademuls,1,2013,60,59
900,172207,Viladrau,-15,2013,25,40
901,172214,Vilafant,-16,2013,275,291
902,083054,Vilafranca del Penedès,294,2013,2040,1746
903,252445,Vilagrassa,2,2013,37,35
904,172235,Vilajuïga,-4,2013,97,101
905,431750,Vilalba dels Arcs,-9,2013,7,16
906,083067,Vilalba Sasserra,17,2013,69,52
907,252458,Vilaller,-23,2013,23,46
908,172240,Vilallonga de Ter,-14,2013,13,27
909,431665,Vilallonga del Camp,-25,2013,158,183
910,172253,Vilamacolum,5,2013,26,21
911,172266,Vilamalla,5,2013,66,61
912,172272,Vilamaniscle,8,2013,17,9
913,252477,Vilamòs,-7,2013,9,16
914,172288,Vilanant,13,2013,34,21
915,431671,Vilanova d'Escornalbou,-21,2013,24,45
916,252483,Vilanova de Bellpuig,25,2013,63,38
917,252496,Vilanova de l'Aguda,-6,2013,2,8
918,252542,Vilanova de la Barca,-21,2013,52,73
919,252509,Vilanova de Meià,10,2013,16,6
920,431687,Vilanova de Prades,-5,2013,4,9
921,083036,Vilanova de Sau,-17,2013,13,30
922,252516,Vilanova de Segrià,30,2013,86,56
923,083020,Vilanova del Camí,-74,2013,548,622
924,089024,Vilanova del Vallès,82,2013,364,282
925,083073,Vilanova i la Geltrú,-218,2013,2901,3119
926,431690,Vilaplana,4,2013,20,16
927,431704,Vila-rodona,5,2013,64,59
928,172305,Vila-sacra,17,2013,67,50
929,252521,Vila-sana,-12,2013,33,45
930,431711,Vila-seca,134,2013,1442,1308
931,082140,Vilassar de Dalt,-2,2013,421,423
932,082191,Vilassar de Mar,114,2013,1095,981
933,172229,Vilaür,4,2013,12,8
934,431726,Vilaverd,-15,2013,26,41
935,431732,"Vilella Alta, la",-2,2013,2,4
936,431747,"Vilella Baixa, la",-9,2013,4,13
937,172333,Vilobí d'Onyar,13,2013,160,147
938,083041,Vilobí del Penedès,-17,2013,44,61
939,172327,Vilopriu,8,2013,18,10
940,252537,"Vilosell, el",0,2013,12,12
941,431763,Vimbodí i Poblet,1,2013,37,36
942,252555,Vinaixa,-9,2013,21,30
943,431779,Vinebre,-22,2013,14,36
944,431785,Vinyols i els Arcs,-90,2013,145,235
945,083089,Viver i Serrateix,-3,2013,4,7
946,430521,Xerta,-11,2013,36,47
0,250019,Abella de la Conca,1,2014,5,4
1,080018,Abrera,-98,2014,616,714
2,250024,Àger,18,2014,41,23
3,250030,Agramunt,-10,2014,175,185
4,080023,Aguilar de Segarra,-4,2014,7,11
5,170010,Agullana,18,2014,53,35
6,080142,Aiguafreda,-16,2014,161,177
7,430017,Aiguamúrcia,0,2014,49,49
8,170025,Aiguaviva,-17,2014,24,41
9,250387,Aitona,66,2014,200,134
10,250045,"Alamús, els",12,2014,40,28
11,250058,Alàs i Cerc,3,2014,18,15
12,250061,"Albagés, l'",-3,2014,12,15
13,170031,Albanyà,-5,2014,15,20
14,250077,Albatàrrec,67,2014,185,118
15,250083,Albesa,12,2014,66,54
16,250096,"Albi, l'",-12,2014,15,27
17,430022,Albinyana,-15,2014,140,155
18,430038,"Albiol, l'",-9,2014,18,27
19,170046,Albons,3,2014,74,71
20,430043,Alcanar,-298,2014,464,762
21,250100,Alcanó,5,2014,14,9
22,250117,Alcarràs,115,2014,688,573
23,250122,Alcoletge,-11,2014,225,236
24,430056,Alcover,-32,2014,206,238
25,439044,"Aldea, l'",-120,2014,188,308
26,430069,Aldover,-5,2014,25,30
27,430075,"Aleixar, l'",-4,2014,38,42
28,080039,Alella,11,2014,589,578
29,430081,Alfara de Carles,-10,2014,9,19
30,250138,Alfarràs,-17,2014,104,121
31,250143,Alfés,9,2014,18,9
32,430094,Alforja,40,2014,135,95
33,250156,Algerri,2,2014,23,21
34,250169,Alguaire,-62,2014,131,193
35,250175,Alins,1,2014,9,8
36,430108,Alió,-14,2014,10,24
37,250194,Almacelles,85,2014,290,205
38,250208,Almatret,2,2014,12,10
39,250215,Almenar,-27,2014,155,182
40,430115,Almoster,-4,2014,42,46
41,250220,Alòs de Balaguer,0,2014,9,9
42,170062,Alp,-51,2014,92,143
43,080044,Alpens,-8,2014,3,11
44,250236,Alpicat,-5,2014,229,234
45,250241,Alt Àneu,-6,2014,20,26
46,430120,Altafulla,35,2014,307,272
47,170078,Amer,-21,2014,86,107
48,430136,"Ametlla de Mar, l'",46,2014,286,240
49,080057,"Ametlla del Vallès, l'",30,2014,434,404
50,439060,"Ampolla, l'",31,2014,221,190
51,430141,Amposta,-101,2014,911,1012
52,170084,Anglès,-63,2014,247,310
53,250273,Anglesola,23,2014,61,38
54,250292,Arbeca,-84,2014,66,150
55,430167,"Arboç, l'",1,2014,317,316
56,430154,Arbolí,17,2014,20,3
57,170097,Arbúcies,-175,2014,273,448
58,080060,Arenys de Mar,28,2014,824,796
59,080076,Arenys de Munt,70,2014,468,398
60,170101,Argelaguer,-13,2014,11,24
61,080082,Argençola,8,2014,12,4
62,430173,"Argentera, l'",-1,2014,8,9
63,080095,Argentona,26,2014,600,574
64,170118,"Armentera, l'",2,2014,62,60
65,430189,Arnes,7,2014,26,19
66,250313,Arres,-6,2014,8,14
67,250328,Arsèguel,1,2014,7,6
68,080109,Artés,-6,2014,251,257
69,250334,Artesa de Lleida,20,2014,66,46
70,250349,Artesa de Segre,0,2014,159,159
71,430192,Ascó,45,2014,88,43
72,250365,Aspa,6,2014,9,3
73,250371,"Avellanes i Santa Linya, les",-6,2014,27,33
74,080116,Avià,-27,2014,83,110
75,080121,Avinyó,-12,2014,77,89
76,170123,Avinyonet de Puigventós,-5,2014,70,75
77,080137,Avinyonet del Penedès,-18,2014,92,110
78,080155,Badalona,-1334,2014,10678,12012
79,089045,Badia del Vallès,-79,2014,536,615
80,080168,Bagà,-13,2014,74,87
81,250390,Baix Pallars,-5,2014,18,23
82,250404,Balaguer,13,2014,817,804
83,080174,Balenyà,-5,2014,169,174
84,080180,Balsareny,3,2014,104,101
85,430206,Banyeres del Penedès,32,2014,193,161
86,170157,Banyoles,-9,2014,910,919
87,250411,Barbens,29,2014,79,50
88,430213,Barberà de la Conca,-8,2014,26,34
89,082520,Barberà del Vallès,-62,2014,1470,1532
90,080193,Barcelona,6614,2014,90123,83509
91,250426,"Baronia de Rialb, la",14,2014,17,3
92,170160,Bàscara,-1,2014,57,58
93,250447,Bassella,-9,2014,15,24
94,430228,Batea,-33,2014,62,95
95,250450,Bausen,2,2014,2,0
96,080207,Begues,25,2014,392,367
97,170139,Begur,-90,2014,198,288
98,250463,Belianes,11,2014,18,7
99,251706,Bellaguarda,5,2014,8,3
100,170182,Bellcaire d'Empordà,2,2014,35,33
101,250479,Bellcaire d'Urgell,-4,2014,48,52
102,250485,Bell-lloc d'Urgell,-26,2014,68,94
103,250498,Bellmunt d'Urgell,-6,2014,1,7
104,430234,Bellmunt del Priorat,-4,2014,20,24
105,080214,Bellprat,0,2014,3,3
106,250501,Bellpuig,46,2014,263,217
107,430249,Bellvei,-5,2014,162,167
108,250518,Bellver de Cerdanya,-26,2014,131,157
109,250523,Bellvís,-60,2014,85,145
110,250539,Benavent de Segrià,-12,2014,66,78
111,430252,Benifallet,-3,2014,19,22
112,430265,Benissanet,4,2014,59,55
113,080229,Berga,-124,2014,552,676
114,170195,Besalú,28,2014,111,83
115,170209,Bescanó,-64,2014,163,227
116,170216,Beuda,-1,2014,23,24
117,080235,Bigues i Riells del Fai,-3,2014,493,496
118,250557,Biosca,1,2014,10,9
119,170221,"Bisbal d'Empordà, la",-66,2014,551,617
120,430271,"Bisbal de Falset, la",8,2014,13,5
121,430287,"Bisbal del Penedès, la",-2,2014,269,271
122,172348,Biure,-1,2014,14,15
123,430290,Blancafort,-4,2014,17,21
124,170237,Blanes,-71,2014,2148,2219
125,170293,Boadella i les Escaules,14,2014,21,7
126,170242,Bolvir,14,2014,44,30
127,430304,Bonastre,11,2014,62,51
128,250576,"Bòrdes, Es",2,2014,19,17
129,170255,Bordils,14,2014,96,82
130,250582,"Borges Blanques, les",-51,2014,275,326
131,430311,"Borges del Camp, les",10,2014,94,84
132,170268,Borrassà,-15,2014,20,35
133,080240,Borredà,-26,2014,16,42
134,250595,Bossòst,-4,2014,74,78
135,430326,Bot,-2,2014,17,19
136,430332,Botarell,-10,2014,55,65
137,250560,Bovera,-8,2014,9,17
138,430347,Bràfim,3,2014,34,31
139,170274,Breda,-29,2014,130,159
140,080253,"Bruc, el",39,2014,158,119
141,080266,"Brull, el",-8,2014,6,14
142,170280,Brunyola i Sant Martí Sapresa,8,2014,20,12
143,430350,Cabacés,4,2014,10,6
144,250609,Cabanabona,-2,2014,4,6
145,170314,Cabanelles,-2,2014,22,24
146,170307,Cabanes,12,2014,68,56
147,080272,"Cabanyes, les",7,2014,43,36
148,250616,Cabó,0,2014,4,4
149,430363,Cabra del Camp,-3,2014,93,96
150,080288,Cabrera d'Anoia,-22,2014,91,113
151,080291,Cabrera de Mar,-1,2014,253,254
152,080305,Cabrils,28,2014,440,412
153,170329,Cadaqués,19,2014,173,154
154,080312,Calaf,-51,2014,143,194
155,430379,Calafell,-73,2014,2027,2100
156,080348,Calders,23,2014,69,46
157,080327,Caldes d'Estrac,7,2014,286,279
158,170335,Caldes de Malavella,33,2014,435,402
159,080333,Caldes de Montbui,-33,2014,775,808
160,080351,Calella,33,2014,1283,1250
161,080370,Calldetenes,-18,2014,98,116
162,080386,Callús,41,2014,148,107
163,080364,Calonge de Segarra,-3,2014,5,8
164,170340,Calonge i Sant Antoni,20,2014,788,768
165,250621,Camarasa,-25,2014,23,48
166,439039,Camarles,-42,2014,152,194
167,430385,Cambrils,-339,2014,2298,2637
168,170353,Camós,6,2014,27,21
169,170366,Campdevànol,-11,2014,91,102
170,170372,Campelles,-2,2014,5,7
171,080399,Campins,-26,2014,36,62
172,170388,Campllong,-21,2014,26,47
173,170391,Camprodon,-41,2014,98,139
174,250637,Canejan,0,2014,2,2
175,170405,Canet d'Adri,30,2014,62,32
176,080403,Canet de Mar,139,2014,777,638
177,439076,"Canonja, la",20,2014,276,256
178,080410,Canovelles,-72,2014,1130,1202
179,080425,Cànoves i Samalús,27,2014,169,142
180,170412,Cantallops,4,2014,11,7
181,080431,Canyelles,10,2014,287,277
182,430398,Capafonts,-4,2014,4,8
183,430402,Capçanes,2,2014,17,15
184,080446,Capellades,-9,2014,226,235
185,170427,Capmany,-12,2014,41,53
186,080459,Capolat,4,2014,8,4
187,080462,Cardedeu,173,2014,909,736
188,080478,Cardona,21,2014,180,159
189,080484,Carme,-20,2014,47,67
190,430419,Caseres,-5,2014,6,11
191,170448,Cassà de la Selva,117,2014,491,374
192,080497,Casserres,-12,2014,60,72
193,080575,Castell de l'Areny,-1,2014,1,2
194,259046,Castell de Mur,26,2014,28,2
195,250642,Castellar de la Ribera,2,2014,3,1
196,080522,Castellar de n'Hug,4,2014,13,9
197,080500,Castellar del Riu,5,2014,11,6
198,080517,Castellar del Vallès,-27,2014,865,892
199,080538,Castellbell i el Vilar,-53,2014,183,236
200,080543,Castellbisbal,-105,2014,488,593
201,080556,Castellcir,-16,2014,41,57
202,250674,Castelldans,2,2014,52,50
203,080569,Castelldefels,742,2014,4737,3995
204,080581,Castellet i la Gornal,-15,2014,151,166
205,170464,Castellfollit de la Roca,-18,2014,49,67
206,080608,Castellfollit de Riubregós,-6,2014,2,8
207,080594,Castellfollit del Boix,8,2014,26,18
208,080615,Castellgalí,-32,2014,112,144
209,080620,Castellnou de Bages,20,2014,66,46
210,250680,Castellnou de Seana,-13,2014,22,35
211,170470,Castelló d'Empúries,-624,2014,896,1520
212,250693,Castelló de Farfanya,-17,2014,16,33
213,080636,Castellolí,8,2014,32,24
214,170486,Castell-Platja d'Aro,-27,2014,903,930
215,250707,Castellserà,-25,2014,23,48
216,080641,Castellterçol,-18,2014,114,132
217,430424,Castellvell del Camp,26,2014,129,103
218,080654,Castellví de la Marca,-44,2014,55,99
219,080667,Castellví de Rosanes,18,2014,117,99
220,430430,"Catllar, el",-13,2014,223,236
221,250714,Cava,-3,2014,0,3
222,171899,"Cellera de Ter, la",4,2014,77,73
223,170499,Celrà,71,2014,326,255
224,080673,Centelles,56,2014,321,265
225,082687,Cercs,-25,2014,45,70
226,082665,Cerdanyola del Vallès,-83,2014,2791,2874
227,080689,Cervelló,77,2014,580,503
228,250729,Cervera,-137,2014,344,481
229,250735,Cervià de les Garrigues,-4,2014,23,27
230,170502,Cervià de Ter,-9,2014,34,43
231,170519,Cistella,12,2014,36,24
232,250740,Ciutadilla,6,2014,10,4
233,250753,Clariana de Cardener,3,2014,13,10
234,250766,"Cogul, el",-7,2014,4,11
235,170545,Colera,-2,2014,64,66
236,250772,Coll de Nargó,-8,2014,21,29
237,080692,Collbató,-33,2014,233,266
238,430458,Colldejou,0,2014,4,4
239,080706,Collsuspina,3,2014,24,21
240,170558,Colomers,-5,2014,17,22
241,251636,"Coma i la Pedra, la",-1,2014,12,13
242,251615,Conca de Dalt,13,2014,23,10
243,430461,Conesa,0,2014,6,6
244,430477,Constantí,-123,2014,316,439
245,080713,Copons,-11,2014,10,21
246,430483,Corbera d'Ebre,-63,2014,49,112
247,080728,Corbera de Llobregat,59,2014,744,685
248,250788,Corbins,-7,2014,52,59
249,170577,Corçà,-19,2014,85,104
250,080734,Cornellà de Llobregat,72,2014,4656,4584
251,170561,Cornellà del Terri,6,2014,103,97
252,430496,Cornudella de Montsant,29,2014,58,29
253,430509,Creixell,28,2014,303,275
254,170583,Crespià,1,2014,28,27
255,179011,"Cruïlles, Monells i Sant Sadurní de l'Heura",22,2014,80,58
256,080749,Cubelles,-58,2014,1059,1117
257,250791,Cubells,-13,2014,13,26
258,430516,Cunit,-28,2014,953,981
259,170600,Darnius,29,2014,51,22
260,170617,Das,0,2014,19,19
261,439018,Deltebre,-1,2014,406,407
262,080752,Dosrius,43,2014,360,317
263,430537,Duesaigües,-3,2014,17,20
264,170622,"Escala, l'",90,2014,552,462
265,080765,Esparreguera,-5,2014,932,937
266,170638,Espinelves,3,2014,16,13
267,250812,"Espluga Calba, l'",-4,2014,9,13
268,430542,"Espluga de Francolí, l'",19,2014,142,123
269,080771,Esplugues de Llobregat,-236,2014,2916,3152
270,170643,Espolla,6,2014,20,14
271,170656,Esponellà,-7,2014,37,44
272,250827,Espot,4,2014,5,1
273,080787,"Espunyola, l'",-5,2014,4,9
274,082541,"Esquirol, l'",-32,2014,69,101
275,250886,Estamariu,6,2014,8,2
276,080790,"Estany, l'",-4,2014,12,16
277,250851,Estaràs,3,2014,6,3
278,250864,Esterri d'Àneu,-50,2014,37,87
279,250870,Esterri de Cardós,3,2014,4,1
280,430555,Falset,20,2014,103,83
281,170059,"Far d'Empordà, el",-7,2014,15,22
282,250899,Farrera,-6,2014,1,7
283,430568,"Fatarella, la",-13,2014,16,29
284,430574,"Febró, la",-3,2014,0,3
285,081347,Figaró-Montmany,13,2014,93,80
286,080804,Fígols,1,2014,1,0
287,259084,Fígols i Alinyà,6,2014,12,6
288,430580,"Figuera, la",-2,2014,15,17
289,170669,Figueres,-198,2014,2924,3122
290,430593,Figuerola del Camp,4,2014,19,15
291,170675,Flaçà,14,2014,56,42
292,430607,Flix,-23,2014,133,156
293,250925,"Floresta, la",-2,2014,5,7
294,080826,Fogars de la Selva,-39,2014,99,138
295,080811,Fogars de Montclús,-3,2014,34,37
296,170681,Foixà,-11,2014,15,26
297,080832,Folgueroles,14,2014,71,57
298,250931,Fondarella,-5,2014,28,33
299,080847,Fonollosa,-14,2014,56,70
300,170694,Fontanals de Cerdanya,7,2014,39,32
301,170708,Fontanilles,-15,2014,8,23
302,170715,Fontcoberta,-6,2014,68,74
303,080850,Font-rubí,-4,2014,59,63
304,250946,Foradada,-2,2014,8,10
305,179026,Forallac,-22,2014,123,145
306,430614,Forès,5,2014,9,4
307,170736,Fornells de la Selva,36,2014,126,90
308,170741,Fortià,18,2014,53,35
309,080863,"Franqueses del Vallès, les",149,2014,1304,1155
310,430629,Freginals,-1,2014,25,26
311,250962,"Fuliola, la",-5,2014,47,52
312,250978,Fulleda,-2,2014,1,3
313,080902,Gaià,3,2014,12,9
314,430635,"Galera, la",-25,2014,27,52
315,080879,Gallifa,-6,2014,5,11
316,430640,Gandesa,-42,2014,105,147
317,430653,Garcia,21,2014,46,25
318,430666,"Garidells, els",5,2014,11,6
319,080885,"Garriga, la",-22,2014,671,693
320,170754,Garrigàs,20,2014,43,23
321,170767,Garrigoles,6,2014,14,8
322,170773,Garriguella,-13,2014,54,67
323,080898,Gavà,-11,2014,2482,2493
324,250984,Gavet de la Conca,-8,2014,15,23
325,080919,Gelida,26,2014,402,376
326,170789,Ger,0,2014,27,27
327,259123,Gimenells i el Pla de la Font,30,2014,57,27
328,430672,Ginestar,-7,2014,21,28
329,170792,Girona,-70,2014,5976,6046
330,080924,Gironella,-20,2014,123,143
331,080930,Gisclareny,1,2014,2,1
332,430688,Godall,-15,2014,16,31
333,250997,Golmés,27,2014,100,73
334,170806,Gombrèn,-4,2014,4,8
335,251001,Gósol,13,2014,15,2
336,080945,"Granada, la",13,2014,108,95
337,251018,"Granadella, la",20,2014,46,26
338,080958,Granera,-2,2014,3,5
339,251023,"Granja d'Escarp, la",40,2014,101,61
340,080961,Granollers,112,2014,3841,3729
341,251039,Granyanella,0,2014,1,1
342,251057,Granyena de les Garrigues,-3,2014,5,8
343,251044,Granyena de Segarra,1,2014,5,4
344,430691,Gratallops,2,2014,6,4
345,080977,Gualba,-18,2014,98,116
346,170813,Gualta,5,2014,84,79
347,080996,Guardiola de Berguedà,1,2014,43,42
348,430705,"Guiamets, els",-8,2014,6,14
349,170828,Guils de Cerdanya,-13,2014,25,38
350,251095,Guimerà,-12,2014,15,27
351,259031,"Guingueta d'Àneu, la",4,2014,20,16
352,251109,Guissona,-40,2014,376,416
353,251116,Guixers,12,2014,20,8
354,081000,Gurb,-3,2014,67,70
355,430712,Horta de Sant Joan,4,2014,40,36
356,081017,"Hospitalet de Llobregat, l'",-423,2014,19342,19765
357,081629,"Hostalets de Pierola, els",-78,2014,175,253
358,170834,Hostalric,10,2014,291,281
359,081022,Igualada,91,2014,1832,1741
360,251155,Isona i Conca Dellà,17,2014,50,33
361,170849,Isòvol,-20,2014,11,31
362,251137,Ivars d'Urgell,5,2014,55,50
363,251121,Ivars de Noguera,1,2014,14,13
364,251142,Ivorra,-4,2014,3,7
365,170852,Jafre,2,2014,22,20
366,170865,"Jonquera, la",103,2014,357,254
367,081038,Jorba,-2,2014,57,59
368,259101,Josa i Tuixén,-1,2014,14,15
369,170871,Juià,3,2014,40,37
370,251180,Juncosa,-11,2014,10,21
371,251193,Juneda,13,2014,156,143
372,251214,Les,-24,2014,37,61
373,251229,Linyola,-22,2014,102,124
374,081043,"Llacuna, la",-10,2014,41,51
375,170887,Lladó,2,2014,39,37
376,251235,Lladorre,-4,2014,11,15
377,251240,Lladurs,-1,2014,6,7
378,081056,"Llagosta, la",-134,2014,651,785
379,170890,Llagostera,17,2014,424,407
380,170904,Llambilles,-4,2014,29,33
381,170911,Llanars,15,2014,41,26
382,170926,Llançà,32,2014,242,210
383,251253,Llardecans,-4,2014,9,13
384,251266,Llavorsí,-4,2014,18,22
385,251207,Lleida,-470,2014,6173,6643
386,170932,Llers,-29,2014,55,84
387,251272,Lles de Cerdanya,1,2014,14,13
388,081075,Lliçà d'Amunt,48,2014,750,702
389,081081,Lliçà de Vall,2,2014,316,314
390,251288,Llimiana,-1,2014,9,10
391,081069,Llinars del Vallès,57,2014,597,540
392,170947,Llívia,-140,2014,85,225
393,430727,"Lloar, el",11,2014,16,5
394,251291,Llobera,2,2014,10,8
395,430733,Llorac,-1,2014,5,6
396,430748,Llorenç del Penedès,27,2014,151,124
397,170950,Lloret de Mar,-1913,2014,2381,4294
398,170963,"Llosses, les",15,2014,26,11
399,081094,Lluçà,19,2014,25,6
400,171024,Maçanet de Cabrenys,-4,2014,47,51
401,171030,Maçanet de la Selva,-20,2014,446,466
402,170979,Madremanya,-10,2014,10,20
403,170985,Maià de Montcal,4,2014,28,24
404,251333,Maials,-5,2014,29,34
405,251305,Maldà,7,2014,11,4
406,081108,Malgrat de Mar,-28,2014,1058,1086
407,081115,Malla,-8,2014,8,16
408,081120,Manlleu,-45,2014,790,835
409,081136,Manresa,-463,2014,2996,3459
410,430764,Marçà,-16,2014,40,56
411,430751,Margalef,-1,2014,6,7
412,082423,Marganell,-14,2014,11,25
413,081141,Martorell,-324,2014,1233,1557
414,081154,Martorelles,-3,2014,309,312
415,430770,Mas de Barberans,-8,2014,14,22
416,171002,Masarac,18,2014,41,23
417,430786,Masdenverge,-8,2014,64,72
418,081167,"Masies de Roda, les",-21,2014,28,49
419,081173,"Masies de Voltregà, les",-5,2014,104,109
420,430799,Masllorenç,-14,2014,36,50
421,081189,"Masnou, el",130,2014,1176,1046
422,430803,"Masó, la",3,2014,10,7
423,430810,Maspujols,-2,2014,33,35
424,081192,Masquefa,-60,2014,422,482
425,430825,"Masroig, el",-1,2014,16,17
426,251312,Massalcoreig,0,2014,40,40
427,171019,Massanes,2,2014,49,47
428,251327,Massoteres,0,2014,8,8
429,081206,Matadepera,76,2014,434,358
430,081213,Mataró,75,2014,5106,5031
431,081228,Mediona,-8,2014,170,178
432,251348,Menàrguens,-24,2014,33,57
433,170998,Meranges,5,2014,11,6
434,171058,Mieres,0,2014,22,22
435,430831,"Milà, el",3,2014,11,8
436,251351,Miralcamp,4,2014,57,53
437,430846,Miravet,-17,2014,23,40
438,081385,Moià,107,2014,354,247
439,430859,"Molar, el",0,2014,11,11
440,081234,Molins de Rei,-59,2014,896,955
441,251370,Mollerussa,72,2014,814,742
442,171061,Mollet de Peralada,2,2014,21,19
443,081249,Mollet del Vallès,-192,2014,2330,2522
444,171077,Molló,-6,2014,13,19
445,251364,"Molsosa, la",0,2014,0,0
446,081287,Monistrol de Calders,4,2014,35,31
447,081271,Monistrol de Montserrat,-37,2014,162,199
448,171096,Montagut i Oix,-18,2014,60,78
449,430862,Montblanc,24,2014,276,252
450,430884,Montbrió del Camp,47,2014,226,179
451,081252,Montcada i Reixac,43,2014,1891,1848
452,081304,Montclar,1,2014,2,1
453,251399,Montellà i Martinet,-24,2014,30,54
454,081311,Montesquiu,51,2014,97,46
455,251403,Montferrer i Castellbò,-11,2014,68,79
456,430897,Montferri,7,2014,32,25
457,251386,Montgai,-1,2014,25,26
458,081265,Montgat,166,2014,760,594
459,081326,Montmajor,-1,2014,20,21
460,081332,Montmaneu,0,2014,8,8
461,430901,"Montmell, el",-46,2014,89,135
462,081350,Montmeló,-6,2014,392,398
463,251425,Montoliu de Lleida,18,2014,33,15
464,251410,Montoliu de Segarra,4,2014,13,9
465,251431,Montornès de Segarra,-4,2014,5,9
466,081363,Montornès del Vallès,-95,2014,814,909
467,430918,Mont-ral,6,2014,14,8
468,171100,Mont-ras,-29,2014,59,88
469,430923,Mont-roig del Camp,-133,2014,916,1049
470,081379,Montseny,-8,2014,24,32
471,430939,Móra d'Ebre,-91,2014,263,354
472,430944,Móra la Nova,19,2014,146,127
473,430957,"Morell, el",-20,2014,259,279
474,430960,"Morera de Montsant, la",-10,2014,8,18
475,081290,Muntanyola,8,2014,31,23
476,081398,Mura,-7,2014,12,19
477,251459,Nalec,2,2014,5,3
478,250254,Naut Aran,-27,2014,110,137
479,081402,Navarcles,19,2014,257,238
480,081419,Navàs,-8,2014,214,222
481,171117,Navata,62,2014,109,47
482,251462,Navès,2,2014,20,18
483,081424,"Nou de Berguedà, la",4,2014,10,6
484,430976,"Nou de Gaià, la",-13,2014,38,51
485,430982,Nulles,-8,2014,26,34
486,251484,Odèn,-8,2014,7,15
487,081430,Òdena,-20,2014,183,203
488,171122,Ogassa,-11,2014,0,11
489,081458,Olèrdola,-68,2014,178,246
490,081461,Olesa de Bonesvalls,-16,2014,75,91
491,081477,Olesa de Montserrat,-37,2014,1059,1096
492,251497,Oliana,-51,2014,77,128
493,251500,Oliola,-3,2014,9,12
494,251517,Olius,-3,2014,56,59
495,081483,Olivella,-40,2014,343,383
496,081496,Olost,-6,2014,34,40
497,171143,Olot,43,2014,1383,1340
498,251522,"Oluges, les",2,2014,6,4
499,081445,Olvan,-12,2014,35,47
500,251538,"Omellons, els",-6,2014,5,11
501,251543,"Omells de na Gaia, els",-5,2014,0,5
502,171156,Ordis,13,2014,25,12
503,251556,Organyà,20,2014,45,25
504,081509,Orís,6,2014,20,14
505,081516,Oristà,-1,2014,27,28
506,081521,Orpí,2,2014,12,10
507,081537,Òrrius,-4,2014,43,47
508,251569,Os de Balaguer,0,2014,52,52
509,171169,Osor,-24,2014,15,39
510,251575,Ossó de Sió,2,2014,10,8
511,081542,Pacs del Penedès,6,2014,60,54
512,081555,Palafolls,41,2014,574,533
513,171175,Palafrugell,-239,2014,995,1234
514,171181,Palamós,116,2014,1051,935
515,251581,"Palau d'Anglesola, el",-2,2014,84,86
516,171194,Palau de Santa Eulàlia,-5,2014,6,11
517,171215,Palau-sator,2,2014,16,14
518,171208,Palau-saverdera,10,2014,138,128
519,081568,Palau-solità i Plegamans,-34,2014,646,680
520,431009,"Pallaresos, els",66,2014,240,174
521,081574,Pallejà,51,2014,535,484
522,430995,"Palma d'Ebre, la",3,2014,12,9
523,089058,"Palma de Cervelló, la",-48,2014,152,200
524,171236,Palol de Revardit,-7,2014,12,19
525,171241,Pals,-33,2014,127,160
526,081580,"Papiol, el",27,2014,211,184
527,171254,Pardines,1,2014,2,1
528,081593,Parets del Vallès,112,2014,930,818
529,171267,Parlavà,-13,2014,14,27
530,431016,Passanant i Belltall,21,2014,30,9
531,171289,Pau,-7,2014,27,34
532,431021,Paüls,-6,2014,18,24
533,171292,Pedret i Marzà,5,2014,14,9
534,251641,Penelles,-22,2014,26,48
535,171306,"Pera, la",-23,2014,14,37
536,081607,Perafita,10,2014,23,13
537,431037,Perafort,15,2014,110,95
538,171328,Peralada,2,2014,143,141
539,251654,Peramola,-3,2014,12,15
540,431042,"Perelló, el",-461,2014,120,581
541,081614,Piera,-10,2014,896,906
542,431055,"Piles, les",-9,2014,2,11
543,081635,Pineda de Mar,96,2014,1661,1565
544,431068,"Pinell de Brai, el",-21,2014,18,39
545,251667,Pinell de Solsonès,4,2014,5,1
546,251673,Pinós,2,2014,16,14
547,431074,Pira,9,2014,24,15
548,431080,"Pla de Santa Maria, el",-20,2014,140,160
549,081640,"Pla del Penedès, el",5,2014,87,82
550,171334,"Planes d'Hostoles, les",-11,2014,48,59
551,171349,Planoles,-2,2014,13,15
552,259118,"Plans de Sió, els",-23,2014,13,36
553,251689,"Poal, el",13,2014,53,40
554,251692,"Pobla de Cérvoles, la",5,2014,16,11
555,081653,"Pobla de Claramunt, la",-35,2014,102,137
556,081666,"Pobla de Lillet, la",1,2014,43,42
557,431093,"Pobla de Mafumet, la",202,2014,429,227
558,431107,"Pobla de Massaluca, la",-10,2014,6,16
559,431114,"Pobla de Montornès, la",-7,2014,190,197
560,251713,"Pobla de Segur, la",13,2014,169,156
561,431129,Poboleda,2,2014,27,25
562,081672,Polinyà,-77,2014,337,414
563,431135,"Pont d'Armentera, el",-7,2014,28,35
564,250306,"Pont de Bar, el",-7,2014,10,17
565,171352,Pont de Molins,-18,2014,25,43
566,251734,"Pont de Suert, el",16,2014,110,94
567,081825,"Pont de Vilomara i Rocafort, el",-75,2014,156,231
568,431418,Pontils,4,2014,12,8
569,081688,Pontons,8,2014,74,66
570,171365,Pontós,5,2014,20,15
571,251728,Ponts,-47,2014,122,169
572,171371,Porqueres,-5,2014,191,196
573,431140,Porrera,-1,2014,14,15
574,171404,"Port de la Selva, el",19,2014,71,52
575,171387,Portbou,-28,2014,57,85
576,251749,"Portella, la",-11,2014,50,61
577,431153,Pradell de la Teixeta,6,2014,13,7
578,431166,Prades,-1,2014,26,27
579,431172,Prat de Comte,-1,2014,7,8
580,081691,"Prat de Llobregat, el",51,2014,2314,2263
581,431188,Pratdip,16,2014,54,38
582,081712,Prats de Lluçanès,-21,2014,73,94
583,081705,"Prats de Rei, els",-2,2014,20,22
584,251752,Prats i Sansor,1,2014,11,10
585,251765,Preixana,4,2014,16,12
586,251771,Preixens,7,2014,23,16
587,082303,Premià de Dalt,90,2014,666,576
588,081727,Premià de Mar,-138,2014,1479,1617
589,171390,"Preses, les",-6,2014,79,85
590,251790,Prullans,0,2014,13,13
591,171411,Puigcerdà,27,2014,537,510
592,081748,Puigdàlber,3,2014,35,32
593,251804,Puiggròs,2,2014,11,9
594,431191,Puigpelat,23,2014,75,52
595,081751,Puig-reig,18,2014,167,149
596,251811,Puigverd d'Agramunt,1,2014,16,15
597,251826,Puigverd de Lleida,9,2014,68,59
598,081764,Pujalt,0,2014,2,2
599,081770,"Quar, la",-3,2014,2,5
600,171426,Quart,-31,2014,155,186
601,170433,Queralbs,-7,2014,7,14
602,431205,Querol,14,2014,58,44
603,171432,Rabós,5,2014,13,8
604,081786,Rajadell,-3,2014,24,27
605,431212,Rasquera,5,2014,28,23
606,171447,Regencós,-2,2014,21,23
607,081799,Rellinars,24,2014,54,30
608,431227,Renau,9,2014,16,7
609,431233,Reus,-1609,2014,3440,5049
610,251832,Rialp,-37,2014,32,69
611,431248,"Riba, la",1,2014,26,25
612,431251,Riba-roja d'Ebre,-4,2014,37,41
613,259059,Ribera d'Ondara,10,2014,26,16
614,251850,Ribera d'Urgellet,19,2014,79,60
615,171450,Ribes de Freser,-9,2014,65,74
616,171463,Riells i Viabrea,-56,2014,274,330
617,431264,"Riera de Gaià, la",3,2014,92,89
618,251863,Riner,-10,2014,12,22
619,171479,Ripoll,-85,2014,301,386
620,081803,Ripollet,60,2014,1901,1841
621,259139,Riu de Cerdanya,-5,2014,6,11
622,171485,Riudarenes,-10,2014,140,150
623,171498,Riudaura,-1,2014,23,24
624,431270,Riudecanyes,16,2014,46,30
625,431286,Riudecols,-41,2014,50,91
626,171501,Riudellots de la Selva,-14,2014,94,108
627,431299,Riudoms,82,2014,306,224
628,171518,Riumors,1,2014,14,13
629,081810,"Roca del Vallès, la",-30,2014,476,506
630,431303,Rocafort de Queralt,-5,2014,10,15
631,431310,Roda de Berà,55,2014,507,452
632,081831,Roda de Ter,8,2014,275,267
633,431325,Rodonyà,-9,2014,22,31
634,431331,Roquetes,-66,2014,372,438
635,171523,Roses,-109,2014,1090,1199
636,251898,Rosselló,32,2014,220,188
637,431346,"Rourell, el",10,2014,34,24
638,081846,Rubí,118,2014,3188,3070
639,081859,Rubió,2,2014,15,13
640,171539,Rupià,5,2014,20,15
641,089019,Rupit i Pruit,-13,2014,5,18
642,081878,Sabadell,348,2014,8497,8149
643,081884,Sagàs,10,2014,10,0
644,251902,Salàs de Pallars,-1,2014,18,19
645,081901,Saldes,0,2014,15,15
646,171544,Sales de Llierca,1,2014,15,14
647,081918,Sallent,-77,2014,166,243
648,431359,Salomó,-8,2014,29,37
649,439057,Salou,-178,2014,2378,2556
650,171557,Salt,-636,2014,2006,2642
651,251919,Sanaüja,9,2014,21,12
652,081944,Sant Adrià de Besòs,266,2014,2675,2409
653,081957,Sant Agustí de Lluçanès,0,2014,2,2
654,081960,Sant Andreu de la Barca,-28,2014,1259,1287
655,081976,Sant Andreu de Llavaneres,-34,2014,709,743
656,171576,Sant Andreu Salou,-1,2014,8,9
657,171833,Sant Aniol de Finestres,20,2014,25,5
658,081982,Sant Antoni de Vilamajor,65,2014,429,364
659,081995,Sant Bartomeu del Grau,-16,2014,36,52
660,082009,Sant Boi de Llobregat,-649,2014,3012,3661
661,082016,Sant Boi de Lluçanès,-1,2014,40,41
662,431362,Sant Carles de la Ràpita,-190,2014,646,836
663,082037,Sant Cebrià de Vallalta,-16,2014,233,249
664,082021,Sant Celoni,10,2014,982,972
665,082042,Sant Climent de Llobregat,55,2014,190,135
666,171582,Sant Climent Sescebes,14,2014,83,69
667,082055,Sant Cugat del Vallès,531,2014,5069,4538
668,082068,Sant Cugat Sesgarrigues,5,2014,46,41
669,251961,Sant Esteve de la Sarga,13,2014,16,3
670,082074,Sant Esteve de Palautordera,19,2014,193,174
671,082080,Sant Esteve Sesrovires,71,2014,442,371
672,171595,Sant Feliu de Buixalleu,17,2014,70,53
673,082107,Sant Feliu de Codines,13,2014,418,405
674,171609,Sant Feliu de Guíxols,-125,2014,1306,1431
675,082114,Sant Feliu de Llobregat,-16,2014,1916,1932
676,171616,Sant Feliu de Pallerols,-3,2014,76,79
677,082129,Sant Feliu Sasserra,2,2014,19,17
678,171621,Sant Ferriol,-2,2014,19,21
679,082093,Sant Fost de Campsentelles,-12,2014,500,512
680,082135,Sant Fruitós de Bages,86,2014,389,303
681,171637,Sant Gregori,17,2014,168,151
682,251924,Sant Guim de Freixenet,-24,2014,32,56
683,251977,Sant Guim de la Plana,5,2014,11,6
684,171642,Sant Hilari Sacalm,-68,2014,177,245
685,082153,Sant Hipòlit de Voltregà,-18,2014,144,162
686,081939,Sant Iscle de Vallalta,7,2014,86,79
687,439023,Sant Jaume d'Enveja,8,2014,121,113
688,082166,Sant Jaume de Frontanyà,2,2014,2,0
689,171655,Sant Jaume de Llierca,28,2014,65,37
690,431378,Sant Jaume dels Domenys,25,2014,217,192
691,171674,Sant Joan de les Abadesses,8,2014,102,94
692,171680,Sant Joan de Mollet,-7,2014,25,32
693,082188,Sant Joan de Vilatorrada,8,2014,373,365
694,082172,Sant Joan Despí,248,2014,1730,1482
695,171851,Sant Joan les Fonts,26,2014,147,121
696,171668,Sant Jordi Desvalls,13,2014,52,39
697,089030,Sant Julià de Cerdanyola,3,2014,9,6
698,171693,Sant Julià de Ramis,-48,2014,190,238
699,082205,Sant Julià de Vilatorta,-3,2014,93,96
700,179032,Sant Julià del Llor i Bonmatí,16,2014,71,55
701,082212,Sant Just Desvern,15,2014,1206,1191
702,082227,Sant Llorenç d'Hortons,18,2014,146,128
703,171714,Sant Llorenç de la Muga,8,2014,23,15
704,251930,Sant Llorenç de Morunys,-4,2014,51,55
705,082233,Sant Llorenç Savall,18,2014,116,98
706,082251,Sant Martí d'Albars,3,2014,11,8
707,082248,Sant Martí de Centelles,13,2014,121,108
708,171729,Sant Martí de Llémena,-24,2014,26,50
709,259025,Sant Martí de Riucorb,8,2014,22,14
710,082264,Sant Martí de Tous,11,2014,52,41
711,082270,Sant Martí Sarroca,-51,2014,171,222
712,082286,Sant Martí Sesgueioles,-16,2014,16,32
713,171735,Sant Martí Vell,6,2014,20,14
714,082299,Sant Mateu de Bages,-19,2014,20,39
715,171740,Sant Miquel de Campmajor,-10,2014,6,16
716,171753,Sant Miquel de Fluvià,-29,2014,39,68
717,171766,Sant Mori,1,2014,19,18
718,171772,Sant Pau de Segúries,10,2014,49,39
719,082310,Sant Pere de Ribes,223,2014,1869,1646
720,082325,Sant Pere de Riudebitlles,10,2014,82,72
721,082331,Sant Pere de Torelló,14,2014,132,118
722,082346,Sant Pere de Vilamajor,29,2014,270,241
723,171788,Sant Pere Pescador,-18,2014,149,167
724,081897,Sant Pere Sallavinera,5,2014,7,2
725,082359,Sant Pol de Mar,30,2014,323,293
726,082362,Sant Quintí de Mediona,14,2014,100,86
727,082378,Sant Quirze de Besora,1,2014,80,79
728,082384,Sant Quirze del Vallès,-12,2014,933,945
729,082397,Sant Quirze Safaja,-29,2014,32,61
730,251945,Sant Ramon,12,2014,21,9
731,082401,Sant Sadurní d'Anoia,64,2014,508,444
732,082418,Sant Sadurní d'Osormort,1,2014,5,4
733,080983,Sant Salvador de Guardiola,-12,2014,139,151
734,082628,Sant Vicenç de Castellet,-70,2014,442,512
735,082649,Sant Vicenç de Montalt,66,2014,449,383
736,082652,Sant Vicenç de Torelló,20,2014,95,75
737,082634,Sant Vicenç dels Horts,-207,2014,1089,1296
738,431384,Santa Bàrbara,-55,2014,162,217
739,082439,Santa Cecília de Voltregà,3,2014,6,3
740,082444,Santa Coloma de Cervelló,-41,2014,316,357
741,171805,Santa Coloma de Farners,148,2014,651,503
742,082457,Santa Coloma de Gramenet,-1183,2014,7796,8979
743,431397,Santa Coloma de Queralt,-65,2014,82,147
744,171812,Santa Cristina d'Aro,-88,2014,330,418
745,082460,Santa Eugènia de Berga,-30,2014,142,172
746,082476,Santa Eulàlia de Riuprimer,19,2014,72,53
747,082482,Santa Eulàlia de Ronçana,-7,2014,374,381
748,082495,Santa Fe del Penedès,-1,2014,18,19
749,171827,Santa Llogaia d'Àlguema,-1,2014,22,23
750,082508,Santa Margarida de Montbui,-20,2014,511,531
751,082515,Santa Margarida i els Monjos,-43,2014,417,460
752,082589,Santa Maria d'Oló,-2,2014,19,21
753,082536,Santa Maria de Besora,-5,2014,6,11
754,082567,Santa Maria de Martorelles,-1,2014,65,66
755,082554,Santa Maria de Merlès,8,2014,19,11
756,082573,Santa Maria de Miralles,-11,2014,1,12
757,082592,Santa Maria de Palautordera,-21,2014,540,561
758,431401,Santa Oliva,-49,2014,276,325
759,171848,Santa Pau,2,2014,68,66
760,082606,Santa Perpètua de Mogoda,35,2014,1249,1214
761,082613,Santa Susanna,-35,2014,269,304
762,081923,Santpedor,54,2014,293,239
763,431423,Sarral,-3,2014,56,59
764,171864,Sarrià de Ter,-7,2014,261,268
765,252017,Sarroca de Bellera,2,2014,10,8
766,252000,Sarroca de Lleida,-11,2014,4,15
767,171870,"Saus, Camallera i Llampaies",10,2014,54,44
768,431439,Savallà del Comtat,-3,2014,3,6
769,431444,"Secuita, la",-1,2014,89,90
770,171886,"Selva de Mar, la",3,2014,15,12
771,431457,"Selva del Camp, la",-69,2014,192,261
772,431460,Senan,-4,2014,4,8
773,430445,"Sénia, la",-47,2014,238,285
774,252022,Senterada,1,2014,8,7
775,250352,"Sentiu de Sió, la",-2,2014,21,23
776,082671,Sentmenat,-33,2014,384,417
777,171903,Serinyà,6,2014,71,65
778,252043,Seròs,4,2014,108,104
779,171910,Serra de Daró,0,2014,10,10
780,171925,Setcases,-7,2014,8,15
781,252038,"Seu d'Urgell, la",-88,2014,604,692
782,082690,Seva,-62,2014,136,198
783,252056,Sidamon,18,2014,40,22
784,171931,Sils,7,2014,414,407
785,082704,Sitges,-704,2014,2298,3002
786,170524,Siurana,1,2014,8,7
787,082711,Sobremunt,-1,2014,4,5
788,252069,"Soleràs, el",-14,2014,4,18
789,431476,Solivella,-14,2014,15,29
790,252075,Solsona,-32,2014,510,542
791,082726,Sora,5,2014,9,4
792,252081,Soriguera,11,2014,36,25
793,252094,Sort,-31,2014,98,129
794,252108,Soses,-36,2014,56,92
795,082732,Subirats,-26,2014,147,173
796,252115,Sudanell,-16,2014,19,35
797,252120,Sunyer,19,2014,27,8
798,082747,Súria,-46,2014,178,224
799,171946,Susqueda,0,2014,5,5
800,082763,Tagamanent,-1,2014,23,24
801,082779,Talamanca,48,2014,61,13
802,252154,Talarn,179,2014,261,82
803,252167,Talavera,-1,2014,6,7
804,171959,"Tallada d'Empordà, la",4,2014,27,23
805,082785,Taradell,32,2014,261,229
806,431482,Tarragona,83,2014,5625,5542
807,252173,Tàrrega,-174,2014,719,893
808,252189,Tarrés,1,2014,4,3
809,252192,Tarroja de Segarra,6,2014,9,3
810,082750,Tavèrnoles,4,2014,15,11
811,082802,Tavertet,-2,2014,7,9
812,082819,Teià,127,2014,381,254
813,252206,Térmens,0,2014,78,78
814,171962,Terrades,8,2014,21,13
815,082798,Terrassa,-450,2014,8101,8551
816,082824,Tiana,93,2014,429,336
817,252213,Tírvia,-2,2014,7,9
818,252228,Tiurana,-4,2014,2,6
819,431495,Tivenys,1,2014,31,30
820,431508,Tivissa,4,2014,89,85
821,082830,Tona,-10,2014,306,316
822,252234,Torà,15,2014,62,47
823,082845,Tordera,74,2014,1083,1009
824,082858,Torelló,-77,2014,494,571
825,252249,"Torms, els",0,2014,4,4
826,252252,Tornabous,-17,2014,46,63
827,252271,"Torre de Cabdella, la",6,2014,31,25
828,082861,"Torre de Claramunt, la",-72,2014,195,267
829,431515,"Torre de Fontaubella, la",3,2014,6,3
830,431520,"Torre de l'Espanyol, la",-17,2014,22,39
831,252265,Torrebesses,0,2014,16,16
832,431536,Torredembarra,-49,2014,1019,1068
833,252287,Torrefarrera,81,2014,339,258
834,259078,Torrefeta i Florejacs,13,2014,37,24
835,252304,Torregrossa,34,2014,96,62
836,252311,Torrelameu,0,2014,31,31
837,082877,Torrelavit,6,2014,76,70
838,082883,Torrelles de Foix,-66,2014,168,234
839,082896,Torrelles de Llobregat,2,2014,270,268
840,171978,Torrent,2,2014,9,7
841,252326,Torres de Segre,-31,2014,270,301
842,252332,Torre-serona,0,2014,23,23
843,171984,Torroella de Fluvià,18,2014,81,63
844,171997,Torroella de Montgrí,18,2014,658,640
845,431541,Torroja del Priorat,5,2014,10,5
846,172001,Tortellà,1,2014,46,45
847,431554,Tortosa,-116,2014,1496,1612
848,172018,Toses,6,2014,13,7
849,172023,Tossa de Mar,-12,2014,230,242
850,252347,Tremp,-4,2014,447,451
851,172044,Ullà,16,2014,140,124
852,082900,Ullastrell,-6,2014,92,98
853,172057,Ullastret,5,2014,22,17
854,431567,Ulldecona,-105,2014,261,366
855,431573,Ulldemolins,-7,2014,16,23
856,172039,Ultramort,-5,2014,8,13
857,172060,Urús,-7,2014,4,11
858,082917,Vacarisses,-109,2014,302,411
859,170144,"Vajol, la",1,2014,9,8
860,172076,"Vall d'en Bas, la",21,2014,113,92
861,172082,"Vall de Bianya, la",1,2014,63,62
862,250432,"Vall de Boí, la",6,2014,53,47
863,259010,Vall de Cardós,-13,2014,13,26
864,082922,Vallbona d'Anoia,-16,2014,58,74
865,252385,Vallbona de les Monges,-5,2014,2,7
866,082938,Vallcebre,-1,2014,14,15
867,431589,Vallclara,-6,2014,2,8
868,252402,Vallfogona de Balaguer,-14,2014,98,112
869,171707,Vallfogona de Ripollès,-10,2014,3,13
870,431592,Vallfogona de Riucorb,-1,2014,4,5
871,082943,Vallgorguina,45,2014,217,172
872,082956,Vallirana,3,2014,789,786
873,172095,Vall-llobrega,22,2014,70,48
874,431606,Vallmoll,-13,2014,105,118
875,082969,Vallromanes,-3,2014,158,161
876,431613,Valls,-165,2014,890,1055
877,259062,"Valls d'Aguilar, les",9,2014,18,9
878,252398,"Valls de Valira, les",12,2014,91,79
879,431628,Vandellòs i l'Hospitalet de l'Infant,-9,2014,349,358
880,259097,"Vansa i Fórnols, la",4,2014,15,11
881,082975,Veciana,-2,2014,3,5
882,431634,"Vendrell, el",-317,2014,2179,2496
883,172109,Ventalló,16,2014,58,42
884,252424,Verdú,4,2014,35,31
885,172116,Verges,-1,2014,64,65
886,431649,Vespella de Gaià,3,2014,31,28
887,082981,Vic,450,2014,2554,2104
888,172121,Vidrà,0,2014,6,6
889,172137,Vidreres,34,2014,521,487
890,252430,Vielha e Mijaran,-38,2014,408,446
891,431652,Vilabella,-1,2014,23,24
892,172142,Vilabertran,-14,2014,49,63
893,172155,Vilablareix,8,2014,97,89
894,082994,Vilada,-14,2014,22,36
895,172174,Viladamat,3,2014,26,23
896,172168,Viladasens,9,2014,14,5
897,083015,Viladecans,-79,2014,2661,2740
898,083008,Viladecavalls,-30,2014,295,325
899,172180,Vilademuls,35,2014,81,46
900,172207,Viladrau,-3,2014,33,36
901,172214,Vilafant,22,2014,325,303
902,083054,Vilafranca del Penedès,-13,2014,1914,1927
903,252445,Vilagrassa,7,2014,35,28
904,172235,Vilajuïga,-24,2014,75,99
905,431750,Vilalba dels Arcs,0,2014,8,8
906,083067,Vilalba Sasserra,-4,2014,77,81
907,252458,Vilaller,-29,2014,26,55
908,172240,Vilallonga de Ter,-15,2014,13,28
909,431665,Vilallonga del Camp,-24,2014,134,158
910,172253,Vilamacolum,-7,2014,32,39
911,172266,Vilamalla,27,2014,75,48
912,172272,Vilamaniscle,16,2014,28,12
913,252477,Vilamòs,-6,2014,10,16
914,172288,Vilanant,-1,2014,26,27
915,431671,Vilanova d'Escornalbou,3,2014,34,31
916,252483,Vilanova de Bellpuig,-10,2014,35,45
917,252496,Vilanova de l'Aguda,-4,2014,4,8
918,252542,Vilanova de la Barca,-7,2014,45,52
919,252509,Vilanova de Meià,4,2014,20,16
920,431687,Vilanova de Prades,-4,2014,5,9
921,083036,Vilanova de Sau,-1,2014,7,8
922,252516,Vilanova de Segrià,7,2014,62,55
923,083020,Vilanova del Camí,-95,2014,530,625
924,089024,Vilanova del Vallès,-4,2014,252,256
925,083073,Vilanova i la Geltrú,15,2014,2994,2979
926,431690,Vilaplana,2,2014,26,24
927,431704,Vila-rodona,6,2014,66,60
928,172305,Vila-sacra,-11,2014,48,59
929,252521,Vila-sana,12,2014,34,22
930,431711,Vila-seca,26,2014,1381,1355
931,082140,Vilassar de Dalt,87,2014,439,352
932,082191,Vilassar de Mar,232,2014,1107,875
933,172229,Vilaür,5,2014,14,9
934,431726,Vilaverd,-21,2014,18,39
935,431732,"Vilella Alta, la",-1,2014,4,5
936,431747,"Vilella Baixa, la",-2,2014,11,13
937,172333,Vilobí d'Onyar,14,2014,166,152
938,083041,Vilobí del Penedès,0,2014,71,71
939,172327,Vilopriu,-6,2014,7,13
940,252537,"Vilosell, el",1,2014,15,14
941,431763,Vimbodí i Poblet,6,2014,37,31
942,252555,Vinaixa,-11,2014,7,18
943,431779,Vinebre,-23,2014,17,40
944,431785,Vinyols i els Arcs,47,2014,189,142
945,083089,Viver i Serrateix,-4,2014,1,5
946,430521,Xerta,-35,2014,37,72
0,250019,Abella de la Conca,11,2015,16,5
1,080018,Abrera,90,2015,631,541
2,250024,Àger,-9,2015,18,27
3,250030,Agramunt,-78,2015,182,260
4,080023,Aguilar de Segarra,7,2015,14,7
5,170010,Agullana,17,2015,67,50
6,080142,Aiguafreda,8,2015,175,167
7,430017,Aiguamúrcia,-11,2015,46,57
8,170025,Aiguaviva,-14,2015,23,37
9,250387,Aitona,83,2015,202,119
10,250045,"Alamús, els",18,2015,56,38
11,250058,Alàs i Cerc,0,2015,16,16
12,250061,"Albagés, l'",-13,2015,7,20
13,170031,Albanyà,-2,2015,19,21
14,250077,Albatàrrec,58,2015,189,131
15,250083,Albesa,-25,2015,36,61
16,250096,"Albi, l'",-7,2015,21,28
17,430022,Albinyana,-15,2015,135,150
18,430038,"Albiol, l'",9,2015,24,15
19,170046,Albons,27,2015,61,34
20,430043,Alcanar,-79,2015,427,506
21,250100,Alcanó,4,2015,9,5
22,250117,Alcarràs,61,2015,652,591
23,250122,Alcoletge,97,2015,243,146
24,430056,Alcover,5,2015,218,213
25,439044,"Aldea, l'",-39,2015,206,245
26,430069,Aldover,-22,2015,21,43
27,430075,"Aleixar, l'",3,2015,63,60
28,080039,Alella,39,2015,595,556
29,430081,Alfara de Carles,0,2015,11,11
30,250138,Alfarràs,-40,2015,123,163
31,250143,Alfés,2,2015,12,10
32,430094,Alforja,-3,2015,137,140
33,250156,Algerri,9,2015,27,18
34,250169,Alguaire,21,2015,133,112
35,250175,Alins,0,2015,8,8
36,430108,Alió,-14,2015,18,32
37,250194,Almacelles,62,2015,289,227
38,250208,Almatret,8,2015,27,19
39,250215,Almenar,-5,2015,144,149
40,430115,Almoster,-10,2015,41,51
41,250220,Alòs de Balaguer,-1,2015,6,7
42,170062,Alp,-60,2015,93,153
43,080044,Alpens,2,2015,12,10
44,250236,Alpicat,-36,2015,226,262
45,250241,Alt Àneu,0,2015,16,16
46,430120,Altafulla,31,2015,301,270
47,170078,Amer,17,2015,97,80
48,430136,"Ametlla de Mar, l'",107,2015,414,307
49,080057,"Ametlla del Vallès, l'",46,2015,436,390
50,439060,"Ampolla, l'",-74,2015,233,307
51,430141,Amposta,-93,2015,877,970
52,170084,Anglès,-58,2015,224,282
53,250273,Anglesola,-28,2015,46,74
54,250292,Arbeca,20,2015,82,62
55,430167,"Arboç, l'",-36,2015,317,353
56,430154,Arbolí,2,2015,7,5
57,170097,Arbúcies,57,2015,323,266
58,080060,Arenys de Mar,69,2015,926,857
59,080076,Arenys de Munt,-62,2015,410,472
60,170101,Argelaguer,9,2015,28,19
61,080082,Argençola,5,2015,13,8
62,430173,"Argentera, l'",-9,2015,2,11
63,080095,Argentona,97,2015,576,479
64,170118,"Armentera, l'",36,2015,70,34
65,430189,Arnes,-5,2015,17,22
66,250313,Arres,0,2015,1,1
67,250328,Arsèguel,5,2015,6,1
68,080109,Artés,-61,2015,221,282
69,250334,Artesa de Lleida,2,2015,43,41
70,250349,Artesa de Segre,-31,2015,120,151
71,430192,Ascó,10,2015,56,46
72,250365,Aspa,-2,2015,4,6
73,250371,"Avellanes i Santa Linya, les",-1,2015,17,18
74,080116,Avià,34,2015,103,69
75,080121,Avinyó,-12,2015,89,101
76,170123,Avinyonet de Puigventós,10,2015,96,86
77,080137,Avinyonet del Penedès,18,2015,100,82
78,080155,Badalona,279,2015,11344,11065
79,089045,Badia del Vallès,-29,2015,556,585
80,080168,Bagà,-6,2015,95,101
81,250390,Baix Pallars,-4,2015,17,21
82,250404,Balaguer,15,2015,815,800
83,080174,Balenyà,-23,2015,157,180
84,080180,Balsareny,-25,2015,79,104
85,430206,Banyeres del Penedès,-16,2015,223,239
86,170157,Banyoles,12,2015,853,841
87,250411,Barbens,46,2015,82,36
88,430213,Barberà de la Conca,-25,2015,17,42
89,082520,Barberà del Vallès,184,2015,1569,1385
90,080193,Barcelona,10558,2015,95252,84694
91,250426,"Baronia de Rialb, la",-3,2015,9,12
92,170160,Bàscara,37,2015,86,49
93,250447,Bassella,5,2015,15,10
94,430228,Batea,36,2015,80,44
95,250450,Bausen,7,2015,9,2
96,080207,Begues,31,2015,347,316
97,170139,Begur,-25,2015,203,228
98,250463,Belianes,-14,2015,8,22
99,251706,Bellaguarda,4,2015,9,5
100,170182,Bellcaire d'Empordà,-2,2015,46,48
101,250479,Bellcaire d'Urgell,-26,2015,45,71
102,250485,Bell-lloc d'Urgell,19,2015,93,74
103,250498,Bellmunt d'Urgell,0,2015,6,6
104,430234,Bellmunt del Priorat,9,2015,14,5
105,080214,Bellprat,2,2015,4,2
106,250501,Bellpuig,75,2015,291,216
107,430249,Bellvei,-1,2015,165,166
108,250518,Bellver de Cerdanya,-74,2015,141,215
109,250523,Bellvís,19,2015,128,109
110,250539,Benavent de Segrià,-22,2015,49,71
111,430252,Benifallet,9,2015,29,20
112,430265,Benissanet,-21,2015,54,75
113,080229,Berga,29,2015,552,523
114,170195,Besalú,-1,2015,119,120
115,170209,Bescanó,9,2015,186,177
116,170216,Beuda,4,2015,27,23
117,080235,Bigues i Riells del Fai,58,2015,556,498
118,250557,Biosca,-8,2015,2,10
119,170221,"Bisbal d'Empordà, la",-44,2015,551,595
120,430271,"Bisbal de Falset, la",-5,2015,3,8
121,430287,"Bisbal del Penedès, la",16,2015,248,232
122,172348,Biure,-1,2015,9,10
123,430290,Blancafort,-14,2015,7,21
124,170237,Blanes,28,2015,2134,2106
125,170293,Boadella i les Escaules,7,2015,22,15
126,170242,Bolvir,-5,2015,36,41
127,430304,Bonastre,-9,2015,50,59
128,250576,"Bòrdes, Es",13,2015,25,12
129,170255,Bordils,-39,2015,85,124
130,250582,"Borges Blanques, les",-9,2015,268,277
131,430311,"Borges del Camp, les",-4,2015,126,130
132,170268,Borrassà,-1,2015,34,35
133,080240,Borredà,-11,2015,33,44
134,250595,Bossòst,-29,2015,71,100
135,430326,Bot,-1,2015,21,22
136,430332,Botarell,14,2015,66,52
137,250560,Bovera,-1,2015,9,10
138,430347,Bràfim,4,2015,30,26
139,170274,Breda,20,2015,155,135
140,080253,"Bruc, el",-20,2015,138,158
141,080266,"Brull, el",9,2015,15,6
142,170280,Brunyola i Sant Martí Sapresa,-13,2015,13,26
143,430350,Cabacés,-2,2015,9,11
144,250609,Cabanabona,0,2015,2,2
145,170314,Cabanelles,14,2015,27,13
146,170307,Cabanes,-6,2015,59,65
147,080272,"Cabanyes, les",-17,2015,35,52
148,250616,Cabó,-2,2015,1,3
149,430363,Cabra del Camp,7,2015,81,74
150,080288,Cabrera d'Anoia,-3,2015,114,117
151,080291,Cabrera de Mar,37,2015,311,274
152,080305,Cabrils,27,2015,422,395
153,170329,Cadaqués,-28,2015,146,174
154,080312,Calaf,2,2015,185,183
155,430379,Calafell,100,2015,2164,2064
156,080348,Calders,-7,2015,41,48
157,080327,Caldes d'Estrac,75,2015,286,211
158,170335,Caldes de Malavella,35,2015,453,418
159,080333,Caldes de Montbui,108,2015,795,687
160,080351,Calella,220,2015,1350,1130
161,080370,Calldetenes,-15,2015,94,109
162,080386,Callús,31,2015,128,97
163,080364,Calonge de Segarra,-5,2015,3,8
164,170340,Calonge i Sant Antoni,191,2015,856,665
165,250621,Camarasa,-11,2015,32,43
166,439039,Camarles,40,2015,144,104
167,430385,Cambrils,329,2015,2261,1932
168,170353,Camós,2,2015,24,22
169,170366,Campdevànol,-2,2015,94,96
170,170372,Campelles,10,2015,12,2
171,080399,Campins,-18,2015,27,45
172,170388,Campllong,14,2015,35,21
173,170391,Camprodon,-41,2015,112,153
174,250637,Canejan,-2,2015,0,2
175,170405,Canet d'Adri,30,2015,66,36
176,080403,Canet de Mar,143,2015,757,614
177,439076,"Canonja, la",-4,2015,286,290
178,080410,Canovelles,37,2015,1149,1112
179,080425,Cànoves i Samalús,-36,2015,162,198
180,170412,Cantallops,-4,2015,22,26
181,080431,Canyelles,21,2015,315,294
182,430398,Capafonts,-1,2015,1,2
183,430402,Capçanes,-11,2015,2,13
184,080446,Capellades,-24,2015,237,261
185,170427,Capmany,27,2015,53,26
186,080459,Capolat,-1,2015,1,2
187,080462,Cardedeu,175,2015,931,756
188,080478,Cardona,-65,2015,98,163
189,080484,Carme,2,2015,48,46
190,430419,Caseres,-1,2015,8,9
191,170448,Cassà de la Selva,-8,2015,460,468
192,080497,Casserres,-2,2015,56,58
193,080575,Castell de l'Areny,-1,2015,3,4
194,259046,Castell de Mur,-11,2015,5,16
195,250642,Castellar de la Ribera,-6,2015,4,10
196,080522,Castellar de n'Hug,2,2015,6,4
197,080500,Castellar del Riu,2,2015,8,6
198,080517,Castellar del Vallès,198,2015,1003,805
199,080538,Castellbell i el Vilar,-4,2015,216,220
200,080543,Castellbisbal,-79,2015,483,562
201,080556,Castellcir,33,2015,54,21
202,250674,Castelldans,-3,2015,37,40
203,080569,Castelldefels,826,2015,4674,3848
204,080581,Castellet i la Gornal,-19,2015,150,169
205,170464,Castellfollit de la Roca,-22,2015,47,69
206,080608,Castellfollit de Riubregós,-2,2015,6,8
207,080594,Castellfollit del Boix,15,2015,26,11
208,080615,Castellgalí,-3,2015,161,164
209,080620,Castellnou de Bages,13,2015,63,50
210,250680,Castellnou de Seana,17,2015,43,26
211,170470,Castelló d'Empúries,-93,2015,833,926
212,250693,Castelló de Farfanya,13,2015,37,24
213,080636,Castellolí,-5,2015,18,23
214,170486,Castell-Platja d'Aro,-5,2015,965,970
215,250707,Castellserà,-1,2015,27,28
216,080641,Castellterçol,-4,2015,144,148
217,430424,Castellvell del Camp,-55,2015,110,165
218,080654,Castellví de la Marca,4,2015,63,59
219,080667,Castellví de Rosanes,41,2015,149,108
220,430430,"Catllar, el",1,2015,250,249
221,250714,Cava,-3,2015,4,7
222,171899,"Cellera de Ter, la",-26,2015,59,85
223,170499,Celrà,93,2015,344,251
224,080673,Centelles,39,2015,336,297
225,082687,Cercs,-19,2015,42,61
226,082665,Cerdanyola del Vallès,223,2015,3002,2779
227,080689,Cervelló,-2,2015,501,503
228,250729,Cervera,-41,2015,366,407
229,250735,Cervià de les Garrigues,-2,2015,28,30
230,170502,Cervià de Ter,-14,2015,35,49
231,170519,Cistella,-8,2015,30,38
232,250740,Ciutadilla,-12,2015,10,22
233,250753,Clariana de Cardener,-2,2015,5,7
234,250766,"Cogul, el",-5,2015,14,19
235,170545,Colera,-3,2015,36,39
236,250772,Coll de Nargó,3,2015,24,21
237,080692,Collbató,-1,2015,235,236
238,430458,Colldejou,-1,2015,6,7
239,080706,Collsuspina,6,2015,18,12
240,170558,Colomers,0,2015,10,10
241,251636,"Coma i la Pedra, la",-7,2015,6,13
242,251615,Conca de Dalt,-5,2015,20,25
243,430461,Conesa,-4,2015,5,9
244,430477,Constantí,-126,2015,361,487
245,080713,Copons,-6,2015,15,21
246,430483,Corbera d'Ebre,-40,2015,29,69
247,080728,Corbera de Llobregat,15,2015,711,696
248,250788,Corbins,10,2015,69,59
249,170577,Corçà,11,2015,83,72
250,080734,Cornellà de Llobregat,-90,2015,4667,4757
251,170561,Cornellà del Terri,54,2015,139,85
252,430496,Cornudella de Montsant,-8,2015,47,55
253,430509,Creixell,-80,2015,291,371
254,170583,Crespià,7,2015,22,15
255,179011,"Cruïlles, Monells i Sant Sadurní de l'Heura",-8,2015,71,79
256,080749,Cubelles,114,2015,1079,965
257,250791,Cubells,0,2015,25,25
258,430516,Cunit,16,2015,1114,1098
259,170600,Darnius,0,2015,38,38
260,170617,Das,-4,2015,6,10
261,439018,Deltebre,1,2015,399,398
262,080752,Dosrius,-60,2015,310,370
263,430537,Duesaigües,7,2015,21,14
264,170622,"Escala, l'",-11,2015,509,520
265,080765,Esparreguera,9,2015,962,953
266,170638,Espinelves,11,2015,23,12
267,250812,"Espluga Calba, l'",1,2015,8,7
268,430542,"Espluga de Francolí, l'",8,2015,139,131
269,080771,Esplugues de Llobregat,241,2015,2854,2613
270,170643,Espolla,12,2015,33,21
271,170656,Esponellà,11,2015,28,17
272,250827,Espot,0,2015,11,11
273,080787,"Espunyola, l'",0,2015,10,10
274,082541,"Esquirol, l'",32,2015,98,66
275,250886,Estamariu,-2,2015,5,7
276,080790,"Estany, l'",10,2015,22,12
277,250851,Estaràs,-15,2015,3,18
278,250864,Esterri d'Àneu,-11,2015,32,43
279,250870,Esterri de Cardós,-4,2015,2,6
280,430555,Falset,-44,2015,87,131
281,170059,"Far d'Empordà, el",-1,2015,19,20
282,250899,Farrera,4,2015,9,5
283,430568,"Fatarella, la",-10,2015,20,30
284,430574,"Febró, la",1,2015,4,3
285,081347,Figaró-Montmany,15,2015,101,86
286,080804,Fígols,-2,2015,3,5
287,259084,Fígols i Alinyà,-3,2015,8,11
288,430580,"Figuera, la",-9,2015,4,13
289,170669,Figueres,185,2015,2915,2730
290,430593,Figuerola del Camp,-9,2015,11,20
291,170675,Flaçà,-38,2015,52,90
292,430607,Flix,-92,2015,144,236
293,250925,"Floresta, la",-3,2015,5,8
294,080826,Fogars de la Selva,-20,2015,87,107
295,080811,Fogars de Montclús,-15,2015,22,37
296,170681,Foixà,6,2015,14,8
297,080832,Folgueroles,16,2015,77,61
298,250931,Fondarella,-31,2015,28,59
299,080847,Fonollosa,12,2015,59,47
300,170694,Fontanals de Cerdanya,-8,2015,28,36
301,170708,Fontanilles,1,2015,8,7
302,170715,Fontcoberta,18,2015,70,52
303,080850,Font-rubí,9,2015,78,69
304,250946,Foradada,-5,2015,7,12
305,179026,Forallac,29,2015,137,108
306,430614,Forès,-2,2015,1,3
307,170736,Fornells de la Selva,-6,2015,133,139
308,170741,Fortià,3,2015,49,46
309,080863,"Franqueses del Vallès, les",-103,2015,1135,1238
310,430629,Freginals,14,2015,27,13
311,250962,"Fuliola, la",-11,2015,50,61
312,250978,Fulleda,-4,2015,4,8
313,080902,Gaià,-6,2015,3,9
314,430635,"Galera, la",-4,2015,25,29
315,080879,Gallifa,-6,2015,6,12
316,430640,Gandesa,28,2015,118,90
317,430653,Garcia,21,2015,44,23
318,430666,"Garidells, els",6,2015,15,9
319,080885,"Garriga, la",164,2015,754,590
320,170754,Garrigàs,18,2015,47,29
321,170767,Garrigoles,3,2015,8,5
322,170773,Garriguella,6,2015,49,43
323,080898,Gavà,-192,2015,2410,2602
324,250984,Gavet de la Conca,12,2015,19,7
325,080919,Gelida,-29,2015,411,440
326,170789,Ger,2,2015,22,20
327,259123,Gimenells i el Pla de la Font,-23,2015,35,58
328,430672,Ginestar,-21,2015,11,32
329,170792,Girona,167,2015,6178,6011
330,080924,Gironella,-89,2015,154,243
331,080930,Gisclareny,2,2015,2,0
332,430688,Godall,2,2015,15,13
333,250997,Golmés,66,2015,123,57
334,170806,Gombrèn,-4,2015,7,11
335,251001,Gósol,2,2015,25,23
336,080945,"Granada, la",2,2015,152,150
337,251018,"Granadella, la",6,2015,31,25
338,080958,Granera,0,2015,6,6
339,251023,"Granja d'Escarp, la",-20,2015,38,58
340,080961,Granollers,238,2015,3874,3636
341,251039,Granyanella,10,2015,12,2
342,251057,Granyena de les Garrigues,-1,2015,18,19
343,251044,Granyena de Segarra,8,2015,11,3
344,430691,Gratallops,2,2015,6,4
345,080977,Gualba,-2,2015,111,113
346,170813,Gualta,6,2015,59,53
347,080996,Guardiola de Berguedà,-31,2015,42,73
348,430705,"Guiamets, els",1,2015,15,14
349,170828,Guils de Cerdanya,11,2015,47,36
350,251095,Guimerà,2,2015,18,16
351,259031,"Guingueta d'Àneu, la",-7,2015,7,14
352,251109,Guissona,-22,2015,359,381
353,251116,Guixers,6,2015,11,5
354,081000,Gurb,18,2015,121,103
355,430712,Horta de Sant Joan,-22,2015,35,57
356,081017,"Hospitalet de Llobregat, l'",3708,2015,20195,16487
357,081629,"Hostalets de Pierola, els",-3,2015,229,232
358,170834,Hostalric,39,2015,306,267
359,081022,Igualada,344,2015,1989,1645
360,251155,Isona i Conca Dellà,-2,2015,56,58
361,170849,Isòvol,-1,2015,14,15
362,251137,Ivars d'Urgell,-4,2015,78,82
363,251121,Ivars de Noguera,5,2015,20,15
364,251142,Ivorra,9,2015,11,2
365,170852,Jafre,-29,2015,20,49
366,170865,"Jonquera, la",18,2015,312,294
367,081038,Jorba,-5,2015,35,40
368,259101,Josa i Tuixén,-6,2015,8,14
369,170871,Juià,-2,2015,50,52
370,251180,Juncosa,5,2015,16,11
371,251193,Juneda,29,2015,177,148
372,251214,Les,-7,2015,58,65
373,251229,Linyola,14,2015,131,117
374,081043,"Llacuna, la",3,2015,56,53
375,170887,Lladó,-22,2015,39,61
376,251235,Lladorre,1,2015,4,3
377,251240,Lladurs,-4,2015,7,11
378,081056,"Llagosta, la",-10,2015,632,642
379,170890,Llagostera,2,2015,459,457
380,170904,Llambilles,-8,2015,34,42
381,170911,Llanars,2,2015,31,29
382,170926,Llançà,67,2015,295,228
383,251253,Llardecans,-11,2015,7,18
384,251266,Llavorsí,4,2015,19,15
385,251207,Lleida,-639,2015,6296,6935
386,170932,Llers,6,2015,92,86
387,251272,Lles de Cerdanya,-6,2015,16,22
388,081075,Lliçà d'Amunt,26,2015,772,746
389,081081,Lliçà de Vall,9,2015,319,310
390,251288,Llimiana,-5,2015,6,11
391,081069,Llinars del Vallès,110,2015,617,507
392,170947,Llívia,24,2015,101,77
393,430727,"Lloar, el",1,2015,3,2
394,251291,Llobera,0,2015,4,4
395,430733,Llorac,-10,2015,6,16
396,430748,Llorenç del Penedès,21,2015,128,107
397,170950,Lloret de Mar,-532,2015,2517,3049
398,170963,"Llosses, les",-11,2015,9,20
399,081094,Lluçà,-1,2015,20,21
400,171024,Maçanet de Cabrenys,-8,2015,45,53
401,171030,Maçanet de la Selva,13,2015,445,432
402,170979,Madremanya,3,2015,13,10
403,170985,Maià de Montcal,-14,2015,25,39
404,251333,Maials,12,2015,32,20
405,251305,Maldà,4,2015,9,5
406,081108,Malgrat de Mar,2,2015,1020,1018
407,081115,Malla,5,2015,17,12
408,081120,Manlleu,-108,2015,808,916
409,081136,Manresa,273,2015,3375,3102
410,430764,Marçà,-7,2015,39,46
411,430751,Margalef,-4,2015,11,15
412,082423,Marganell,-6,2015,17,23
413,081141,Martorell,4,2015,1327,1323
414,081154,Martorelles,-11,2015,232,243
415,430770,Mas de Barberans,1,2015,15,14
416,171002,Masarac,-10,2015,26,36
417,430786,Masdenverge,-7,2015,47,54
418,081167,"Masies de Roda, les",4,2015,32,28
419,081173,"Masies de Voltregà, les",-6,2015,90,96
420,430799,Masllorenç,9,2015,41,32
421,081189,"Masnou, el",254,2015,1326,1072
422,430803,"Masó, la",2,2015,9,7
423,430810,Maspujols,-10,2015,45,55
424,081192,Masquefa,30,2015,469,439
425,430825,"Masroig, el",-28,2015,10,38
426,251312,Massalcoreig,5,2015,38,33
427,171019,Massanes,14,2015,55,41
428,251327,Massoteres,19,2015,26,7
429,081206,Matadepera,83,2015,467,384
430,081213,Mataró,393,2015,5225,4832
431,171045,Medinyà,0,2015,0,0
432,081228,Mediona,36,2015,177,141
433,251348,Menàrguens,4,2015,49,45
434,170998,Meranges,0,2015,10,10
435,171058,Mieres,-17,2015,18,35
436,430831,"Milà, el",1,2015,13,12
437,251351,Miralcamp,-22,2015,45,67
438,430846,Miravet,-13,2015,32,45
439,081385,Moià,88,2015,345,257
440,430859,"Molar, el",-6,2015,10,16
441,081234,Molins de Rei,66,2015,1010,944
442,251370,Mollerussa,58,2015,774,716
443,171061,Mollet de Peralada,1,2015,11,10
444,081249,Mollet del Vallès,-59,2015,2456,2515
445,171077,Molló,1,2015,19,18
446,251364,"Molsosa, la",0,2015,1,1
447,081287,Monistrol de Calders,5,2015,44,39
448,081271,Monistrol de Montserrat,-10,2015,197,207
449,171096,Montagut i Oix,-17,2015,37,54
450,430862,Montblanc,56,2015,315,259
451,430884,Montbrió del Camp,65,2015,233,168
452,081252,Montcada i Reixac,368,2015,1944,1576
453,081304,Montclar,-1,2015,3,4
454,251399,Montellà i Martinet,-27,2015,19,46
455,081311,Montesquiu,-3,2015,56,59
456,251403,Montferrer i Castellbò,8,2015,75,67
457,430897,Montferri,22,2015,53,31
458,251386,Montgai,-2,2015,13,15
459,081265,Montgat,48,2015,655,607
460,081326,Montmajor,-3,2015,12,15
461,081332,Montmaneu,0,2015,7,7
462,430901,"Montmell, el",20,2015,126,106
463,081350,Montmeló,-46,2015,350,396
464,251425,Montoliu de Lleida,-15,2015,34,49
465,251410,Montoliu de Segarra,-3,2015,8,11
466,251431,Montornès de Segarra,-2,2015,1,3
467,081363,Montornès del Vallès,12,2015,789,777
468,430918,Mont-ral,-11,2015,11,22
469,171100,Mont-ras,-20,2015,95,115
470,430923,Mont-roig del Camp,-325,2015,905,1230
471,081379,Montseny,-1,2015,19,20
472,430939,Móra d'Ebre,112,2015,340,228
473,430944,Móra la Nova,-43,2015,135,178
474,430957,"Morell, el",-1,2015,247,248
475,430960,"Morera de Montsant, la",10,2015,22,12
476,081290,Muntanyola,-1,2015,15,16
477,081398,Mura,11,2015,26,15
478,251459,Nalec,5,2015,8,3
479,250254,Naut Aran,-1,2015,93,94
480,081402,Navarcles,2,2015,244,242
481,081419,Navàs,-41,2015,176,217
482,171117,Navata,19,2015,99,80
483,251462,Navès,-2,2015,9,11
484,081424,"Nou de Berguedà, la",-1,2015,7,8
485,430976,"Nou de Gaià, la",7,2015,40,33
486,430982,Nulles,0,2015,34,34
487,251484,Odèn,6,2015,9,3
488,081430,Òdena,-5,2015,198,203
489,171122,Ogassa,-5,2015,8,13
490,081458,Olèrdola,16,2015,212,196
491,081461,Olesa de Bonesvalls,20,2015,122,102
492,081477,Olesa de Montserrat,29,2015,1033,1004
493,251497,Oliana,9,2015,90,81
494,251500,Oliola,-11,2015,5,16
495,251517,Olius,15,2015,51,36
496,081483,Olivella,-28,2015,326,354
497,081496,Olost,12,2015,51,39
498,171143,Olot,88,2015,1480,1392
499,251522,"Oluges, les",-5,2015,2,7
500,081445,Olvan,1,2015,37,36
501,251538,"Omellons, els",-7,2015,2,9
502,251543,"Omells de na Gaia, els",2,2015,6,4
503,171156,Ordis,-6,2015,9,15
504,251556,Organyà,-25,2015,37,62
505,081509,Orís,-1,2015,15,16
506,081516,Oristà,-12,2015,14,26
507,081521,Orpí,-2,2015,4,6
508,081537,Òrrius,3,2015,40,37
509,251569,Os de Balaguer,29,2015,71,42
510,171169,Osor,12,2015,25,13
511,251575,Ossó de Sió,0,2015,9,9
512,081542,Pacs del Penedès,-2,2015,46,48
513,081555,Palafolls,12,2015,502,490
514,171175,Palafrugell,131,2015,1157,1026
515,171181,Palamós,-100,2015,964,1064
516,251581,"Palau d'Anglesola, el",27,2015,97,70
517,171194,Palau de Santa Eulàlia,-2,2015,5,7
518,171215,Palau-sator,3,2015,19,16
519,171208,Palau-saverdera,-21,2015,119,140
520,081568,Palau-solità i Plegamans,50,2015,639,589
521,431009,"Pallaresos, els",60,2015,246,186
522,081574,Pallejà,51,2015,526,475
523,430995,"Palma d'Ebre, la",-5,2015,8,13
524,089058,"Palma de Cervelló, la",39,2015,213,174
525,171236,Palol de Revardit,4,2015,22,18
526,171241,Pals,-47,2015,145,192
527,081580,"Papiol, el",-24,2015,177,201
528,171254,Pardines,5,2015,10,5
529,081593,Parets del Vallès,-119,2015,848,967
530,171267,Parlavà,-3,2015,7,10
531,431016,Passanant i Belltall,-11,2015,5,16
532,171289,Pau,5,2015,34,29
533,431021,Paüls,0,2015,9,9
534,171292,Pedret i Marzà,-11,2015,8,19
535,251641,Penelles,1,2015,22,21
536,171306,"Pera, la",3,2015,30,27
537,081607,Perafita,2,2015,12,10
538,431037,Perafort,-31,2015,66,97
539,171328,Peralada,4,2015,136,132
540,251654,Peramola,6,2015,14,8
541,431042,"Perelló, el",-1,2015,153,154
542,081614,Piera,33,2015,844,811
543,431055,"Piles, les",-3,2015,4,7
544,081635,Pineda de Mar,293,2015,1708,1415
545,431068,"Pinell de Brai, el",-38,2015,16,54
546,251667,Pinell de Solsonès,5,2015,12,7
547,251673,Pinós,-11,2015,6,17
548,431074,Pira,7,2015,25,18
549,431080,"Pla de Santa Maria, el",-36,2015,84,120
550,081640,"Pla del Penedès, el",17,2015,91,74
551,171334,"Planes d'Hostoles, les",3,2015,60,57
552,171349,Planoles,3,2015,16,13
553,259118,"Plans de Sió, els",1,2015,20,19
554,251689,"Poal, el",-15,2015,17,32
555,251692,"Pobla de Cérvoles, la",-10,2015,4,14
556,081653,"Pobla de Claramunt, la",9,2015,123,114
557,081666,"Pobla de Lillet, la",-14,2015,41,55
558,431093,"Pobla de Mafumet, la",50,2015,345,295
559,431107,"Pobla de Massaluca, la",2,2015,12,10
560,431114,"Pobla de Montornès, la",-48,2015,193,241
561,251713,"Pobla de Segur, la",-17,2015,159,176
562,431129,Poboleda,10,2015,19,9
563,081672,Polinyà,23,2015,379,356
564,431135,"Pont d'Armentera, el",-22,2015,17,39
565,250306,"Pont de Bar, el",7,2015,14,7
566,171352,Pont de Molins,4,2015,29,25
567,251734,"Pont de Suert, el",-31,2015,92,123
568,081825,"Pont de Vilomara i Rocafort, el",-11,2015,140,151
569,431418,Pontils,-2,2015,9,11
570,081688,Pontons,-21,2015,53,74
571,171365,Pontós,2,2015,13,11
572,251728,Ponts,16,2015,159,143
573,171371,Porqueres,9,2015,167,158
574,431140,Porrera,2,2015,13,11
575,171404,"Port de la Selva, el",-9,2015,52,61
576,171387,Portbou,15,2015,67,52
577,251749,"Portella, la",7,2015,39,32
578,431153,Pradell de la Teixeta,-5,2015,5,10
579,431166,Prades,-22,2015,21,43
580,431172,Prat de Comte,4,2015,12,8
581,081691,"Prat de Llobregat, el",371,2015,2566,2195
582,431188,Pratdip,-111,2015,47,158
583,081712,Prats de Lluçanès,0,2015,85,85
584,081705,"Prats de Rei, els",4,2015,26,22
585,251752,Prats i Sansor,-12,2015,12,24
586,251765,Preixana,-21,2015,7,28
587,251771,Preixens,-7,2015,14,21
588,082303,Premià de Dalt,-48,2015,588,636
589,081727,Premià de Mar,-20,2015,1431,1451
590,171390,"Preses, les",11,2015,79,68
591,251790,Prullans,3,2015,19,16
592,171411,Puigcerdà,109,2015,564,455
593,081748,Puigdàlber,-23,2015,28,51
594,251804,Puiggròs,-5,2015,8,13
595,431191,Puigpelat,5,2015,75,70
596,081751,Puig-reig,3,2015,158,155
597,251811,Puigverd d'Agramunt,-14,2015,8,22
598,251826,Puigverd de Lleida,-41,2015,48,89
599,081764,Pujalt,2,2015,4,2
600,081770,"Quar, la",2,2015,4,2
601,171426,Quart,14,2015,193,179
602,170433,Queralbs,3,2015,8,5
603,431205,Querol,-15,2015,50,65
604,171432,Rabós,-1,2015,9,10
605,081786,Rajadell,8,2015,30,22
606,431212,Rasquera,-67,2015,27,94
607,171447,Regencós,-3,2015,8,11
608,081799,Rellinars,-23,2015,31,54
609,431227,Renau,-1,2015,8,9
610,431233,Reus,531,2015,4372,3841
611,251832,Rialp,5,2015,32,27
612,431248,"Riba, la",-13,2015,21,34
613,431251,Riba-roja d'Ebre,-32,2015,46,78
614,259059,Ribera d'Ondara,8,2015,33,25
615,251850,Ribera d'Urgellet,-10,2015,71,81
616,171450,Ribes de Freser,-2,2015,76,78
617,171463,Riells i Viabrea,-11,2015,292,303
618,431264,"Riera de Gaià, la",-7,2015,76,83
619,251863,Riner,-5,2015,8,13
620,171479,Ripoll,-27,2015,321,348
621,081803,Ripollet,64,2015,1951,1887
622,259139,Riu de Cerdanya,-6,2015,1,7
623,171485,Riudarenes,-4,2015,133,137
624,171498,Riudaura,6,2015,22,16
625,431270,Riudecanyes,-52,2015,54,106
626,431286,Riudecols,-51,2015,53,104
627,171501,Riudellots de la Selva,-1,2015,136,137
628,431299,Riudoms,6,2015,249,243
629,171518,Riumors,14,2015,22,8
630,081810,"Roca del Vallès, la",74,2015,573,499
631,431303,Rocafort de Queralt,4,2015,14,10
632,431310,Roda de Berà,78,2015,565,487
633,081831,Roda de Ter,5,2015,271,266
634,431325,Rodonyà,-8,2015,35,43
635,431331,Roquetes,-53,2015,361,414
636,171523,Roses,-154,2015,1101,1255
637,251898,Rosselló,-37,2015,170,207
638,431346,"Rourell, el",-2,2015,24,26
639,081846,Rubí,287,2015,3399,3112
640,081859,Rubió,3,2015,10,7
641,171539,Rupià,4,2015,17,13
642,089019,Rupit i Pruit,-1,2015,8,9
643,081878,Sabadell,658,2015,8688,8030
644,081884,Sagàs,-1,2015,9,10
645,251902,Salàs de Pallars,-15,2015,8,23
646,081901,Saldes,-15,2015,10,25
647,171544,Sales de Llierca,-2,2015,6,8
648,081918,Sallent,-36,2015,169,205
649,431359,Salomó,-5,2015,23,28
650,439057,Salou,-69,2015,2232,2301
651,171557,Salt,-261,2015,2133,2394
652,251919,Sanaüja,-1,2015,20,21
653,081944,Sant Adrià de Besòs,774,2015,3171,2397
654,081957,Sant Agustí de Lluçanès,3,2015,7,4
655,081960,Sant Andreu de la Barca,68,2015,1337,1269
656,081976,Sant Andreu de Llavaneres,195,2015,777,582
657,171576,Sant Andreu Salou,5,2015,5,0
658,171833,Sant Aniol de Finestres,-3,2015,24,27
659,081982,Sant Antoni de Vilamajor,58,2015,428,370
660,081995,Sant Bartomeu del Grau,-13,2015,43,56
661,082009,Sant Boi de Llobregat,56,2015,3256,3200
662,082016,Sant Boi de Lluçanès,0,2015,34,34
663,431362,Sant Carles de la Ràpita,39,2015,735,696
664,082037,Sant Cebrià de Vallalta,0,2015,242,242
665,082021,Sant Celoni,175,2015,1011,836
666,082042,Sant Climent de Llobregat,-8,2015,153,161
667,171582,Sant Climent Sescebes,40,2015,100,60
668,082055,Sant Cugat del Vallès,1232,2015,5297,4065
669,082068,Sant Cugat Sesgarrigues,9,2015,50,41
670,251961,Sant Esteve de la Sarga,-6,2015,2,8
671,082074,Sant Esteve de Palautordera,25,2015,179,154
672,082080,Sant Esteve Sesrovires,39,2015,429,390
673,171595,Sant Feliu de Buixalleu,12,2015,68,56
674,082107,Sant Feliu de Codines,84,2015,461,377
675,171609,Sant Feliu de Guíxols,152,2015,1338,1186
676,082114,Sant Feliu de Llobregat,197,2015,1835,1638
677,171616,Sant Feliu de Pallerols,-3,2015,68,71
678,082129,Sant Feliu Sasserra,-20,2015,17,37
679,171621,Sant Ferriol,-3,2015,29,32
680,082093,Sant Fost de Campsentelles,102,2015,549,447
681,082135,Sant Fruitós de Bages,-7,2015,348,355
682,171637,Sant Gregori,62,2015,177,115
683,251924,Sant Guim de Freixenet,-11,2015,39,50
684,251977,Sant Guim de la Plana,-5,2015,10,15
685,171642,Sant Hilari Sacalm,0,2015,228,228
686,082153,Sant Hipòlit de Voltregà,34,2015,191,157
687,081939,Sant Iscle de Vallalta,-17,2015,63,80
688,439023,Sant Jaume d'Enveja,-28,2015,152,180
689,082166,Sant Jaume de Frontanyà,1,2015,3,2
690,171655,Sant Jaume de Llierca,34,2015,78,44
691,431378,Sant Jaume dels Domenys,18,2015,183,165
692,171674,Sant Joan de les Abadesses,-6,2015,93,99
693,171680,Sant Joan de Mollet,-1,2015,30,31
694,082188,Sant Joan de Vilatorrada,8,2015,392,384
695,082172,Sant Joan Despí,149,2015,1717,1568
696,171851,Sant Joan les Fonts,-10,2015,135,145
697,171668,Sant Jordi Desvalls,-11,2015,38,49
698,089030,Sant Julià de Cerdanyola,6,2015,10,4
699,171693,Sant Julià de Ramis,28,2015,242,214
700,082205,Sant Julià de Vilatorta,2,2015,115,113
701,179032,Sant Julià del Llor i Bonmatí,2,2015,87,85
702,082212,Sant Just Desvern,184,2015,1159,975
703,082227,Sant Llorenç d'Hortons,10,2015,143,133
704,171714,Sant Llorenç de la Muga,-9,2015,18,27
705,251930,Sant Llorenç de Morunys,13,2015,41,28
706,082233,Sant Llorenç Savall,2,2015,92,90
707,082251,Sant Martí d'Albars,-3,2015,3,6
708,082248,Sant Martí de Centelles,17,2015,127,110
709,171729,Sant Martí de Llémena,15,2015,40,25
710,259025,Sant Martí de Riucorb,0,2015,27,27
711,082264,Sant Martí de Tous,5,2015,43,38
712,082270,Sant Martí Sarroca,6,2015,161,155
713,082286,Sant Martí Sesgueioles,-1,2015,14,15
714,171735,Sant Martí Vell,2,2015,12,10
715,082299,Sant Mateu de Bages,7,2015,23,16
716,171740,Sant Miquel de Campmajor,8,2015,17,9
717,171753,Sant Miquel de Fluvià,-2,2015,43,45
718,171766,Sant Mori,5,2015,17,12
719,171772,Sant Pau de Segúries,-8,2015,33,41
720,082310,Sant Pere de Ribes,138,2015,1795,1657
721,082325,Sant Pere de Riudebitlles,6,2015,101,95
722,082331,Sant Pere de Torelló,14,2015,124,110
723,082346,Sant Pere de Vilamajor,-31,2015,268,299
724,171788,Sant Pere Pescador,-23,2015,130,153
725,081897,Sant Pere Sallavinera,-7,2015,2,9
726,082359,Sant Pol de Mar,-119,2015,302,421
727,082362,Sant Quintí de Mediona,8,2015,99,91
728,082378,Sant Quirze de Besora,4,2015,76,72
729,082384,Sant Quirze del Vallès,-44,2015,862,906
730,082397,Sant Quirze Safaja,13,2015,62,49
731,251945,Sant Ramon,16,2015,26,10
732,082401,Sant Sadurní d'Anoia,-30,2015,476,506
733,082418,Sant Sadurní d'Osormort,-4,2015,5,9
734,080983,Sant Salvador de Guardiola,35,2015,200,165
735,082628,Sant Vicenç de Castellet,-9,2015,467,476
736,082649,Sant Vicenç de Montalt,167,2015,587,420
737,082652,Sant Vicenç de Torelló,3,2015,84,81
738,082634,Sant Vicenç dels Horts,-13,2015,1102,1115
739,431384,Santa Bàrbara,55,2015,224,169
740,082439,Santa Cecília de Voltregà,5,2015,5,0
741,082444,Santa Coloma de Cervelló,50,2015,353,303
742,171805,Santa Coloma de Farners,-19,2015,545,564
743,082457,Santa Coloma de Gramenet,145,2015,8297,8152
744,431397,Santa Coloma de Queralt,-77,2015,71,148
745,171812,Santa Cristina d'Aro,48,2015,370,322
746,082460,Santa Eugènia de Berga,53,2015,174,121
747,082476,Santa Eulàlia de Riuprimer,-23,2015,58,81
748,082482,Santa Eulàlia de Ronçana,-5,2015,390,395
749,082495,Santa Fe del Penedès,-3,2015,9,12
750,171827,Santa Llogaia d'Àlguema,-5,2015,18,23
751,082508,Santa Margarida de Montbui,10,2015,489,479
752,082515,Santa Margarida i els Monjos,6,2015,441,435
753,082589,Santa Maria d'Oló,-1,2015,27,28
754,082536,Santa Maria de Besora,-7,2015,5,12
755,082567,Santa Maria de Martorelles,7,2015,46,39
756,082554,Santa Maria de Merlès,-9,2015,10,19
757,082573,Santa Maria de Miralles,5,2015,7,2
758,082592,Santa Maria de Palautordera,78,2015,515,437
759,431401,Santa Oliva,-69,2015,225,294
760,171848,Santa Pau,-38,2015,42,80
761,082606,Santa Perpètua de Mogoda,22,2015,1228,1206
762,082613,Santa Susanna,55,2015,315,260
763,081923,Santpedor,70,2015,302,232
764,431423,Sarral,-8,2015,55,63
765,171864,Sarrià de Ter,58,2015,327,269
766,252017,Sarroca de Bellera,-6,2015,3,9
767,252000,Sarroca de Lleida,-8,2015,11,19
768,171870,"Saus, Camallera i Llampaies",13,2015,41,28
769,431439,Savallà del Comtat,-3,2015,2,5
770,431444,"Secuita, la",19,2015,115,96
771,171886,"Selva de Mar, la",4,2015,14,10
772,431457,"Selva del Camp, la",19,2015,261,242
773,431460,Senan,4,2015,5,1
774,430445,"Sénia, la",-21,2015,259,280
775,252022,Senterada,0,2015,8,8
776,250352,"Sentiu de Sió, la",5,2015,22,17
777,082671,Sentmenat,-3,2015,444,447
778,171903,Serinyà,11,2015,53,42
779,252043,Seròs,19,2015,108,89
780,171910,Serra de Daró,-1,2015,10,11
781,171925,Setcases,3,2015,12,9
782,252038,"Seu d'Urgell, la",-4,2015,586,590
783,082690,Seva,11,2015,176,165
784,252056,Sidamon,9,2015,39,30
785,171931,Sils,118,2015,431,313
786,082704,Sitges,124,2015,2340,2216
787,170524,Siurana,-1,2015,8,9
788,082711,Sobremunt,3,2015,7,4
789,252069,"Soleràs, el",9,2015,18,9
790,431476,Solivella,-11,2015,35,46
791,252075,Solsona,-23,2015,581,604
792,082726,Sora,7,2015,12,5
793,252081,Soriguera,22,2015,43,21
794,252094,Sort,-59,2015,107,166
795,252108,Soses,-24,2015,67,91
796,082732,Subirats,28,2015,157,129
797,252115,Sudanell,22,2015,44,22
798,252120,Sunyer,25,2015,36,11
799,082747,Súria,-2,2015,158,160
800,171946,Susqueda,3,2015,10,7
801,082763,Tagamanent,-6,2015,16,22
802,082779,Talamanca,-3,2015,17,20
803,252154,Talarn,108,2015,351,243
804,252167,Talavera,-2,2015,9,11
805,171959,"Tallada d'Empordà, la",1,2015,23,22
806,082785,Taradell,72,2015,269,197
807,431482,Tarragona,253,2015,6011,5758
808,252173,Tàrrega,49,2015,835,786
809,252189,Tarrés,-1,2015,3,4
810,252192,Tarroja de Segarra,5,2015,14,9
811,082750,Tavèrnoles,1,2015,17,16
812,082802,Tavertet,-12,2015,1,13
813,082819,Teià,41,2015,366,325
814,252206,Térmens,5,2015,77,72
815,171962,Terrades,-1,2015,24,25
816,082798,Terrassa,108,2015,8596,8488
817,082824,Tiana,123,2015,459,336
818,252213,Tírvia,-8,2015,3,11
819,252228,Tiurana,1,2015,2,1
820,431495,Tivenys,-8,2015,22,30
821,431508,Tivissa,-22,2015,53,75
822,082830,Tona,-39,2015,309,348
823,252234,Torà,-12,2015,58,70
824,082845,Tordera,42,2015,1045,1003
825,082858,Torelló,9,2015,612,603
826,252249,"Torms, els",2,2015,5,3
827,252252,Tornabous,1,2015,55,54
828,252271,"Torre de Cabdella, la",0,2015,28,28
829,082861,"Torre de Claramunt, la",-47,2015,161,208
830,431515,"Torre de Fontaubella, la",8,2015,25,17
831,431520,"Torre de l'Espanyol, la",7,2015,30,23
832,252265,Torrebesses,13,2015,17,4
833,431536,Torredembarra,62,2015,1047,985
834,252287,Torrefarrera,38,2015,282,244
835,259078,Torrefeta i Florejacs,-4,2015,29,33
836,252304,Torregrossa,-62,2015,35,97
837,252311,Torrelameu,0,2015,31,31
838,082877,Torrelavit,16,2015,72,56
839,082883,Torrelles de Foix,-23,2015,157,180
840,082896,Torrelles de Llobregat,27,2015,299,272
841,171978,Torrent,-6,2015,3,9
842,252326,Torres de Segre,3,2015,226,223
843,252332,Torre-serona,10,2015,29,19
844,171984,Torroella de Fluvià,-8,2015,59,67
845,171997,Torroella de Montgrí,104,2015,648,544
846,431541,Torroja del Priorat,-2,2015,2,4
847,172001,Tortellà,9,2015,55,46
848,431554,Tortosa,-25,2015,1413,1438
849,172018,Toses,11,2015,28,17
850,172023,Tossa de Mar,-212,2015,269,481
851,252347,Tremp,-136,2015,395,531
852,172044,Ullà,0,2015,101,101
853,082900,Ullastrell,-12,2015,93,105
854,172057,Ullastret,-6,2015,10,16
855,431567,Ulldecona,-119,2015,335,454
856,431573,Ulldemolins,0,2015,15,15
857,172039,Ultramort,6,2015,14,8
858,172060,Urús,5,2015,14,9
859,082917,Vacarisses,26,2015,400,374
860,170144,"Vajol, la",-4,2015,5,9
861,172076,"Vall d'en Bas, la",27,2015,113,86
862,172082,"Vall de Bianya, la",-14,2015,60,74
863,250432,"Vall de Boí, la",8,2015,70,62
864,259010,Vall de Cardós,-11,2015,17,28
865,082922,Vallbona d'Anoia,-5,2015,69,74
866,252385,Vallbona de les Monges,-7,2015,11,18
867,082938,Vallcebre,2,2015,15,13
868,431589,Vallclara,0,2015,9,9
869,252402,Vallfogona de Balaguer,-16,2015,73,89
870,171707,Vallfogona de Ripollès,-2,2015,4,6
871,431592,Vallfogona de Riucorb,0,2015,9,9
872,082943,Vallgorguina,-17,2015,204,221
873,082956,Vallirana,56,2015,789,733
874,172095,Vall-llobrega,17,2015,55,38
875,431606,Vallmoll,-5,2015,108,113
876,082969,Vallromanes,-5,2015,145,150
877,431613,Valls,-4,2015,975,979
878,259062,"Valls d'Aguilar, les",-7,2015,15,22
879,252398,"Valls de Valira, les",-10,2015,79,89
880,431628,Vandellòs i l'Hospitalet de l'Infant,74,2015,394,320
881,259097,"Vansa i Fórnols, la",-12,2015,5,17
882,082975,Veciana,-1,2015,5,6
883,431634,"Vendrell, el",-18,2015,2315,2333
884,172109,Ventalló,-13,2015,60,73
885,252424,Verdú,3,2015,43,40
886,172116,Verges,-47,2015,68,115
887,431649,Vespella de Gaià,-6,2015,23,29
888,082981,Vic,822,2015,3123,2301
889,172121,Vidrà,1,2015,13,12
890,172137,Vidreres,26,2015,464,438
891,252430,Vielha e Mijaran,-9,2015,425,434
892,431652,Vilabella,-37,2015,18,55
893,172142,Vilabertran,27,2015,63,36
894,172155,Vilablareix,63,2015,149,86
895,082994,Vilada,8,2015,22,14
896,172174,Viladamat,29,2015,41,12
897,172168,Viladasens,6,2015,18,12
898,083015,Viladecans,34,2015,2632,2598
899,083008,Viladecavalls,-8,2015,365,373
900,172180,Vilademuls,-18,2015,35,53
901,172207,Viladrau,-19,2015,48,67
902,172214,Vilafant,-82,2015,272,354
903,083054,Vilafranca del Penedès,181,2015,2002,1821
904,252445,Vilagrassa,-8,2015,25,33
905,172235,Vilajuïga,1,2015,77,76
906,431750,Vilalba dels Arcs,-1,2015,8,9
907,083067,Vilalba Sasserra,-18,2015,64,82
908,252458,Vilaller,-18,2015,24,42
909,172240,Vilallonga de Ter,-3,2015,27,30
910,431665,Vilallonga del Camp,31,2015,200,169
911,172253,Vilamacolum,29,2015,49,20
912,172266,Vilamalla,-8,2015,71,79
913,172272,Vilamaniscle,8,2015,21,13
914,252477,Vilamòs,-13,2015,18,31
915,172288,Vilanant,2,2015,22,20
916,431671,Vilanova d'Escornalbou,8,2015,36,28
917,252483,Vilanova de Bellpuig,-1,2015,48,49
918,252496,Vilanova de l'Aguda,0,2015,3,3
919,252542,Vilanova de la Barca,-14,2015,57,71
920,252509,Vilanova de Meià,0,2015,15,15
921,431687,Vilanova de Prades,-4,2015,0,4
922,083036,Vilanova de Sau,-1,2015,11,12
923,252516,Vilanova de Segrià,2,2015,67,65
924,083020,Vilanova del Camí,-49,2015,537,586
925,089024,Vilanova del Vallès,-28,2015,294,322
926,083073,Vilanova i la Geltrú,636,2015,3164,2528
927,431690,Vilaplana,-20,2015,25,45
928,431704,Vila-rodona,-17,2015,61,78
929,172305,Vila-sacra,38,2015,74,36
930,252521,Vila-sana,18,2015,36,18
931,431711,Vila-seca,-367,2015,1199,1566
932,082140,Vilassar de Dalt,20,2015,365,345
933,082191,Vilassar de Mar,197,2015,1120,923
934,172229,Vilaür,-3,2015,9,12
935,431726,Vilaverd,-18,2015,19,37
936,431732,"Vilella Alta, la",2,2015,2,0
937,431747,"Vilella Baixa, la",-1,2015,6,7
938,172333,Vilobí d'Onyar,15,2015,156,141
939,083041,Vilobí del Penedès,19,2015,64,45
940,172327,Vilopriu,3,2015,24,21
941,252537,"Vilosell, el",0,2015,7,7
942,431763,Vimbodí i Poblet,-10,2015,26,36
943,252555,Vinaixa,-16,2015,16,32
944,431779,Vinebre,-8,2015,12,20
945,431785,Vinyols i els Arcs,-6,2015,147,153
946,083089,Viver i Serrateix,-6,2015,1,7
947,430521,Xerta,-7,2015,32,39
0,250019,Abella de la Conca,5,2016,10,5
1,080018,Abrera,66,2016,607,541
2,250024,Àger,-6,2016,25,31
3,250030,Agramunt,2,2016,187,185
4,080023,Aguilar de Segarra,12,2016,15,3
5,170010,Agullana,-9,2016,41,50
6,080142,Aiguafreda,60,2016,174,114
7,430017,Aiguamúrcia,-3,2016,42,45
8,170025,Aiguaviva,17,2016,43,26
9,250387,Aitona,68,2016,182,114
10,250045,"Alamús, els",-8,2016,41,49
11,250058,Alàs i Cerc,4,2016,18,14
12,250061,"Albagés, l'",-5,2016,19,24
13,170031,Albanyà,-5,2016,10,15
14,250077,Albatàrrec,-22,2016,182,204
15,250083,Albesa,-7,2016,45,52
16,250096,"Albi, l'",-17,2016,13,30
17,430022,Albinyana,33,2016,184,151
18,430038,"Albiol, l'",20,2016,35,15
19,170046,Albons,7,2016,58,51
20,430043,Alcanar,36,2016,422,386
21,250100,Alcanó,-2,2016,6,8
22,250117,Alcarràs,85,2016,694,609
23,250122,Alcoletge,82,2016,256,174
24,430056,Alcover,48,2016,229,181
25,439044,"Aldea, l'",-35,2016,213,248
26,430069,Aldover,-9,2016,28,37
27,430075,"Aleixar, l'",-16,2016,26,42
28,080039,Alella,62,2016,638,576
29,430081,Alfara de Carles,1,2016,16,15
30,250138,Alfarràs,-40,2016,95,135
31,250143,Alfés,-13,2016,7,20
32,430094,Alforja,-31,2016,80,111
33,250156,Algerri,3,2016,24,21
34,250169,Alguaire,4,2016,129,125
35,250175,Alins,3,2016,10,7
36,430108,Alió,1,2016,29,28
37,250194,Almacelles,76,2016,334,258
38,250208,Almatret,-4,2016,11,15
39,250215,Almenar,-5,2016,178,183
40,430115,Almoster,-41,2016,28,69
41,250220,Alòs de Balaguer,4,2016,7,3
42,170062,Alp,-33,2016,90,123
43,080044,Alpens,-14,2016,2,16
44,250236,Alpicat,28,2016,322,294
45,250241,Alt Àneu,4,2016,25,21
46,430120,Altafulla,50,2016,342,292
47,170078,Amer,-6,2016,91,97
48,430136,"Ametlla de Mar, l'",-383,2016,285,668
49,080057,"Ametlla del Vallès, l'",30,2016,432,402
50,439060,"Ampolla, l'",-53,2016,220,273
51,430141,Amposta,112,2016,914,802
52,170084,Anglès,7,2016,292,285
53,250273,Anglesola,-7,2016,68,75
54,250292,Arbeca,42,2016,101,59
55,430167,"Arboç, l'",-26,2016,299,325
56,430154,Arbolí,-2,2016,5,7
57,170097,Arbúcies,59,2016,303,244
58,080060,Arenys de Mar,254,2016,1001,747
59,080076,Arenys de Munt,73,2016,452,379
60,170101,Argelaguer,6,2016,29,23
61,080082,Argençola,-1,2016,12,13
62,430173,"Argentera, l'",-1,2016,4,5
63,080095,Argentona,80,2016,538,458
64,170118,"Armentera, l'",17,2016,56,39
65,430189,Arnes,-9,2016,11,20
66,250313,Arres,-5,2016,0,5
67,250328,Arsèguel,-2,2016,5,7
68,080109,Artés,-24,2016,264,288
69,250334,Artesa de Lleida,20,2016,49,29
70,250349,Artesa de Segre,14,2016,143,129
71,430192,Ascó,2,2016,58,56
72,250365,Aspa,-3,2016,4,7
73,250371,"Avellanes i Santa Linya, les",-2,2016,23,25
74,080116,Avià,-4,2016,104,108
75,080121,Avinyó,45,2016,97,52
76,170123,Avinyonet de Puigventós,-11,2016,76,87
77,080137,Avinyonet del Penedès,-11,2016,126,137
78,080155,Badalona,433,2016,10648,10215
79,089045,Badia del Vallès,-46,2016,529,575
80,080168,Bagà,5,2016,71,66
81,250390,Baix Pallars,-5,2016,19,24
82,250404,Balaguer,110,2016,934,824
83,080174,Balenyà,-6,2016,206,212
84,080180,Balsareny,-21,2016,85,106
85,430206,Banyeres del Penedès,27,2016,236,209
86,170157,Banyoles,170,2016,897,727
87,250411,Barbens,14,2016,83,69
88,430213,Barberà de la Conca,-6,2016,16,22
89,082520,Barberà del Vallès,-12,2016,1400,1412
90,080193,Barcelona,21062,2016,91409,70347
91,250426,"Baronia de Rialb, la",-5,2016,4,9
92,170160,Bàscara,1,2016,61,60
93,250447,Bassella,-4,2016,11,15
94,430228,Batea,9,2016,48,39
95,250450,Bausen,5,2016,8,3
96,080207,Begues,74,2016,378,304
97,170139,Begur,15,2016,214,199
98,250463,Belianes,-10,2016,17,27
99,251706,Bellaguarda,1,2016,8,7
100,170182,Bellcaire d'Empordà,29,2016,60,31
101,250479,Bellcaire d'Urgell,2,2016,44,42
102,250485,Bell-lloc d'Urgell,-23,2016,89,112
103,250498,Bellmunt d'Urgell,1,2016,4,3
104,430234,Bellmunt del Priorat,-4,2016,6,10
105,080214,Bellprat,-1,2016,2,3
106,250501,Bellpuig,17,2016,252,235
107,430249,Bellvei,-3,2016,155,158
108,250518,Bellver de Cerdanya,3,2016,115,112
109,250523,Bellvís,20,2016,108,88
110,250539,Benavent de Segrià,-31,2016,58,89
111,430252,Benifallet,20,2016,39,19
112,430265,Benissanet,-34,2016,35,69
113,080229,Berga,45,2016,663,618
114,170195,Besalú,20,2016,134,114
115,170209,Bescanó,46,2016,215,169
116,170216,Beuda,-11,2016,13,24
117,080235,Bigues i Riells del Fai,61,2016,530,469
118,250557,Biosca,1,2016,12,11
119,170221,"Bisbal d'Empordà, la",48,2016,577,529
120,430271,"Bisbal de Falset, la",8,2016,14,6
121,430287,"Bisbal del Penedès, la",-3,2016,257,260
122,172348,Biure,1,2016,13,12
123,430290,Blancafort,-10,2016,10,20
124,170237,Blanes,-11,2016,2115,2126
125,170293,Boadella i les Escaules,1,2016,23,22
126,170242,Bolvir,5,2016,39,34
127,430304,Bonastre,22,2016,68,46
128,250576,"Bòrdes, Es",1,2016,24,23
129,170255,Bordils,29,2016,109,80
130,250582,"Borges Blanques, les",11,2016,289,278
131,430311,"Borges del Camp, les",11,2016,99,88
132,170268,Borrassà,9,2016,40,31
133,080240,Borredà,2,2016,30,28
134,250595,Bossòst,11,2016,74,63
135,430326,Bot,5,2016,21,16
136,430332,Botarell,-42,2016,45,87
137,250560,Bovera,1,2016,8,7
138,430347,Bràfim,-3,2016,29,32
139,170274,Breda,25,2016,161,136
140,080253,"Bruc, el",-16,2016,124,140
141,080266,"Brull, el",-2,2016,7,9
142,170280,Brunyola i Sant Martí Sapresa,-4,2016,22,26
143,430350,Cabacés,-13,2016,5,18
144,250609,Cabanabona,6,2016,8,2
145,170314,Cabanelles,11,2016,26,15
146,170307,Cabanes,-4,2016,57,61
147,080272,"Cabanyes, les",-4,2016,52,56
148,250616,Cabó,2,2016,4,2
149,430363,Cabra del Camp,18,2016,90,72
150,080288,Cabrera d'Anoia,16,2016,115,99
151,080291,Cabrera de Mar,45,2016,264,219
152,080305,Cabrils,30,2016,433,403
153,170329,Cadaqués,33,2016,145,112
154,080312,Calaf,69,2016,207,138
155,430379,Calafell,663,2016,2420,1757
156,080348,Calders,3,2016,53,50
157,080327,Caldes d'Estrac,101,2016,318,217
158,170335,Caldes de Malavella,141,2016,496,355
159,080333,Caldes de Montbui,81,2016,816,735
160,080351,Calella,341,2016,1421,1080
161,080370,Calldetenes,36,2016,117,81
162,080386,Callús,10,2016,118,108
163,080364,Calonge de Segarra,5,2016,9,4
164,170340,Calonge i Sant Antoni,135,2016,802,667
165,250621,Camarasa,-3,2016,29,32
166,439039,Camarles,-29,2016,94,123
167,430385,Cambrils,-606,2016,2264,2870
168,170353,Camós,13,2016,24,11
169,170366,Campdevànol,-31,2016,74,105
170,170372,Campelles,0,2016,11,11
171,080399,Campins,23,2016,55,32
172,170388,Campllong,6,2016,28,22
173,170391,Camprodon,15,2016,162,147
174,250637,Canejan,-5,2016,2,7
175,170405,Canet d'Adri,4,2016,41,37
176,080403,Canet de Mar,220,2016,802,582
177,439076,"Canonja, la",-23,2016,270,293
178,080410,Canovelles,170,2016,1073,903
179,080425,Cànoves i Samalús,22,2016,205,183
180,170412,Cantallops,13,2016,21,8
181,080431,Canyelles,-17,2016,269,286
182,430398,Capafonts,-5,2016,10,15
183,430402,Capçanes,15,2016,20,5
184,080446,Capellades,-2,2016,235,237
185,170427,Capmany,29,2016,67,38
186,080459,Capolat,8,2016,13,5
187,080462,Cardedeu,60,2016,872,812
188,080478,Cardona,-32,2016,96,128
189,080484,Carme,3,2016,54,51
190,430419,Caseres,-16,2016,0,16
191,170448,Cassà de la Selva,210,2016,568,358
192,080497,Casserres,31,2016,83,52
193,080575,Castell de l'Areny,0,2016,0,0
194,259046,Castell de Mur,-4,2016,3,7
195,250642,Castellar de la Ribera,-1,2016,2,3
196,080522,Castellar de n'Hug,1,2016,7,6
197,080500,Castellar del Riu,-8,2016,6,14
198,080517,Castellar del Vallès,130,2016,992,862
199,080538,Castellbell i el Vilar,64,2016,249,185
200,080543,Castellbisbal,14,2016,502,488
201,080556,Castellcir,5,2016,43,38
202,250674,Castelldans,-11,2016,38,49
203,080569,Castelldefels,965,2016,4574,3609
204,080581,Castellet i la Gornal,50,2016,185,135
205,170464,Castellfollit de la Roca,1,2016,33,32
206,080608,Castellfollit de Riubregós,-3,2016,6,9
207,080594,Castellfollit del Boix,-5,2016,10,15
208,080615,Castellgalí,24,2016,168,144
209,080620,Castellnou de Bages,6,2016,61,55
210,250680,Castellnou de Seana,-40,2016,24,64
211,170470,Castelló d'Empúries,22,2016,924,902
212,250693,Castelló de Farfanya,-14,2016,22,36
213,080636,Castellolí,21,2016,36,15
214,170486,Castell-Platja d'Aro,22,2016,883,861
215,250707,Castellserà,-12,2016,35,47
216,080641,Castellterçol,53,2016,167,114
217,430424,Castellvell del Camp,27,2016,141,114
218,080654,Castellví de la Marca,23,2016,66,43
219,080667,Castellví de Rosanes,39,2016,139,100
220,430430,"Catllar, el",36,2016,245,209
221,250714,Cava,-5,2016,2,7
222,171899,"Cellera de Ter, la",-34,2016,75,109
223,170499,Celrà,38,2016,289,251
224,080673,Centelles,32,2016,339,307
225,082687,Cercs,-8,2016,51,59
226,082665,Cerdanyola del Vallès,157,2016,2850,2693
227,080689,Cervelló,51,2016,574,523
228,250729,Cervera,54,2016,411,357
229,250735,Cervià de les Garrigues,-12,2016,17,29
230,170502,Cervià de Ter,13,2016,51,38
231,170519,Cistella,11,2016,34,23
232,250740,Ciutadilla,1,2016,8,7
233,250753,Clariana de Cardener,3,2016,9,6
234,250766,"Cogul, el",-10,2016,6,16
235,170545,Colera,-37,2016,22,59
236,250772,Coll de Nargó,-13,2016,21,34
237,080692,Collbató,15,2016,211,196
238,430458,Colldejou,4,2016,7,3
239,080706,Collsuspina,-12,2016,7,19
240,170558,Colomers,-11,2016,12,23
241,251636,"Coma i la Pedra, la",0,2016,20,20
242,251615,Conca de Dalt,5,2016,18,13
243,430461,Conesa,-2,2016,3,5
244,430477,Constantí,57,2016,425,368
245,080713,Copons,13,2016,22,9
246,430483,Corbera d'Ebre,12,2016,46,34
247,080728,Corbera de Llobregat,259,2016,833,574
248,250788,Corbins,11,2016,64,53
249,170577,Corçà,-1,2016,83,84
250,080734,Cornellà de Llobregat,749,2016,4994,4245
251,170561,Cornellà del Terri,9,2016,131,122
252,430496,Cornudella de Montsant,7,2016,59,52
253,430509,Creixell,4,2016,333,329
254,170583,Crespià,-9,2016,10,19
255,179011,"Cruïlles, Monells i Sant Sadurní de l'Heura",6,2016,80,74
256,080749,Cubelles,-86,2016,1125,1211
257,250791,Cubells,0,2016,20,20
258,430516,Cunit,331,2016,1208,877
259,170600,Darnius,12,2016,43,31
260,170617,Das,4,2016,12,8
261,439018,Deltebre,21,2016,365,344
262,080752,Dosrius,32,2016,323,291
263,430537,Duesaigües,0,2016,23,23
264,170622,"Escala, l'",-30,2016,477,507
265,080765,Esparreguera,128,2016,1081,953
266,170638,Espinelves,0,2016,27,27
267,250812,"Espluga Calba, l'",-16,2016,12,28
268,430542,"Espluga de Francolí, l'",-7,2016,136,143
269,080771,Esplugues de Llobregat,380,2016,2989,2609
270,170643,Espolla,8,2016,20,12
271,170656,Esponellà,-22,2016,11,33
272,250827,Espot,10,2016,11,1
273,080787,"Espunyola, l'",-1,2016,10,11
274,082541,"Esquirol, l'",1,2016,76,75
275,250886,Estamariu,6,2016,7,1
276,080790,"Estany, l'",4,2016,15,11
277,250851,Estaràs,-5,2016,5,10
278,250864,Esterri d'Àneu,-15,2016,41,56
279,250870,Esterri de Cardós,-1,2016,1,2
280,430555,Falset,9,2016,95,86
281,170059,"Far d'Empordà, el",16,2016,43,27
282,250899,Farrera,-5,2016,3,8
283,430568,"Fatarella, la",-6,2016,15,21
284,430574,"Febró, la",2,2016,3,1
285,081347,Figaró-Montmany,-11,2016,86,97
286,080804,Fígols,2,2016,3,1
287,259084,Fígols i Alinyà,1,2016,12,11
288,430580,"Figuera, la",0,2016,4,4
289,170669,Figueres,347,2016,2895,2548
290,430593,Figuerola del Camp,-11,2016,8,19
291,170675,Flaçà,32,2016,69,37
292,430607,Flix,-53,2016,92,145
293,250925,"Floresta, la",3,2016,5,2
294,080826,Fogars de la Selva,7,2016,124,117
295,080811,Fogars de Montclús,-4,2016,29,33
296,170681,Foixà,2,2016,13,11
297,080832,Folgueroles,-5,2016,63,68
298,250931,Fondarella,-8,2016,39,47
299,080847,Fonollosa,0,2016,66,66
300,170694,Fontanals de Cerdanya,6,2016,36,30
301,170708,Fontanilles,-4,2016,3,7
302,170715,Fontcoberta,4,2016,59,55
303,080850,Font-rubí,8,2016,56,48
304,250946,Foradada,-2,2016,8,10
305,179026,Forallac,-29,2016,98,127
306,430614,Forès,-2,2016,3,5
307,170736,Fornells de la Selva,51,2016,141,90
308,170741,Fortià,13,2016,57,44
309,080863,"Franqueses del Vallès, les",116,2016,1198,1082
310,430629,Freginals,15,2016,30,15
311,250962,"Fuliola, la",-21,2016,40,61
312,250978,Fulleda,-2,2016,3,5
313,080902,Gaià,1,2016,8,7
314,430635,"Galera, la",-9,2016,23,32
315,080879,Gallifa,-4,2016,7,11
316,430640,Gandesa,17,2016,117,100
317,430653,Garcia,-38,2016,23,61
318,430666,"Garidells, els",2,2016,10,8
319,080885,"Garriga, la",89,2016,715,626
320,170754,Garrigàs,10,2016,32,22
321,170767,Garrigoles,10,2016,16,6
322,170773,Garriguella,0,2016,67,67
323,080898,Gavà,284,2016,2570,2286
324,250984,Gavet de la Conca,-12,2016,15,27
325,080919,Gelida,63,2016,390,327
326,170789,Ger,-10,2016,26,36
327,259123,Gimenells i el Pla de la Font,-2,2016,25,27
328,430672,Ginestar,5,2016,45,40
329,170792,Girona,555,2016,6075,5520
330,080924,Gironella,17,2016,176,159
331,080930,Gisclareny,-1,2016,1,2
332,430688,Godall,-10,2016,17,27
333,250997,Golmés,21,2016,96,75
334,170806,Gombrèn,6,2016,11,5
335,251001,Gósol,-2,2016,12,14
336,080945,"Granada, la",28,2016,137,109
337,251018,"Granadella, la",17,2016,55,38
338,080958,Granera,-1,2016,2,3
339,251023,"Granja d'Escarp, la",13,2016,73,60
340,080961,Granollers,429,2016,3678,3249
341,251039,Granyanella,-1,2016,2,3
342,251057,Granyena de les Garrigues,0,2016,6,6
343,251044,Granyena de Segarra,-3,2016,1,4
344,430691,Gratallops,2,2016,9,7
345,080977,Gualba,7,2016,89,82
346,170813,Gualta,14,2016,71,57
347,080996,Guardiola de Berguedà,4,2016,46,42
348,430705,"Guiamets, els",7,2016,8,1
349,170828,Guils de Cerdanya,-1,2016,50,51
350,251095,Guimerà,4,2016,17,13
351,259031,"Guingueta d'Àneu, la",7,2016,26,19
352,251109,Guissona,76,2016,460,384
353,251116,Guixers,-4,2016,6,10
354,081000,Gurb,46,2016,134,88
355,430712,Horta de Sant Joan,-4,2016,38,42
356,081017,"Hospitalet de Llobregat, l'",3322,2016,19522,16200
357,081629,"Hostalets de Pierola, els",3,2016,209,206
358,170834,Hostalric,64,2016,301,237
359,081022,Igualada,525,2016,2183,1658
360,251155,Isona i Conca Dellà,-13,2016,40,53
361,170849,Isòvol,-5,2016,13,18
362,251137,Ivars d'Urgell,1,2016,66,65
363,251121,Ivars de Noguera,-12,2016,6,18
364,251142,Ivorra,-4,2016,5,9
365,170852,Jafre,6,2016,24,18
366,170865,"Jonquera, la",-60,2016,263,323
367,081038,Jorba,-10,2016,57,67
368,259101,Josa i Tuixén,-3,2016,7,10
369,170871,Juià,7,2016,51,44
370,251180,Juncosa,-14,2016,9,23
371,251193,Juneda,50,2016,172,122
372,251214,Les,-21,2016,50,71
373,251229,Linyola,-18,2016,97,115
374,081043,"Llacuna, la",4,2016,36,32
375,170887,Lladó,23,2016,62,39
376,251235,Lladorre,-6,2016,3,9
377,251240,Lladurs,-3,2016,5,8
378,081056,"Llagosta, la",77,2016,755,678
379,170890,Llagostera,-73,2016,443,516
380,170904,Llambilles,-10,2016,17,27
381,170911,Llanars,-1,2016,22,23
382,170926,Llançà,-24,2016,249,273
383,251253,Llardecans,0,2016,9,9
384,251266,Llavorsí,11,2016,27,16
385,251207,Lleida,-415,2016,5970,6385
386,170932,Llers,6,2016,63,57
387,251272,Lles de Cerdanya,4,2016,15,11
388,081075,Lliçà d'Amunt,144,2016,881,737
389,081081,Lliçà de Vall,-2,2016,306,308
390,251288,Llimiana,-6,2016,3,9
391,081069,Llinars del Vallès,79,2016,625,546
392,170947,Llívia,-47,2016,80,127
393,430727,"Lloar, el",-1,2016,4,5
394,251291,Llobera,-2,2016,3,5
395,430733,Llorac,-3,2016,5,8
396,430748,Llorenç del Penedès,-13,2016,99,112
397,170950,Lloret de Mar,-292,2016,2652,2944
398,170963,"Llosses, les",-3,2016,10,13
399,081094,Lluçà,-5,2016,5,10
400,171024,Maçanet de Cabrenys,-23,2016,36,59
401,171030,Maçanet de la Selva,41,2016,459,418
402,170979,Madremanya,0,2016,17,17
403,170985,Maià de Montcal,-22,2016,24,46
404,251333,Maials,-2,2016,30,32
405,251305,Maldà,2,2016,10,8
406,081108,Malgrat de Mar,144,2016,1070,926
407,081115,Malla,-2,2016,9,11
408,081120,Manlleu,-56,2016,836,892
409,081136,Manresa,282,2016,3585,3303
410,430764,Marçà,23,2016,45,22
411,430751,Margalef,2,2016,9,7
412,082423,Marganell,-15,2016,8,23
413,081141,Martorell,-46,2016,1259,1305
414,081154,Martorelles,23,2016,259,236
415,430770,Mas de Barberans,-17,2016,14,31
416,171002,Masarac,-1,2016,18,19
417,430786,Masdenverge,-28,2016,55,83
418,081167,"Masies de Roda, les",-1,2016,24,25
419,081173,"Masies de Voltregà, les",-23,2016,102,125
420,430799,Masllorenç,4,2016,34,30
421,081189,"Masnou, el",299,2016,1306,1007
422,430803,"Masó, la",-4,2016,7,11
423,430810,Maspujols,14,2016,44,30
424,081192,Masquefa,86,2016,475,389
425,430825,"Masroig, el",13,2016,30,17
426,251312,Massalcoreig,13,2016,51,38
427,171019,Massanes,-27,2016,41,68
428,251327,Massoteres,7,2016,20,13
429,081206,Matadepera,194,2016,566,372
430,081213,Mataró,323,2016,5271,4948
431,171045,Medinyà,0,2016,0,0
432,081228,Mediona,-5,2016,158,163
433,251348,Menàrguens,-21,2016,23,44
434,170998,Meranges,1,2016,3,2
435,171058,Mieres,-1,2016,19,20
436,430831,"Milà, el",5,2016,9,4
437,251351,Miralcamp,-2,2016,55,57
438,430846,Miravet,3,2016,36,33
439,081385,Moià,121,2016,368,247
440,430859,"Molar, el",6,2016,10,4
441,081234,Molins de Rei,138,2016,980,842
442,251370,Mollerussa,163,2016,815,652
443,171061,Mollet de Peralada,10,2016,16,6
444,081249,Mollet del Vallès,-67,2016,2467,2534
445,171077,Molló,5,2016,15,10
446,251364,"Molsosa, la",1,2016,2,1
447,081287,Monistrol de Calders,-16,2016,31,47
448,081271,Monistrol de Montserrat,58,2016,236,178
449,171096,Montagut i Oix,4,2016,44,40
450,430862,Montblanc,43,2016,252,209
451,430884,Montbrió del Camp,6,2016,192,186
452,081252,Montcada i Reixac,257,2016,1877,1620
453,081304,Montclar,2,2016,5,3
454,251399,Montellà i Martinet,8,2016,34,26
455,081311,Montesquiu,19,2016,70,51
456,251403,Montferrer i Castellbò,30,2016,93,63
457,430897,Montferri,-10,2016,26,36
458,251386,Montgai,-7,2016,12,19
459,081265,Montgat,44,2016,652,608
460,081326,Montmajor,-14,2016,25,39
461,081332,Montmaneu,4,2016,14,10
462,430901,"Montmell, el",27,2016,116,89
463,081350,Montmeló,-24,2016,362,386
464,251425,Montoliu de Lleida,-18,2016,10,28
465,251410,Montoliu de Segarra,-7,2016,6,13
466,251431,Montornès de Segarra,-2,2016,4,6
467,081363,Montornès del Vallès,1,2016,712,711
468,430918,Mont-ral,-6,2016,9,15
469,171100,Mont-ras,29,2016,120,91
470,430923,Mont-roig del Camp,150,2016,901,751
471,081379,Montseny,15,2016,27,12
472,430939,Móra d'Ebre,49,2016,343,294
473,430944,Móra la Nova,-27,2016,138,165
474,430957,"Morell, el",60,2016,283,223
475,430960,"Morera de Montsant, la",12,2016,20,8
476,081290,Muntanyola,8,2016,31,23
477,081398,Mura,10,2016,15,5
478,251459,Nalec,0,2016,2,2
479,250254,Naut Aran,13,2016,95,82
480,081402,Navarcles,-43,2016,198,241
481,081419,Navàs,1,2016,179,178
482,171117,Navata,0,2016,90,90
483,251462,Navès,2,2016,15,13
484,081424,"Nou de Berguedà, la",8,2016,13,5
485,430976,"Nou de Gaià, la",15,2016,45,30
486,430982,Nulles,9,2016,38,29
487,251484,Odèn,1,2016,7,6
488,081430,Òdena,-17,2016,191,208
489,171122,Ogassa,7,2016,7,0
490,081458,Olèrdola,35,2016,209,174
491,081461,Olesa de Bonesvalls,19,2016,102,83
492,081477,Olesa de Montserrat,-69,2016,956,1025
493,251497,Oliana,2,2016,92,90
494,251500,Oliola,-5,2016,4,9
495,251517,Olius,-1,2016,35,36
496,081483,Olivella,57,2016,374,317
497,081496,Olost,18,2016,53,35
498,171143,Olot,333,2016,1536,1203
499,251522,"Oluges, les",4,2016,10,6
500,081445,Olvan,5,2016,38,33
501,251538,"Omellons, els",-5,2016,0,5
502,251543,"Omells de na Gaia, els",-1,2016,3,4
503,171156,Ordis,-9,2016,9,18
504,251556,Organyà,-18,2016,37,55
505,081509,Orís,-1,2016,21,22
506,081516,Oristà,3,2016,24,21
507,081521,Orpí,-9,2016,6,15
508,081537,Òrrius,-4,2016,22,26
509,251569,Os de Balaguer,4,2016,47,43
510,171169,Osor,-5,2016,14,19
511,251575,Ossó de Sió,0,2016,6,6
512,081542,Pacs del Penedès,6,2016,63,57
513,081555,Palafolls,31,2016,553,522
514,171175,Palafrugell,-136,2016,1062,1198
515,171181,Palamós,54,2016,942,888
516,251581,"Palau d'Anglesola, el",35,2016,101,66
517,171194,Palau de Santa Eulàlia,5,2016,5,0
518,171215,Palau-sator,-10,2016,14,24
519,171208,Palau-saverdera,-9,2016,93,102
520,081568,Palau-solità i Plegamans,147,2016,733,586
521,431009,"Pallaresos, els",49,2016,239,190
522,081574,Pallejà,70,2016,534,464
523,430995,"Palma d'Ebre, la",-4,2016,10,14
524,089058,"Palma de Cervelló, la",-1,2016,177,178
525,171236,Palol de Revardit,4,2016,22,18
526,171241,Pals,-7,2016,156,163
527,081580,"Papiol, el",13,2016,229,216
528,171254,Pardines,4,2016,10,6
529,081593,Parets del Vallès,119,2016,864,745
530,171267,Parlavà,3,2016,17,14
531,431016,Passanant i Belltall,-8,2016,2,10
532,171289,Pau,6,2016,30,24
533,431021,Paüls,-4,2016,9,13
534,171292,Pedret i Marzà,6,2016,11,5
535,251641,Penelles,-7,2016,26,33
536,171306,"Pera, la",19,2016,29,10
537,081607,Perafita,3,2016,15,12
538,431037,Perafort,-25,2016,56,81
539,171328,Peralada,31,2016,130,99
540,251654,Peramola,-2,2016,15,17
541,431042,"Perelló, el",46,2016,136,90
542,081614,Piera,185,2016,904,719
543,431055,"Piles, les",6,2016,11,5
544,081635,Pineda de Mar,207,2016,1712,1505
545,431068,"Pinell de Brai, el",4,2016,30,26
546,251667,Pinell de Solsonès,-1,2016,4,5
547,251673,Pinós,19,2016,23,4
548,431074,Pira,1,2016,13,12
549,431080,"Pla de Santa Maria, el",-33,2016,117,150
550,081640,"Pla del Penedès, el",-12,2016,56,68
551,171334,"Planes d'Hostoles, les",-19,2016,62,81
552,171349,Planoles,5,2016,14,9
553,259118,"Plans de Sió, els",-2,2016,19,21
554,251689,"Poal, el",-15,2016,17,32
555,251692,"Pobla de Cérvoles, la",-12,2016,4,16
556,081653,"Pobla de Claramunt, la",35,2016,116,81
557,081666,"Pobla de Lillet, la",-4,2016,26,30
558,431093,"Pobla de Mafumet, la",61,2016,300,239
559,431107,"Pobla de Massaluca, la",3,2016,19,16
560,431114,"Pobla de Montornès, la",0,2016,219,219
561,251713,"Pobla de Segur, la",11,2016,172,161
562,431129,Poboleda,-8,2016,10,18
563,081672,Polinyà,41,2016,370,329
564,431135,"Pont d'Armentera, el",-8,2016,20,28
565,250306,"Pont de Bar, el",7,2016,19,12
566,171352,Pont de Molins,12,2016,37,25
567,251734,"Pont de Suert, el",-10,2016,100,110
568,081825,"Pont de Vilomara i Rocafort, el",80,2016,216,136
569,431418,Pontils,-4,2016,4,8
570,081688,Pontons,2,2016,56,54
571,171365,Pontós,8,2016,22,14
572,251728,Ponts,16,2016,154,138
573,171371,Porqueres,60,2016,214,154
574,431140,Porrera,-7,2016,12,19
575,171404,"Port de la Selva, el",7,2016,57,50
576,171387,Portbou,-35,2016,35,70
577,251749,"Portella, la",-20,2016,54,74
578,431153,Pradell de la Teixeta,-9,2016,6,15
579,431166,Prades,6,2016,41,35
580,431172,Prat de Comte,4,2016,10,6
581,081691,"Prat de Llobregat, el",350,2016,2547,2197
582,431188,Pratdip,9,2016,51,42
583,081712,Prats de Lluçanès,-5,2016,74,79
584,081705,"Prats de Rei, els",6,2016,25,19
585,251752,Prats i Sansor,-2,2016,15,17
586,251765,Preixana,0,2016,14,14
587,251771,Preixens,6,2016,25,19
588,082303,Premià de Dalt,-160,2016,576,736
589,081727,Premià de Mar,262,2016,1527,1265
590,171390,"Preses, les",-21,2016,62,83
591,251790,Prullans,18,2016,26,8
592,171411,Puigcerdà,118,2016,568,450
593,081748,Puigdàlber,-8,2016,19,27
594,251804,Puiggròs,-4,2016,6,10
595,431191,Puigpelat,19,2016,74,55
596,081751,Puig-reig,13,2016,167,154
597,251811,Puigverd d'Agramunt,-9,2016,8,17
598,251826,Puigverd de Lleida,-16,2016,42,58
599,081764,Pujalt,3,2016,5,2
600,081770,"Quar, la",7,2016,10,3
601,171426,Quart,53,2016,199,146
602,170433,Queralbs,8,2016,12,4
603,431205,Querol,0,2016,37,37
604,171432,Rabós,3,2016,10,7
605,081786,Rajadell,2,2016,31,29
606,431212,Rasquera,0,2016,23,23
607,171447,Regencós,0,2016,15,15
608,081799,Rellinars,7,2016,52,45
609,431227,Renau,6,2016,10,4
610,431233,Reus,11,2016,4061,4050
611,251832,Rialp,2,2016,41,39
612,431248,"Riba, la",-4,2016,30,34
613,431251,Riba-roja d'Ebre,6,2016,37,31
614,259059,Ribera d'Ondara,-9,2016,25,34
615,251850,Ribera d'Urgellet,-11,2016,71,82
616,171450,Ribes de Freser,16,2016,91,75
617,171463,Riells i Viabrea,-6,2016,264,270
618,431264,"Riera de Gaià, la",4,2016,80,76
619,251863,Riner,0,2016,25,25
620,171479,Ripoll,78,2016,398,320
621,081803,Ripollet,128,2016,1917,1789
622,259139,Riu de Cerdanya,-3,2016,4,7
623,171485,Riudarenes,18,2016,160,142
624,171498,Riudaura,12,2016,33,21
625,431270,Riudecanyes,-8,2016,62,70
626,431286,Riudecols,1,2016,67,66
627,171501,Riudellots de la Selva,16,2016,114,98
628,431299,Riudoms,28,2016,303,275
629,171518,Riumors,11,2016,27,16
630,081810,"Roca del Vallès, la",-79,2016,449,528
631,431303,Rocafort de Queralt,-3,2016,11,14
632,431310,Roda de Berà,11,2016,450,439
633,081831,Roda de Ter,16,2016,290,274
634,431325,Rodonyà,8,2016,31,23
635,431331,Roquetes,-76,2016,384,460
636,171523,Roses,-172,2016,1072,1244
637,251898,Rosselló,52,2016,248,196
638,431346,"Rourell, el",-23,2016,14,37
639,081846,Rubí,304,2016,3094,2790
640,081859,Rubió,-3,2016,14,17
641,171539,Rupià,14,2016,26,12
642,089019,Rupit i Pruit,7,2016,16,9
643,081878,Sabadell,1735,2016,9114,7379
644,081884,Sagàs,4,2016,10,6
645,251902,Salàs de Pallars,4,2016,18,14
646,081901,Saldes,1,2016,19,18
647,171544,Sales de Llierca,7,2016,10,3
648,081918,Sallent,41,2016,219,178
649,431359,Salomó,6,2016,32,26
650,439057,Salou,-83,2016,2375,2458
651,171557,Salt,566,2016,2401,1835
652,251919,Sanaüja,-19,2016,3,22
653,081944,Sant Adrià de Besòs,58,2016,2608,2550
654,081957,Sant Agustí de Lluçanès,-6,2016,1,7
655,081960,Sant Andreu de la Barca,-30,2016,1308,1338
656,081976,Sant Andreu de Llavaneres,106,2016,768,662
657,171576,Sant Andreu Salou,-4,2016,1,5
658,171833,Sant Aniol de Finestres,-6,2016,24,30
659,081982,Sant Antoni de Vilamajor,149,2016,476,327
660,081995,Sant Bartomeu del Grau,4,2016,48,44
661,082009,Sant Boi de Llobregat,80,2016,3233,3153
662,082016,Sant Boi de Lluçanès,3,2016,24,21
663,431362,Sant Carles de la Ràpita,251,2016,806,555
664,082037,Sant Cebrià de Vallalta,-12,2016,194,206
665,082021,Sant Celoni,69,2016,1007,938
666,082042,Sant Climent de Llobregat,9,2016,166,157
667,171582,Sant Climent Sescebes,-8,2016,80,88
668,082055,Sant Cugat del Vallès,613,2016,4973,4360
669,082068,Sant Cugat Sesgarrigues,13,2016,36,23
670,251961,Sant Esteve de la Sarga,-4,2016,9,13
671,082074,Sant Esteve de Palautordera,52,2016,200,148
672,082080,Sant Esteve Sesrovires,57,2016,456,399
673,171595,Sant Feliu de Buixalleu,27,2016,57,30
674,082107,Sant Feliu de Codines,79,2016,455,376
675,171609,Sant Feliu de Guíxols,28,2016,1222,1194
676,082114,Sant Feliu de Llobregat,87,2016,1840,1753
677,171616,Sant Feliu de Pallerols,29,2016,78,49
678,082129,Sant Feliu Sasserra,-7,2016,16,23
679,171621,Sant Ferriol,0,2016,24,24
680,082093,Sant Fost de Campsentelles,103,2016,522,419
681,082135,Sant Fruitós de Bages,112,2016,414,302
682,171637,Sant Gregori,61,2016,223,162
683,251924,Sant Guim de Freixenet,-22,2016,37,59
684,251977,Sant Guim de la Plana,6,2016,10,4
685,171642,Sant Hilari Sacalm,2,2016,197,195
686,082153,Sant Hipòlit de Voltregà,-6,2016,156,162
687,081939,Sant Iscle de Vallalta,-6,2016,84,90
688,439023,Sant Jaume d'Enveja,-2,2016,142,144
689,082166,Sant Jaume de Frontanyà,2,2016,2,0
690,171655,Sant Jaume de Llierca,-18,2016,32,50
691,431378,Sant Jaume dels Domenys,22,2016,191,169
692,171674,Sant Joan de les Abadesses,-19,2016,91,110
693,171680,Sant Joan de Mollet,4,2016,24,20
694,082188,Sant Joan de Vilatorrada,53,2016,439,386
695,082172,Sant Joan Despí,270,2016,1741,1471
696,171851,Sant Joan les Fonts,42,2016,168,126
697,171668,Sant Jordi Desvalls,24,2016,61,37
698,089030,Sant Julià de Cerdanyola,-6,2016,6,12
699,171693,Sant Julià de Ramis,-18,2016,210,228
700,082205,Sant Julià de Vilatorta,17,2016,129,112
701,179032,Sant Julià del Llor i Bonmatí,38,2016,117,79
702,082212,Sant Just Desvern,-230,2016,1138,1368
703,082227,Sant Llorenç d'Hortons,-10,2016,169,179
704,171714,Sant Llorenç de la Muga,12,2016,32,20
705,251930,Sant Llorenç de Morunys,6,2016,49,43
706,082233,Sant Llorenç Savall,3,2016,123,120
707,082251,Sant Martí d'Albars,5,2016,6,1
708,082248,Sant Martí de Centelles,2,2016,112,110
709,171729,Sant Martí de Llémena,-7,2016,36,43
710,259025,Sant Martí de Riucorb,-11,2016,23,34
711,082264,Sant Martí de Tous,13,2016,58,45
712,082270,Sant Martí Sarroca,98,2016,218,120
713,082286,Sant Martí Sesgueioles,-15,2016,8,23
714,171735,Sant Martí Vell,-6,2016,14,20
715,082299,Sant Mateu de Bages,3,2016,20,17
716,171740,Sant Miquel de Campmajor,1,2016,14,13
717,171753,Sant Miquel de Fluvià,6,2016,60,54
718,171766,Sant Mori,2,2016,10,8
719,171772,Sant Pau de Segúries,9,2016,38,29
720,082310,Sant Pere de Ribes,357,2016,1980,1623
721,082325,Sant Pere de Riudebitlles,-18,2016,108,126
722,082331,Sant Pere de Torelló,30,2016,108,78
723,082346,Sant Pere de Vilamajor,65,2016,311,246
724,171788,Sant Pere Pescador,-84,2016,139,223
725,081897,Sant Pere Sallavinera,-2,2016,1,3
726,082359,Sant Pol de Mar,145,2016,405,260
727,082362,Sant Quintí de Mediona,36,2016,116,80
728,082378,Sant Quirze de Besora,-22,2016,79,101
729,082384,Sant Quirze del Vallès,149,2016,1031,882
730,082397,Sant Quirze Safaja,-6,2016,38,44
731,251945,Sant Ramon,1,2016,19,18
732,082401,Sant Sadurní d'Anoia,57,2016,526,469
733,082418,Sant Sadurní d'Osormort,-1,2016,2,3
734,080983,Sant Salvador de Guardiola,-19,2016,189,208
735,082628,Sant Vicenç de Castellet,42,2016,501,459
736,082649,Sant Vicenç de Montalt,114,2016,534,420
737,082652,Sant Vicenç de Torelló,2,2016,65,63
738,082634,Sant Vicenç dels Horts,68,2016,1121,1053
739,431384,Santa Bàrbara,22,2016,194,172
740,082439,Santa Cecília de Voltregà,4,2016,9,5
741,082444,Santa Coloma de Cervelló,19,2016,341,322
742,171805,Santa Coloma de Farners,18,2016,645,627
743,082457,Santa Coloma de Gramenet,172,2016,7437,7265
744,431397,Santa Coloma de Queralt,-20,2016,72,92
745,171812,Santa Cristina d'Aro,81,2016,358,277
746,082460,Santa Eugènia de Berga,6,2016,164,158
747,082476,Santa Eulàlia de Riuprimer,17,2016,71,54
748,082482,Santa Eulàlia de Ronçana,72,2016,423,351
749,082495,Santa Fe del Penedès,4,2016,17,13
750,171827,Santa Llogaia d'Àlguema,10,2016,27,17
751,082508,Santa Margarida de Montbui,103,2016,496,393
752,082515,Santa Margarida i els Monjos,103,2016,453,350
753,082589,Santa Maria d'Oló,-14,2016,25,39
754,082536,Santa Maria de Besora,4,2016,13,9
755,082567,Santa Maria de Martorelles,-3,2016,41,44
756,082554,Santa Maria de Merlès,12,2016,20,8
757,082573,Santa Maria de Miralles,-6,2016,4,10
758,082592,Santa Maria de Palautordera,102,2016,565,463
759,431401,Santa Oliva,50,2016,258,208
760,171848,Santa Pau,23,2016,64,41
761,082606,Santa Perpètua de Mogoda,-3,2016,1208,1211
762,082613,Santa Susanna,31,2016,286,255
763,081923,Santpedor,-31,2016,243,274
764,431423,Sarral,-20,2016,40,60
765,171864,Sarrià de Ter,-6,2016,256,262
766,252017,Sarroca de Bellera,2,2016,7,5
767,252000,Sarroca de Lleida,0,2016,8,8
768,171870,"Saus, Camallera i Llampaies",-3,2016,34,37
769,431439,Savallà del Comtat,-3,2016,2,5
770,431444,"Secuita, la",-10,2016,93,103
771,171886,"Selva de Mar, la",5,2016,13,8
772,431457,"Selva del Camp, la",-28,2016,194,222
773,431460,Senan,0,2016,2,2
774,430445,"Sénia, la",-10,2016,204,214
775,252022,Senterada,4,2016,9,5
776,250352,"Sentiu de Sió, la",-11,2016,16,27
777,082671,Sentmenat,58,2016,438,380
778,171903,Serinyà,-10,2016,43,53
779,252043,Seròs,4,2016,76,72
780,171910,Serra de Daró,1,2016,15,14
781,171925,Setcases,5,2016,7,2
782,252038,"Seu d'Urgell, la",-121,2016,613,734
783,082690,Seva,10,2016,171,161
784,252056,Sidamon,3,2016,39,36
785,171931,Sils,9,2016,389,380
786,082704,Sitges,277,2016,2300,2023
787,170524,Siurana,6,2016,19,13
788,082711,Sobremunt,2,2016,6,4
789,252069,"Soleràs, el",3,2016,16,13
790,431476,Solivella,0,2016,19,19
791,252075,Solsona,36,2016,438,402
792,082726,Sora,3,2016,16,13
793,252081,Soriguera,2,2016,29,27
794,252094,Sort,6,2016,137,131
795,252108,Soses,12,2016,66,54
796,082732,Subirats,29,2016,142,113
797,252115,Sudanell,17,2016,40,23
798,252120,Sunyer,11,2016,20,9
799,082747,Súria,60,2016,217,157
800,171946,Susqueda,3,2016,7,4
801,082763,Tagamanent,10,2016,34,24
802,082779,Talamanca,7,2016,25,18
803,252154,Talarn,12,2016,337,325
804,252167,Talavera,0,2016,11,11
805,171959,"Tallada d'Empordà, la",-6,2016,17,23
806,082785,Taradell,35,2016,283,248
807,431482,Tarragona,321,2016,6194,5873
808,252173,Tàrrega,153,2016,863,710
809,252189,Tarrés,0,2016,5,5
810,252192,Tarroja de Segarra,1,2016,6,5
811,082750,Tavèrnoles,-1,2016,10,11
812,082802,Tavertet,0,2016,5,5
813,082819,Teià,111,2016,418,307
814,252206,Térmens,-76,2016,71,147
815,171962,Terrades,24,2016,32,8
816,082798,Terrassa,1408,2016,9222,7814
817,082824,Tiana,80,2016,435,355
818,252213,Tírvia,2,2016,8,6
819,252228,Tiurana,3,2016,8,5
820,431495,Tivenys,-3,2016,21,24
821,431508,Tivissa,-19,2016,53,72
822,082830,Tona,164,2016,440,276
823,252234,Torà,14,2016,74,60
824,082845,Tordera,158,2016,1031,873
825,082858,Torelló,141,2016,664,523
826,252249,"Torms, els",2,2016,4,2
827,252252,Tornabous,-14,2016,49,63
828,252271,"Torre de Cabdella, la",15,2016,39,24
829,082861,"Torre de Claramunt, la",3,2016,206,203
830,431515,"Torre de Fontaubella, la",1,2016,12,11
831,431520,"Torre de l'Espanyol, la",11,2016,36,25
832,252265,Torrebesses,1,2016,12,11
833,431536,Torredembarra,263,2016,1181,918
834,252287,Torrefarrera,46,2016,297,251
835,259078,Torrefeta i Florejacs,10,2016,26,16
836,252304,Torregrossa,14,2016,88,74
837,252311,Torrelameu,27,2016,44,17
838,082877,Torrelavit,-20,2016,59,79
839,082883,Torrelles de Foix,42,2016,198,156
840,082896,Torrelles de Llobregat,-7,2016,303,310
841,171978,Torrent,-1,2016,7,8
842,252326,Torres de Segre,-20,2016,230,250
843,252332,Torre-serona,-7,2016,18,25
844,171984,Torroella de Fluvià,-12,2016,50,62
845,171997,Torroella de Montgrí,13,2016,648,635
846,431541,Torroja del Priorat,-3,2016,2,5
847,172001,Tortellà,9,2016,41,32
848,431554,Tortosa,-159,2016,1385,1544
849,172018,Toses,3,2016,6,3
850,172023,Tossa de Mar,-235,2016,314,549
851,252347,Tremp,-30,2016,311,341
852,172044,Ullà,59,2016,160,101
853,082900,Ullastrell,21,2016,122,101
854,172057,Ullastret,8,2016,20,12
855,431567,Ulldecona,-22,2016,333,355
856,431573,Ulldemolins,-1,2016,12,13
857,172039,Ultramort,7,2016,15,8
858,172060,Urús,-7,2016,10,17
859,082917,Vacarisses,131,2016,436,305
860,170144,"Vajol, la",3,2016,11,8
861,172076,"Vall d'en Bas, la",29,2016,134,105
862,172082,"Vall de Bianya, la",9,2016,57,48
863,250432,"Vall de Boí, la",-7,2016,66,73
864,259010,Vall de Cardós,5,2016,18,13
865,082922,Vallbona d'Anoia,-1,2016,74,75
866,252385,Vallbona de les Monges,-16,2016,2,18
867,082938,Vallcebre,3,2016,11,8
868,431589,Vallclara,-5,2016,5,10
869,252402,Vallfogona de Balaguer,-3,2016,80,83
870,171707,Vallfogona de Ripollès,5,2016,12,7
871,431592,Vallfogona de Riucorb,-4,2016,3,7
872,082943,Vallgorguina,18,2016,212,194
873,082956,Vallirana,114,2016,823,709
874,172095,Vall-llobrega,7,2016,67,60
875,431606,Vallmoll,51,2016,130,79
876,082969,Vallromanes,-10,2016,148,158
877,431613,Valls,-62,2016,922,984
878,259062,"Valls d'Aguilar, les",-11,2016,7,18
879,252398,"Valls de Valira, les",23,2016,97,74
880,431628,Vandellòs i l'Hospitalet de l'Infant,146,2016,401,255
881,259097,"Vansa i Fórnols, la",-18,2016,5,23
882,082975,Veciana,-8,2016,3,11
883,431634,"Vendrell, el",132,2016,2369,2237
884,172109,Ventalló,3,2016,36,33
885,252424,Verdú,11,2016,48,37
886,172116,Verges,21,2016,70,49
887,431649,Vespella de Gaià,6,2016,30,24
888,082981,Vic,807,2016,3062,2255
889,172121,Vidrà,1,2016,5,4
890,172137,Vidreres,47,2016,496,449
891,252430,Vielha e Mijaran,40,2016,458,418
892,431652,Vilabella,-1,2016,25,26
893,172142,Vilabertran,-5,2016,54,59
894,172155,Vilablareix,32,2016,122,90
895,082994,Vilada,-4,2016,20,24
896,172174,Viladamat,5,2016,27,22
897,172168,Viladasens,-7,2016,14,21
898,083015,Viladecans,127,2016,2770,2643
899,083008,Viladecavalls,48,2016,401,353
900,172180,Vilademuls,-12,2016,44,56
901,172207,Viladrau,11,2016,56,45
902,172214,Vilafant,-34,2016,277,311
903,083054,Vilafranca del Penedès,57,2016,1827,1770
904,252445,Vilagrassa,17,2016,53,36
905,172235,Vilajuïga,-9,2016,66,75
906,431750,Vilalba dels Arcs,0,2016,15,15
907,083067,Vilalba Sasserra,16,2016,82,66
908,252458,Vilaller,5,2016,21,16
909,172240,Vilallonga de Ter,3,2016,24,21
910,431665,Vilallonga del Camp,58,2016,155,97
911,172253,Vilamacolum,5,2016,35,30
912,172266,Vilamalla,25,2016,66,41
913,172272,Vilamaniscle,-1,2016,26,27
914,252477,Vilamòs,3,2016,31,28
915,172288,Vilanant,-4,2016,29,33
916,431671,Vilanova d'Escornalbou,-20,2016,18,38
917,252483,Vilanova de Bellpuig,7,2016,62,55
918,252496,Vilanova de l'Aguda,-3,2016,5,8
919,252542,Vilanova de la Barca,22,2016,55,33
920,252509,Vilanova de Meià,-7,2016,8,15
921,431687,Vilanova de Prades,3,2016,14,11
922,083036,Vilanova de Sau,4,2016,23,19
923,252516,Vilanova de Segrià,6,2016,66,60
924,083020,Vilanova del Camí,-63,2016,547,610
925,089024,Vilanova del Vallès,57,2016,328,271
926,083073,Vilanova i la Geltrú,210,2016,3000,2790
927,431690,Vilaplana,-10,2016,19,29
928,431704,Vila-rodona,8,2016,78,70
929,172305,Vila-sacra,-1,2016,54,55
930,252521,Vila-sana,-6,2016,30,36
931,431711,Vila-seca,-22,2016,1198,1220
932,082140,Vilassar de Dalt,80,2016,424,344
933,082191,Vilassar de Mar,1,2016,946,945
934,172229,Vilaür,-9,2016,12,21
935,431726,Vilaverd,-3,2016,14,17
936,431732,"Vilella Alta, la",-2,2016,5,7
937,431747,"Vilella Baixa, la",7,2016,12,5
938,172333,Vilobí d'Onyar,-10,2016,172,182
939,083041,Vilobí del Penedès,-12,2016,44,56
940,172327,Vilopriu,0,2016,13,13
941,252537,"Vilosell, el",-4,2016,11,15
942,431763,Vimbodí i Poblet,-20,2016,19,39
943,252555,Vinaixa,-13,2016,16,29
944,431779,Vinebre,1,2016,20,19
945,431785,Vinyols i els Arcs,17,2016,123,106
946,083089,Viver i Serrateix,10,2016,12,2
947,430521,Xerta,5,2016,48,43
0,250019,Abella de la Conca,-2,2017,5,7
1,080018,Abrera,-15,2017,622,637
2,250024,Àger,25,2017,41,16
3,250030,Agramunt,-15,2017,221,236
4,080023,Aguilar de Segarra,10,2017,19,9
5,170010,Agullana,-27,2017,62,89
6,080142,Aiguafreda,9,2017,161,152
7,430017,Aiguamúrcia,11,2017,60,49
8,170025,Aiguaviva,-10,2017,37,47
9,250387,Aitona,23,2017,182,159
10,250045,"Alamús, els",22,2017,45,23
11,250058,Alàs i Cerc,-6,2017,9,15
12,250061,"Albagés, l'",-11,2017,5,16
13,170031,Albanyà,0,2017,20,20
14,250077,Albatàrrec,52,2017,222,170
15,250083,Albesa,1,2017,85,84
16,250096,"Albi, l'",-11,2017,26,37
17,430022,Albinyana,31,2017,184,153
18,430038,"Albiol, l'",-16,2017,29,45
19,170046,Albons,4,2017,68,64
20,430043,Alcanar,-34,2017,463,497
21,250100,Alcanó,-6,2017,4,10
22,250117,Alcarràs,-13,2017,584,597
23,250122,Alcoletge,0,2017,206,206
24,430056,Alcover,-26,2017,166,192
25,439044,"Aldea, l'",13,2017,199,186
26,430069,Aldover,3,2017,28,25
27,430075,"Aleixar, l'",3,2017,20,17
28,080039,Alella,228,2017,715,487
29,430081,Alfara de Carles,11,2017,19,8
30,250138,Alfarràs,-36,2017,93,129
31,250143,Alfés,0,2017,19,19
32,430094,Alforja,36,2017,125,89
33,250156,Algerri,-12,2017,16,28
34,250169,Alguaire,-30,2017,129,159
35,250175,Alins,0,2017,16,16
36,430108,Alió,14,2017,35,21
37,250194,Almacelles,-8,2017,268,276
38,250208,Almatret,-4,2017,11,15
39,250215,Almenar,-18,2017,170,188
40,430115,Almoster,-9,2017,58,67
41,250220,Alòs de Balaguer,9,2017,13,4
42,170062,Alp,58,2017,155,97
43,080044,Alpens,-2,2017,12,14
44,250236,Alpicat,-36,2017,222,258
45,250241,Alt Àneu,2,2017,15,13
46,430120,Altafulla,13,2017,325,312
47,170078,Amer,21,2017,137,116
48,430136,"Ametlla de Mar, l'",-199,2017,309,508
49,080057,"Ametlla del Vallès, l'",126,2017,523,397
50,439060,"Ampolla, l'",-75,2017,238,313
51,430141,Amposta,189,2017,941,752
52,170084,Anglès,61,2017,359,298
53,250273,Anglesola,-12,2017,53,65
54,250292,Arbeca,-7,2017,70,77
55,430167,"Arboç, l'",35,2017,367,332
56,430154,Arbolí,-8,2017,5,13
57,170097,Arbúcies,124,2017,345,221
58,080060,Arenys de Mar,250,2017,1049,799
59,080076,Arenys de Munt,146,2017,537,391
60,170101,Argelaguer,1,2017,28,27
61,080082,Argençola,-4,2017,10,14
62,430173,"Argentera, l'",-6,2017,0,6
63,080095,Argentona,160,2017,693,533
64,170118,"Armentera, l'",14,2017,63,49
65,430189,Arnes,8,2017,28,20
66,250313,Arres,4,2017,4,0
67,250328,Arsèguel,5,2017,9,4
68,080109,Artés,76,2017,299,223
69,250334,Artesa de Lleida,-1,2017,60,61
70,250349,Artesa de Segre,-34,2017,136,170
71,430192,Ascó,-4,2017,55,59
72,250365,Aspa,2,2017,8,6
73,250371,"Avellanes i Santa Linya, les",4,2017,28,24
74,080116,Avià,6,2017,99,93
75,080121,Avinyó,34,2017,141,107
76,170123,Avinyonet de Puigventós,38,2017,137,99
77,080137,Avinyonet del Penedès,12,2017,117,105
78,080155,Badalona,2124,2017,11976,9852
79,089045,Badia del Vallès,6,2017,537,531
80,080168,Bagà,10,2017,106,96
81,250390,Baix Pallars,-7,2017,22,29
82,250404,Balaguer,222,2017,1003,781
83,080174,Balenyà,103,2017,247,144
84,080180,Balsareny,-2,2017,95,97
85,430206,Banyeres del Penedès,17,2017,207,190
86,170157,Banyoles,248,2017,956,708
87,250411,Barbens,35,2017,87,52
88,430213,Barberà de la Conca,1,2017,26,25
89,082520,Barberà del Vallès,-16,2017,1405,1421
90,080193,Barcelona,13036,2017,102468,89432
91,250426,"Baronia de Rialb, la",0,2017,4,4
92,170160,Bàscara,7,2017,57,50
93,250447,Bassella,1,2017,10,9
94,430228,Batea,-3,2017,31,34
95,250450,Bausen,-3,2017,1,4
96,080207,Begues,121,2017,441,320
97,170139,Begur,-12,2017,238,250
98,250463,Belianes,13,2017,26,13
99,251706,Bellaguarda,0,2017,10,10
100,170182,Bellcaire d'Empordà,5,2017,49,44
101,250479,Bellcaire d'Urgell,19,2017,60,41
102,250485,Bell-lloc d'Urgell,-18,2017,93,111
103,250498,Bellmunt d'Urgell,8,2017,10,2
104,430234,Bellmunt del Priorat,0,2017,12,12
105,080214,Bellprat,-1,2017,1,2
106,250501,Bellpuig,24,2017,329,305
107,430249,Bellvei,-2,2017,153,155
108,250518,Bellver de Cerdanya,13,2017,122,109
109,250523,Bellvís,-14,2017,81,95
110,250539,Benavent de Segrià,22,2017,80,58
111,430252,Benifallet,0,2017,21,21
112,430265,Benissanet,-8,2017,58,66
113,080229,Berga,189,2017,883,694
114,170195,Besalú,40,2017,113,73
115,170209,Bescanó,-1,2017,172,173
116,170216,Beuda,4,2017,19,15
117,080235,Bigues i Riells del Fai,48,2017,503,455
118,250557,Biosca,-4,2017,6,10
119,170221,"Bisbal d'Empordà, la",84,2017,559,475
120,430271,"Bisbal de Falset, la",1,2017,7,6
121,430287,"Bisbal del Penedès, la",23,2017,241,218
122,172348,Biure,8,2017,18,10
123,430290,Blancafort,-2,2017,25,27
124,170237,Blanes,197,2017,2170,1973
125,170293,Boadella i les Escaules,2,2017,15,13
126,170242,Bolvir,3,2017,29,26
127,430304,Bonastre,20,2017,62,42
128,250576,"Bòrdes, Es",16,2017,37,21
129,170255,Bordils,1,2017,108,107
130,250582,"Borges Blanques, les",11,2017,283,272
131,430311,"Borges del Camp, les",22,2017,111,89
132,170268,Borrassà,0,2017,26,26
133,080240,Borredà,-15,2017,22,37
134,250595,Bossòst,11,2017,68,57
135,430326,Bot,3,2017,20,17
136,430332,Botarell,-10,2017,56,66
137,250560,Bovera,-5,2017,5,10
138,430347,Bràfim,3,2017,32,29
139,170274,Breda,1,2017,150,149
140,080253,"Bruc, el",43,2017,155,112
141,080266,"Brull, el",-2,2017,9,11
142,170280,Brunyola i Sant Martí Sapresa,1,2017,20,19
143,430350,Cabacés,-4,2017,8,12
144,250609,Cabanabona,0,2017,4,4
145,170314,Cabanelles,5,2017,32,27
146,170307,Cabanes,37,2017,77,40
147,080272,"Cabanyes, les",15,2017,47,32
148,250616,Cabó,4,2017,4,0
149,430363,Cabra del Camp,18,2017,79,61
150,080288,Cabrera d'Anoia,19,2017,118,99
151,080291,Cabrera de Mar,66,2017,311,245
152,080305,Cabrils,46,2017,484,438
153,170329,Cadaqués,-34,2017,154,188
154,080312,Calaf,52,2017,220,168
155,430379,Calafell,656,2017,2521,1865
156,080348,Calders,-23,2017,52,75
157,080327,Caldes d'Estrac,47,2017,287,240
158,170335,Caldes de Malavella,111,2017,514,403
159,080333,Caldes de Montbui,229,2017,904,675
160,080351,Calella,422,2017,1505,1083
161,080370,Calldetenes,46,2017,134,88
162,080386,Callús,24,2017,136,112
163,080364,Calonge de Segarra,-4,2017,4,8
164,170340,Calonge i Sant Antoni,107,2017,842,735
165,250621,Camarasa,-6,2017,34,40
166,439039,Camarles,28,2017,138,110
167,430385,Cambrils,638,2017,2570,1932
168,170353,Camós,3,2017,22,19
169,170366,Campdevànol,2,2017,105,103
170,170372,Campelles,-3,2017,9,12
171,080399,Campins,8,2017,47,39
172,170388,Campllong,11,2017,25,14
173,170391,Camprodon,55,2017,167,112
174,250637,Canejan,-1,2017,4,5
175,170405,Canet d'Adri,8,2017,33,25
176,080403,Canet de Mar,274,2017,917,643
177,439076,"Canonja, la",13,2017,280,267
178,080410,Canovelles,239,2017,1085,846
179,080425,Cànoves i Samalús,78,2017,218,140
180,170412,Cantallops,-1,2017,20,21
181,080431,Canyelles,104,2017,353,249
182,430398,Capafonts,-5,2017,8,13
183,430402,Capçanes,-2,2017,6,8
184,080446,Capellades,5,2017,266,261
185,170427,Capmany,-6,2017,28,34
186,080459,Capolat,-3,2017,5,8
187,080462,Cardedeu,100,2017,886,786
188,080478,Cardona,-21,2017,111,132
189,080484,Carme,3,2017,36,33
190,430419,Caseres,1,2017,6,5
191,170448,Cassà de la Selva,131,2017,571,440
192,080497,Casserres,25,2017,79,54
193,080575,Castell de l'Areny,4,2017,7,3
194,259046,Castell de Mur,-2,2017,3,5
195,250642,Castellar de la Ribera,-4,2017,1,5
196,080522,Castellar de n'Hug,4,2017,17,13
197,080500,Castellar del Riu,-1,2017,8,9
198,080517,Castellar del Vallès,229,2017,1051,822
199,080538,Castellbell i el Vilar,3,2017,203,200
200,080543,Castellbisbal,58,2017,580,522
201,080556,Castellcir,9,2017,50,41
202,250674,Castelldans,-11,2017,38,49
203,080569,Castelldefels,611,2017,4742,4131
204,080581,Castellet i la Gornal,14,2017,140,126
205,170464,Castellfollit de la Roca,6,2017,60,54
206,080608,Castellfollit de Riubregós,-4,2017,7,11
207,080594,Castellfollit del Boix,7,2017,19,12
208,080615,Castellgalí,28,2017,164,136
209,080620,Castellnou de Bages,25,2017,83,58
210,250680,Castellnou de Seana,5,2017,35,30
211,170470,Castelló d'Empúries,-8,2017,914,922
212,250693,Castelló de Farfanya,9,2017,41,32
213,080636,Castellolí,8,2017,19,11
214,170486,Castell-Platja d'Aro,-11,2017,1008,1019
215,250707,Castellserà,-4,2017,30,34
216,080641,Castellterçol,61,2017,181,120
217,430424,Castellvell del Camp,21,2017,128,107
218,080654,Castellví de la Marca,-5,2017,70,75
219,080667,Castellví de Rosanes,43,2017,175,132
220,430430,"Catllar, el",102,2017,310,208
221,250714,Cava,-5,2017,1,6
222,171899,"Cellera de Ter, la",-18,2017,94,112
223,170499,Celrà,-3,2017,295,298
224,080673,Centelles,28,2017,284,256
225,082687,Cercs,0,2017,60,60
226,082665,Cerdanyola del Vallès,138,2017,2965,2827
227,080689,Cervelló,72,2017,560,488
228,250729,Cervera,86,2017,422,336
229,250735,Cervià de les Garrigues,-3,2017,11,14
230,170502,Cervià de Ter,29,2017,70,41
231,170519,Cistella,-4,2017,17,21
232,250740,Ciutadilla,4,2017,11,7
233,250753,Clariana de Cardener,0,2017,3,3
234,250766,"Cogul, el",6,2017,12,6
235,170545,Colera,-35,2017,22,57
236,250772,Coll de Nargó,-3,2017,20,23
237,080692,Collbató,64,2017,276,212
238,430458,Colldejou,-2,2017,5,7
239,080706,Collsuspina,0,2017,21,21
240,170558,Colomers,-1,2017,11,12
241,251636,"Coma i la Pedra, la",8,2017,21,13
242,251615,Conca de Dalt,-15,2017,12,27
243,430461,Conesa,-6,2017,5,11
244,430477,Constantí,14,2017,362,348
245,080713,Copons,-14,2017,15,29
246,430483,Corbera d'Ebre,-8,2017,29,37
247,080728,Corbera de Llobregat,171,2017,863,692
248,250788,Corbins,14,2017,68,54
249,170577,Corçà,-4,2017,61,65
250,080734,Cornellà de Llobregat,321,2017,4847,4526
251,170561,Cornellà del Terri,40,2017,155,115
252,430496,Cornudella de Montsant,23,2017,54,31
253,430509,Creixell,69,2017,371,302
254,170583,Crespià,-4,2017,22,26
255,179011,"Cruïlles, Monells i Sant Sadurní de l'Heura",-7,2017,71,78
256,080749,Cubelles,274,2017,1295,1021
257,250791,Cubells,-10,2017,13,23
258,430516,Cunit,418,2017,1358,940
259,170600,Darnius,3,2017,34,31
260,170617,Das,3,2017,14,11
261,439018,Deltebre,33,2017,393,360
262,080752,Dosrius,51,2017,394,343
263,430537,Duesaigües,-6,2017,7,13
264,170622,"Escala, l'",44,2017,546,502
265,080765,Esparreguera,150,2017,1156,1006
266,170638,Espinelves,1,2017,18,17
267,250812,"Espluga Calba, l'",-2,2017,8,10
268,430542,"Espluga de Francolí, l'",1,2017,134,133
269,080771,Esplugues de Llobregat,554,2017,2961,2407
270,170643,Espolla,2,2017,10,8
271,170656,Esponellà,-5,2017,24,29
272,250827,Espot,-8,2017,12,20
273,080787,"Espunyola, l'",20,2017,26,6
274,082541,"Esquirol, l'",5,2017,90,85
275,250886,Estamariu,-5,2017,1,6
276,080790,"Estany, l'",-5,2017,19,24
277,250851,Estaràs,-1,2017,4,5
278,250864,Esterri d'Àneu,-11,2017,48,59
279,250870,Esterri de Cardós,1,2017,3,2
280,430555,Falset,7,2017,111,104
281,170059,"Far d'Empordà, el",1,2017,24,23
282,250899,Farrera,2,2017,9,7
283,430568,"Fatarella, la",1,2017,10,9
284,430574,"Febró, la",1,2017,1,0
285,081347,Figaró-Montmany,44,2017,112,68
286,080804,Fígols,0,2017,2,2
287,259084,Fígols i Alinyà,9,2017,13,4
288,430580,"Figuera, la",4,2017,9,5
289,170669,Figueres,208,2017,2960,2752
290,430593,Figuerola del Camp,-17,2017,18,35
291,170675,Flaçà,32,2017,79,47
292,430607,Flix,-32,2017,112,144
293,250925,"Floresta, la",-1,2017,6,7
294,080826,Fogars de la Selva,16,2017,122,106
295,080811,Fogars de Montclús,7,2017,35,28
296,170681,Foixà,-5,2017,11,16
297,080832,Folgueroles,-24,2017,55,79
298,250931,Fondarella,-1,2017,53,54
299,080847,Fonollosa,30,2017,79,49
300,170694,Fontanals de Cerdanya,9,2017,34,25
301,170708,Fontanilles,1,2017,7,6
302,170715,Fontcoberta,-5,2017,50,55
303,080850,Font-rubí,13,2017,58,45
304,250946,Foradada,6,2017,12,6
305,179026,Forallac,22,2017,89,67
306,430614,Forès,-1,2017,3,4
307,170736,Fornells de la Selva,26,2017,153,127
308,170741,Fortià,9,2017,52,43
309,080863,"Franqueses del Vallès, les",139,2017,1231,1092
310,430629,Freginals,-13,2017,12,25
311,250962,"Fuliola, la",0,2017,53,53
312,250978,Fulleda,-2,2017,3,5
313,080902,Gaià,2,2017,15,13
314,430635,"Galera, la",10,2017,38,28
315,080879,Gallifa,-9,2017,4,13
316,430640,Gandesa,5,2017,112,107
317,430653,Garcia,-1,2017,37,38
318,430666,"Garidells, els",7,2017,15,8
319,080885,"Garriga, la",234,2017,856,622
320,170754,Garrigàs,6,2017,29,23
321,170767,Garrigoles,4,2017,15,11
322,170773,Garriguella,-18,2017,54,72
323,080898,Gavà,286,2017,2652,2366
324,250984,Gavet de la Conca,1,2017,16,15
325,080919,Gelida,57,2017,441,384
326,170789,Ger,3,2017,33,30
327,259123,Gimenells i el Pla de la Font,16,2017,47,31
328,430672,Ginestar,-6,2017,29,35
329,170792,Girona,764,2017,6518,5754
330,080924,Gironella,78,2017,232,154
331,080930,Gisclareny,0,2017,0,0
332,430688,Godall,-8,2017,13,21
333,250997,Golmés,7,2017,107,100
334,170806,Gombrèn,2,2017,14,12
335,251001,Gósol,-7,2017,8,15
336,080945,"Granada, la",16,2017,145,129
337,251018,"Granadella, la",5,2017,33,28
338,080958,Granera,4,2017,8,4
339,251023,"Granja d'Escarp, la",-2,2017,65,67
340,080961,Granollers,456,2017,3807,3351
341,251039,Granyanella,-3,2017,1,4
342,251057,Granyena de les Garrigues,-6,2017,3,9
343,251044,Granyena de Segarra,0,2017,3,3
344,430691,Gratallops,-7,2017,7,14
345,080977,Gualba,49,2017,120,71
346,170813,Gualta,2,2017,58,56
347,080996,Guardiola de Berguedà,-10,2017,53,63
348,430705,"Guiamets, els",-2,2017,14,16
349,170828,Guils de Cerdanya,7,2017,34,27
350,251095,Guimerà,4,2017,11,7
351,259031,"Guingueta d'Àneu, la",-12,2017,21,33
352,251109,Guissona,-1,2017,419,420
353,251116,Guixers,-4,2017,6,10
354,081000,Gurb,39,2017,123,84
355,430712,Horta de Sant Joan,-12,2017,23,35
356,081017,"Hospitalet de Llobregat, l'",4760,2017,20960,16200
357,081629,"Hostalets de Pierola, els",-1,2017,206,207
358,170834,Hostalric,39,2017,237,198
359,081022,Igualada,194,2017,2188,1994
360,251155,Isona i Conca Dellà,3,2017,55,52
361,170849,Isòvol,4,2017,19,15
362,251137,Ivars d'Urgell,-2,2017,60,62
363,251121,Ivars de Noguera,7,2017,15,8
364,251142,Ivorra,-2,2017,2,4
365,170852,Jafre,0,2017,20,20
366,170865,"Jonquera, la",65,2017,287,222
367,081038,Jorba,23,2017,71,48
368,259101,Josa i Tuixén,5,2017,10,5
369,170871,Juià,0,2017,67,67
370,251180,Juncosa,-4,2017,14,18
371,251193,Juneda,81,2017,183,102
372,251214,Les,10,2017,88,78
373,251229,Linyola,27,2017,115,88
374,081043,"Llacuna, la",2,2017,45,43
375,170887,Lladó,11,2017,59,48
376,251235,Lladorre,-2,2017,5,7
377,251240,Lladurs,-7,2017,8,15
378,081056,"Llagosta, la",47,2017,755,708
379,170890,Llagostera,87,2017,480,393
380,170904,Llambilles,-19,2017,31,50
381,170911,Llanars,7,2017,40,33
382,170926,Llançà,47,2017,300,253
383,251253,Llardecans,-4,2017,15,19
384,251266,Llavorsí,1,2017,15,14
385,251207,Lleida,5,2017,6203,6198
386,170932,Llers,30,2017,95,65
387,251272,Lles de Cerdanya,2,2017,8,6
388,081075,Lliçà d'Amunt,188,2017,887,699
389,081081,Lliçà de Vall,87,2017,375,288
390,251288,Llimiana,1,2017,9,8
391,081069,Llinars del Vallès,117,2017,620,503
392,170947,Llívia,23,2017,107,84
393,430727,"Lloar, el",2,2017,12,10
394,251291,Llobera,-5,2017,8,13
395,430733,Llorac,8,2017,11,3
396,430748,Llorenç del Penedès,42,2017,161,119
397,170950,Lloret de Mar,-193,2017,2928,3121
398,170963,"Llosses, les",11,2017,25,14
399,081094,Lluçà,1,2017,4,3
400,171024,Maçanet de Cabrenys,-15,2017,29,44
401,171030,Maçanet de la Selva,108,2017,472,364
402,170979,Madremanya,1,2017,30,29
403,170985,Maià de Montcal,4,2017,21,17
404,251333,Maials,-1,2017,38,39
405,251305,Maldà,-1,2017,5,6
406,081108,Malgrat de Mar,152,2017,1013,861
407,081115,Malla,8,2017,19,11
408,081120,Manlleu,242,2017,1031,789
409,081136,Manresa,700,2017,4131,3431
410,430764,Marçà,3,2017,30,27
411,430751,Margalef,-1,2017,2,3
412,082423,Marganell,8,2017,25,17
413,081141,Martorell,-183,2017,1436,1619
414,081154,Martorelles,64,2017,311,247
415,430770,Mas de Barberans,-1,2017,15,16
416,171002,Masarac,-9,2017,16,25
417,430786,Masdenverge,7,2017,51,44
418,081167,"Masies de Roda, les",-2,2017,34,36
419,081173,"Masies de Voltregà, les",-9,2017,116,125
420,430799,Masllorenç,4,2017,37,33
421,081189,"Masnou, el",116,2017,1263,1147
422,430803,"Masó, la",-4,2017,6,10
423,430810,Maspujols,12,2017,42,30
424,081192,Masquefa,119,2017,512,393
425,430825,"Masroig, el",-8,2017,15,23
426,251312,Massalcoreig,-2,2017,50,52
427,171019,Massanes,1,2017,44,43
428,251327,Massoteres,21,2017,28,7
429,081206,Matadepera,132,2017,493,361
430,081213,Mataró,806,2017,5677,4871
431,171045,Medinyà,0,2017,0,0
432,081228,Mediona,105,2017,239,134
433,251348,Menàrguens,-5,2017,21,26
434,170998,Meranges,0,2017,4,4
435,171058,Mieres,-6,2017,16,22
436,430831,"Milà, el",2,2017,7,5
437,251351,Miralcamp,-7,2017,44,51
438,430846,Miravet,-16,2017,21,37
439,081385,Moià,137,2017,373,236
440,430859,"Molar, el",1,2017,15,14
441,081234,Molins de Rei,166,2017,966,800
442,251370,Mollerussa,184,2017,897,713
443,171061,Mollet de Peralada,5,2017,22,17
444,081249,Mollet del Vallès,-70,2017,2414,2484
445,171077,Molló,-9,2017,19,28
446,251364,"Molsosa, la",1,2017,7,6
447,081287,Monistrol de Calders,0,2017,39,39
448,081271,Monistrol de Montserrat,23,2017,238,215
449,171096,Montagut i Oix,-15,2017,38,53
450,430862,Montblanc,28,2017,277,249
451,430884,Montbrió del Camp,-1,2017,197,198
452,081252,Montcada i Reixac,482,2017,2069,1587
453,081304,Montclar,10,2017,11,1
454,251399,Montellà i Martinet,5,2017,45,40
455,081311,Montesquiu,13,2017,77,64
456,251403,Montferrer i Castellbò,-12,2017,65,77
457,430897,Montferri,-5,2017,33,38
458,251386,Montgai,9,2017,19,10
459,081265,Montgat,12,2017,659,647
460,081326,Montmajor,0,2017,22,22
461,081332,Montmaneu,4,2017,12,8
462,430901,"Montmell, el",46,2017,146,100
463,081350,Montmeló,39,2017,386,347
464,251425,Montoliu de Lleida,6,2017,27,21
465,251410,Montoliu de Segarra,16,2017,19,3
466,251431,Montornès de Segarra,0,2017,4,4
467,081363,Montornès del Vallès,-12,2017,784,796
468,430918,Mont-ral,7,2017,14,7
469,171100,Mont-ras,-17,2017,68,85
470,430923,Mont-roig del Camp,242,2017,985,743
471,081379,Montseny,-18,2017,15,33
472,430939,Móra d'Ebre,57,2017,318,261
473,430944,Móra la Nova,27,2017,160,133
474,430957,"Morell, el",12,2017,251,239
475,430960,"Morera de Montsant, la",3,2017,10,7
476,081290,Muntanyola,8,2017,44,36
477,081398,Mura,-1,2017,16,17
478,251459,Nalec,-8,2017,0,8
479,250254,Naut Aran,10,2017,79,69
480,081402,Navarcles,33,2017,258,225
481,081419,Navàs,25,2017,214,189
482,171117,Navata,20,2017,96,76
483,251462,Navès,-2,2017,21,23
484,081424,"Nou de Berguedà, la",3,2017,7,4
485,430976,"Nou de Gaià, la",11,2017,27,16
486,430982,Nulles,11,2017,40,29
487,251484,Odèn,6,2017,10,4
488,081430,Òdena,10,2017,232,222
489,171122,Ogassa,-3,2017,5,8
490,081458,Olèrdola,43,2017,241,198
491,081461,Olesa de Bonesvalls,61,2017,157,96
492,081477,Olesa de Montserrat,195,2017,1071,876
493,251497,Oliana,-20,2017,49,69
494,251500,Oliola,-10,2017,3,13
495,251517,Olius,25,2017,56,31
496,081483,Olivella,101,2017,409,308
497,081496,Olost,-4,2017,41,45
498,171143,Olot,531,2017,1728,1197
499,251522,"Oluges, les",17,2017,17,0
500,081445,Olvan,0,2017,40,40
501,251538,"Omellons, els",1,2017,7,6
502,251543,"Omells de na Gaia, els",1,2017,4,3
503,171156,Ordis,9,2017,21,12
504,251556,Organyà,-9,2017,35,44
505,081509,Orís,-5,2017,12,17
506,081516,Oristà,-5,2017,23,28
507,081521,Orpí,3,2017,5,2
508,081537,Òrrius,36,2017,80,44
509,251569,Os de Balaguer,6,2017,56,50
510,171169,Osor,8,2017,28,20
511,251575,Ossó de Sió,-6,2017,2,8
512,081542,Pacs del Penedès,8,2017,59,51
513,081555,Palafolls,96,2017,552,456
514,171175,Palafrugell,193,2017,1166,973
515,171181,Palamós,193,2017,1063,870
516,251581,"Palau d'Anglesola, el",-25,2017,73,98
517,171194,Palau de Santa Eulàlia,0,2017,3,3
518,171215,Palau-sator,9,2017,19,10
519,171208,Palau-saverdera,-19,2017,98,117
520,081568,Palau-solità i Plegamans,54,2017,670,616
521,431009,"Pallaresos, els",109,2017,302,193
522,081574,Pallejà,76,2017,576,500
523,430995,"Palma d'Ebre, la",-4,2017,7,11
524,089058,"Palma de Cervelló, la",-15,2017,191,206
525,171236,Palol de Revardit,-6,2017,14,20
526,171241,Pals,8,2017,149,141
527,081580,"Papiol, el",9,2017,205,196
528,171254,Pardines,2,2017,7,5
529,081593,Parets del Vallès,32,2017,855,823
530,171267,Parlavà,-1,2017,18,19
531,431016,Passanant i Belltall,0,2017,7,7
532,171289,Pau,0,2017,33,33
533,431021,Paüls,-4,2017,12,16
534,171292,Pedret i Marzà,11,2017,15,4
535,251641,Penelles,7,2017,23,16
536,171306,"Pera, la",-5,2017,15,20
537,081607,Perafita,4,2017,18,14
538,431037,Perafort,7,2017,77,70
539,171328,Peralada,37,2017,127,90
540,251654,Peramola,19,2017,29,10
541,431042,"Perelló, el",-16,2017,142,158
542,081614,Piera,196,2017,969,773
543,431055,"Piles, les",-7,2017,3,10
544,081635,Pineda de Mar,374,2017,1854,1480
545,431068,"Pinell de Brai, el",-3,2017,26,29
546,251667,Pinell de Solsonès,-5,2017,5,10
547,251673,Pinós,-5,2017,14,19
548,431074,Pira,-3,2017,12,15
549,431080,"Pla de Santa Maria, el",43,2017,150,107
550,081640,"Pla del Penedès, el",20,2017,82,62
551,171334,"Planes d'Hostoles, les",48,2017,98,50
552,171349,Planoles,7,2017,19,12
553,259118,"Plans de Sió, els",7,2017,36,29
554,251689,"Poal, el",-8,2017,18,26
555,251692,"Pobla de Cérvoles, la",-1,2017,5,6
556,081653,"Pobla de Claramunt, la",-7,2017,111,118
557,081666,"Pobla de Lillet, la",26,2017,59,33
558,431093,"Pobla de Mafumet, la",18,2017,310,292
559,431107,"Pobla de Massaluca, la",-2,2017,10,12
560,431114,"Pobla de Montornès, la",48,2017,220,172
561,251713,"Pobla de Segur, la",32,2017,180,148
562,431129,Poboleda,-18,2017,7,25
563,081672,Polinyà,-37,2017,395,432
564,431135,"Pont d'Armentera, el",13,2017,39,26
565,250306,"Pont de Bar, el",-1,2017,19,20
566,171352,Pont de Molins,3,2017,42,39
567,251734,"Pont de Suert, el",-9,2017,86,95
568,081825,"Pont de Vilomara i Rocafort, el",6,2017,155,149
569,431418,Pontils,-2,2017,8,10
570,081688,Pontons,1,2017,47,46
571,171365,Pontós,11,2017,26,15
572,251728,Ponts,-15,2017,150,165
573,171371,Porqueres,-19,2017,177,196
574,431140,Porrera,4,2017,13,9
575,171404,"Port de la Selva, el",-21,2017,45,66
576,171387,Portbou,-13,2017,68,81
577,251749,"Portella, la",2,2017,60,58
578,431153,Pradell de la Teixeta,-3,2017,4,7
579,431166,Prades,-5,2017,23,28
580,431172,Prat de Comte,0,2017,2,2
581,081691,"Prat de Llobregat, el",330,2017,2606,2276
582,431188,Pratdip,-6,2017,55,61
583,081712,Prats de Lluçanès,10,2017,107,97
584,081705,"Prats de Rei, els",4,2017,29,25
585,251752,Prats i Sansor,-2,2017,13,15
586,251765,Preixana,12,2017,24,12
587,251771,Preixens,-7,2017,18,25
588,082303,Premià de Dalt,40,2017,559,519
589,081727,Premià de Mar,73,2017,1425,1352
590,171390,"Preses, les",-2,2017,86,88
591,251790,Prullans,-2,2017,20,22
592,171411,Puigcerdà,-174,2017,643,817
593,081748,Puigdàlber,17,2017,35,18
594,251804,Puiggròs,-3,2017,9,12
595,431191,Puigpelat,-4,2017,55,59
596,081751,Puig-reig,61,2017,201,140
597,251811,Puigverd d'Agramunt,10,2017,23,13
598,251826,Puigverd de Lleida,23,2017,51,28
599,081764,Pujalt,0,2017,6,6
600,081770,"Quar, la",-4,2017,2,6
601,171426,Quart,58,2017,227,169
602,170433,Queralbs,9,2017,11,2
603,431205,Querol,-8,2017,58,66
604,171432,Rabós,11,2017,18,7
605,081786,Rajadell,6,2017,33,27
606,431212,Rasquera,2,2017,22,20
607,171447,Regencós,-2,2017,12,14
608,081799,Rellinars,7,2017,65,58
609,431227,Renau,-1,2017,5,6
610,431233,Reus,35,2017,4129,4094
611,251832,Rialp,7,2017,45,38
612,431248,"Riba, la",-17,2017,17,34
613,431251,Riba-roja d'Ebre,8,2017,43,35
614,259059,Ribera d'Ondara,-4,2017,17,21
615,251850,Ribera d'Urgellet,-5,2017,69,74
616,171450,Ribes de Freser,3,2017,86,83
617,171463,Riells i Viabrea,73,2017,358,285
618,431264,"Riera de Gaià, la",-4,2017,86,90
619,251863,Riner,1,2017,5,4
620,171479,Ripoll,68,2017,475,407
621,081803,Ripollet,440,2017,2081,1641
622,259139,Riu de Cerdanya,1,2017,7,6
623,171485,Riudarenes,36,2017,173,137
624,171498,Riudaura,-7,2017,11,18
625,431270,Riudecanyes,49,2017,96,47
626,431286,Riudecols,22,2017,75,53
627,171501,Riudellots de la Selva,24,2017,138,114
628,431299,Riudoms,83,2017,288,205
629,171518,Riumors,1,2017,21,20
630,081810,"Roca del Vallès, la",108,2017,569,461
631,431303,Rocafort de Queralt,14,2017,34,20
632,431310,Roda de Berà,130,2017,545,415
633,081831,Roda de Ter,95,2017,330,235
634,431325,Rodonyà,-8,2017,22,30
635,431331,Roquetes,-119,2017,371,490
636,171523,Roses,78,2017,1222,1144
637,251898,Rosselló,41,2017,258,217
638,431346,"Rourell, el",16,2017,41,25
639,081846,Rubí,665,2017,3585,2920
640,081859,Rubió,0,2017,11,11
641,171539,Rupià,3,2017,13,10
642,089019,Rupit i Pruit,3,2017,15,12
643,081878,Sabadell,2093,2017,9789,7696
644,081884,Sagàs,6,2017,9,3
645,251902,Salàs de Pallars,0,2017,21,21
646,081901,Saldes,-6,2017,10,16
647,171544,Sales de Llierca,2,2017,5,3
648,081918,Sallent,78,2017,233,155
649,431359,Salomó,24,2017,38,14
650,439057,Salou,370,2017,2610,2240
651,171557,Salt,716,2017,2435,1719
652,251919,Sanaüja,-4,2017,8,12
653,081944,Sant Adrià de Besòs,6,2017,2653,2647
654,081957,Sant Agustí de Lluçanès,2,2017,4,2
655,081960,Sant Andreu de la Barca,-4,2017,1319,1323
656,081976,Sant Andreu de Llavaneres,132,2017,822,690
657,171576,Sant Andreu Salou,7,2017,9,2
658,171833,Sant Aniol de Finestres,-10,2017,17,27
659,081982,Sant Antoni de Vilamajor,74,2017,415,341
660,081995,Sant Bartomeu del Grau,-17,2017,42,59
661,082009,Sant Boi de Llobregat,518,2017,3544,3026
662,082016,Sant Boi de Lluçanès,30,2017,50,20
663,431362,Sant Carles de la Ràpita,-99,2017,832,931
664,082037,Sant Cebrià de Vallalta,32,2017,236,204
665,082021,Sant Celoni,194,2017,1010,816
666,082042,Sant Climent de Llobregat,43,2017,209,166
667,171582,Sant Climent Sescebes,0,2017,84,84
668,082055,Sant Cugat del Vallès,517,2017,5164,4647
669,082068,Sant Cugat Sesgarrigues,12,2017,40,28
670,251961,Sant Esteve de la Sarga,4,2017,7,3
671,082074,Sant Esteve de Palautordera,83,2017,193,110
672,082080,Sant Esteve Sesrovires,133,2017,486,353
673,171595,Sant Feliu de Buixalleu,-16,2017,45,61
674,082107,Sant Feliu de Codines,119,2017,488,369
675,171609,Sant Feliu de Guíxols,176,2017,1367,1191
676,082114,Sant Feliu de Llobregat,270,2017,1907,1637
677,171616,Sant Feliu de Pallerols,8,2017,83,75
678,082129,Sant Feliu Sasserra,-6,2017,13,19
679,171621,Sant Ferriol,16,2017,31,15
680,082093,Sant Fost de Campsentelles,118,2017,550,432
681,082135,Sant Fruitós de Bages,88,2017,452,364
682,171637,Sant Gregori,95,2017,230,135
683,251924,Sant Guim de Freixenet,19,2017,66,47
684,251977,Sant Guim de la Plana,6,2017,12,6
685,171642,Sant Hilari Sacalm,18,2017,238,220
686,082153,Sant Hipòlit de Voltregà,40,2017,184,144
687,081939,Sant Iscle de Vallalta,8,2017,107,99
688,439023,Sant Jaume d'Enveja,16,2017,146,130
689,082166,Sant Jaume de Frontanyà,0,2017,2,2
690,171655,Sant Jaume de Llierca,-7,2017,51,58
691,431378,Sant Jaume dels Domenys,-9,2017,173,182
692,171674,Sant Joan de les Abadesses,-13,2017,113,126
693,171680,Sant Joan de Mollet,8,2017,31,23
694,082188,Sant Joan de Vilatorrada,26,2017,437,411
695,082172,Sant Joan Despí,159,2017,1638,1479
696,171851,Sant Joan les Fonts,58,2017,179,121
697,171668,Sant Jordi Desvalls,-3,2017,42,45
698,089030,Sant Julià de Cerdanyola,1,2017,10,9
699,171693,Sant Julià de Ramis,9,2017,227,218
700,082205,Sant Julià de Vilatorta,5,2017,124,119
701,179032,Sant Julià del Llor i Bonmatí,-31,2017,98,129
702,082212,Sant Just Desvern,277,2017,1219,942
703,082227,Sant Llorenç d'Hortons,50,2017,168,118
704,171714,Sant Llorenç de la Muga,-1,2017,11,12
705,251930,Sant Llorenç de Morunys,5,2017,53,48
706,082233,Sant Llorenç Savall,16,2017,115,99
707,082251,Sant Martí d'Albars,6,2017,11,5
708,082248,Sant Martí de Centelles,0,2017,105,105
709,171729,Sant Martí de Llémena,19,2017,62,43
710,259025,Sant Martí de Riucorb,-1,2017,25,26
711,082264,Sant Martí de Tous,11,2017,40,29
712,082270,Sant Martí Sarroca,36,2017,218,182
713,082286,Sant Martí Sesgueioles,-3,2017,10,13
714,171735,Sant Martí Vell,4,2017,14,10
715,082299,Sant Mateu de Bages,-7,2017,18,25
716,171740,Sant Miquel de Campmajor,-1,2017,9,10
717,171753,Sant Miquel de Fluvià,-4,2017,47,51
718,171766,Sant Mori,6,2017,18,12
719,171772,Sant Pau de Segúries,31,2017,55,24
720,082310,Sant Pere de Ribes,258,2017,2118,1860
721,082325,Sant Pere de Riudebitlles,-7,2017,98,105
722,082331,Sant Pere de Torelló,-13,2017,99,112
723,082346,Sant Pere de Vilamajor,45,2017,285,240
724,171788,Sant Pere Pescador,8,2017,159,151
725,081897,Sant Pere Sallavinera,0,2017,7,7
726,082359,Sant Pol de Mar,87,2017,399,312
727,082362,Sant Quintí de Mediona,30,2017,158,128
728,082378,Sant Quirze de Besora,38,2017,129,91
729,082384,Sant Quirze del Vallès,39,2017,956,917
730,082397,Sant Quirze Safaja,11,2017,48,37
731,251945,Sant Ramon,2,2017,27,25
732,082401,Sant Sadurní d'Anoia,114,2017,588,474
733,082418,Sant Sadurní d'Osormort,4,2017,5,1
734,080983,Sant Salvador de Guardiola,43,2017,275,232
735,082628,Sant Vicenç de Castellet,30,2017,522,492
736,082649,Sant Vicenç de Montalt,130,2017,550,420
737,082652,Sant Vicenç de Torelló,22,2017,91,69
738,082634,Sant Vicenç dels Horts,-33,2017,1108,1141
739,431384,Santa Bàrbara,-10,2017,194,204
740,082439,Santa Cecília de Voltregà,1,2017,6,5
741,082444,Santa Coloma de Cervelló,84,2017,413,329
742,171805,Santa Coloma de Farners,-16,2017,628,644
743,082457,Santa Coloma de Gramenet,1153,2017,7881,6728
744,431397,Santa Coloma de Queralt,-14,2017,98,112
745,171812,Santa Cristina d'Aro,6,2017,332,326
746,082460,Santa Eugènia de Berga,-13,2017,109,122
747,082476,Santa Eulàlia de Riuprimer,12,2017,69,57
748,082482,Santa Eulàlia de Ronçana,71,2017,400,329
749,082495,Santa Fe del Penedès,-1,2017,11,12
750,171827,Santa Llogaia d'Àlguema,12,2017,33,21
751,082508,Santa Margarida de Montbui,124,2017,584,460
752,082515,Santa Margarida i els Monjos,19,2017,388,369
753,082589,Santa Maria d'Oló,-1,2017,35,36
754,082536,Santa Maria de Besora,-5,2017,6,11
755,082567,Santa Maria de Martorelles,27,2017,69,42
756,082554,Santa Maria de Merlès,-6,2017,8,14
757,082573,Santa Maria de Miralles,6,2017,11,5
758,082592,Santa Maria de Palautordera,31,2017,513,482
759,431401,Santa Oliva,11,2017,254,243
760,171848,Santa Pau,36,2017,76,40
761,082606,Santa Perpètua de Mogoda,66,2017,1197,1131
762,082613,Santa Susanna,18,2017,293,275
763,081923,Santpedor,22,2017,261,239
764,431423,Sarral,-13,2017,60,73
765,171864,Sarrià de Ter,51,2017,346,295
766,252017,Sarroca de Bellera,0,2017,6,6
767,252000,Sarroca de Lleida,-4,2017,11,15
768,171870,"Saus, Camallera i Llampaies",15,2017,57,42
769,431439,Savallà del Comtat,4,2017,8,4
770,431444,"Secuita, la",21,2017,111,90
771,171886,"Selva de Mar, la",4,2017,12,8
772,431457,"Selva del Camp, la",104,2017,284,180
773,431460,Senan,-2,2017,2,4
774,430445,"Sénia, la",0,2017,220,220
775,252022,Senterada,7,2017,12,5
776,250352,"Sentiu de Sió, la",-13,2017,29,42
777,082671,Sentmenat,114,2017,484,370
778,171903,Serinyà,-8,2017,40,48
779,252043,Seròs,-3,2017,97,100
780,171910,Serra de Daró,2,2017,12,10
781,171925,Setcases,-7,2017,3,10
782,252038,"Seu d'Urgell, la",96,2017,659,563
783,082690,Seva,30,2017,173,143
784,252056,Sidamon,2,2017,25,23
785,171931,Sils,57,2017,420,363
786,082704,Sitges,620,2017,2506,1886
787,170524,Siurana,7,2017,19,12
788,082711,Sobremunt,-4,2017,2,6
789,252069,"Soleràs, el",-1,2017,11,12
790,431476,Solivella,4,2017,25,21
791,252075,Solsona,68,2017,461,393
792,082726,Sora,11,2017,17,6
793,252081,Soriguera,3,2017,32,29
794,252094,Sort,43,2017,152,109
795,252108,Soses,43,2017,105,62
796,082732,Subirats,43,2017,179,136
797,252115,Sudanell,-21,2017,29,50
798,252120,Sunyer,5,2017,27,22
799,082747,Súria,9,2017,195,186
800,171946,Susqueda,1,2017,6,5
801,082763,Tagamanent,7,2017,29,22
802,082779,Talamanca,13,2017,32,19
803,252154,Talarn,-50,2017,274,324
804,252167,Talavera,-4,2017,3,7
805,171959,"Tallada d'Empordà, la",7,2017,31,24
806,082785,Taradell,83,2017,289,206
807,431482,Tarragona,1467,2017,7195,5728
808,252173,Tàrrega,212,2017,942,730
809,252189,Tarrés,1,2017,5,4
810,252192,Tarroja de Segarra,3,2017,6,3
811,082750,Tavèrnoles,1,2017,14,13
812,082802,Tavertet,-6,2017,9,15
813,082819,Teià,31,2017,328,297
814,252206,Térmens,-61,2017,80,141
815,171962,Terrades,9,2017,29,20
816,082798,Terrassa,1966,2017,9721,7755
817,082824,Tiana,57,2017,427,370
818,252213,Tírvia,0,2017,6,6
819,252228,Tiurana,-1,2017,5,6
820,431495,Tivenys,9,2017,32,23
821,431508,Tivissa,-30,2017,43,73
822,082830,Tona,35,2017,388,353
823,252234,Torà,28,2017,97,69
824,082845,Tordera,337,2017,1182,845
825,082858,Torelló,194,2017,634,440
826,252249,"Torms, els",7,2017,10,3
827,252252,Tornabous,32,2017,65,33
828,252271,"Torre de Cabdella, la",2,2017,30,28
829,082861,"Torre de Claramunt, la",17,2017,202,185
830,431515,"Torre de Fontaubella, la",3,2017,7,4
831,431520,"Torre de l'Espanyol, la",-2,2017,25,27
832,252265,Torrebesses,-4,2017,8,12
833,431536,Torredembarra,313,2017,1241,928
834,252287,Torrefarrera,-7,2017,298,305
835,259078,Torrefeta i Florejacs,7,2017,38,31
836,252304,Torregrossa,7,2017,80,73
837,252311,Torrelameu,27,2017,60,33
838,082877,Torrelavit,39,2017,93,54
839,082883,Torrelles de Foix,51,2017,217,166
840,082896,Torrelles de Llobregat,5,2017,305,300
841,171978,Torrent,1,2017,14,13
842,252326,Torres de Segre,108,2017,326,218
843,252332,Torre-serona,26,2017,42,16
844,171984,Torroella de Fluvià,20,2017,92,72
845,171997,Torroella de Montgrí,34,2017,695,661
846,431541,Torroja del Priorat,2,2017,6,4
847,172001,Tortellà,22,2017,59,37
848,431554,Tortosa,160,2017,1489,1329
849,172018,Toses,0,2017,13,13
850,172023,Tossa de Mar,16,2017,350,334
851,252347,Tremp,-13,2017,315,328
852,172044,Ullà,10,2017,127,117
853,082900,Ullastrell,18,2017,111,93
854,172057,Ullastret,-5,2017,18,23
855,431567,Ulldecona,-56,2017,374,430
856,431573,Ulldemolins,8,2017,21,13
857,172039,Ultramort,2,2017,10,8
858,172060,Urús,5,2017,15,10
859,082917,Vacarisses,160,2017,540,380
860,170144,"Vajol, la",1,2017,6,5
861,172076,"Vall d'en Bas, la",17,2017,128,111
862,172082,"Vall de Bianya, la",-14,2017,85,99
863,250432,"Vall de Boí, la",16,2017,57,41
864,259010,Vall de Cardós,12,2017,31,19
865,082922,Vallbona d'Anoia,-3,2017,61,64
866,252385,Vallbona de les Monges,11,2017,20,9
867,082938,Vallcebre,-1,2017,8,9
868,431589,Vallclara,-3,2017,2,5
869,252402,Vallfogona de Balaguer,13,2017,101,88
870,171707,Vallfogona de Ripollès,5,2017,10,5
871,431592,Vallfogona de Riucorb,-2,2017,2,4
872,082943,Vallgorguina,64,2017,251,187
873,082956,Vallirana,89,2017,781,692
874,172095,Vall-llobrega,-5,2017,60,65
875,431606,Vallmoll,21,2017,104,83
876,082969,Vallromanes,18,2017,167,149
877,431613,Valls,150,2017,1026,876
878,259062,"Valls d'Aguilar, les",1,2017,11,10
879,252398,"Valls de Valira, les",23,2017,79,56
880,431628,Vandellòs i l'Hospitalet de l'Infant,73,2017,369,296
881,259097,"Vansa i Fórnols, la",-5,2017,5,10
882,082975,Veciana,4,2017,8,4
883,431634,"Vendrell, el",507,2017,2741,2234
884,172109,Ventalló,41,2017,93,52
885,252424,Verdú,1,2017,38,37
886,172116,Verges,29,2017,75,46
887,431649,Vespella de Gaià,-5,2017,26,31
888,082981,Vic,1173,2017,3409,2236
889,172121,Vidrà,-4,2017,6,10
890,172137,Vidreres,121,2017,581,460
891,252430,Vielha e Mijaran,-32,2017,408,440
892,431652,Vilabella,3,2017,21,18
893,172142,Vilabertran,27,2017,69,42
894,172155,Vilablareix,77,2017,167,90
895,082994,Vilada,9,2017,21,12
896,172174,Viladamat,2,2017,28,26
897,172168,Viladasens,-10,2017,10,20
898,083015,Viladecans,105,2017,2789,2684
899,083008,Viladecavalls,89,2017,417,328
900,172180,Vilademuls,33,2017,61,28
901,172207,Viladrau,-6,2017,35,41
902,172214,Vilafant,-13,2017,280,293
903,083054,Vilafranca del Penedès,591,2017,2036,1445
904,252445,Vilagrassa,-5,2017,31,36
905,172235,Vilajuïga,-21,2017,69,90
906,431750,Vilalba dels Arcs,3,2017,15,12
907,083067,Vilalba Sasserra,9,2017,79,70
908,252458,Vilaller,-2,2017,26,28
909,172240,Vilallonga de Ter,5,2017,22,17
910,431665,Vilallonga del Camp,-4,2017,139,143
911,172253,Vilamacolum,-13,2017,35,48
912,172266,Vilamalla,13,2017,79,66
913,172272,Vilamaniscle,9,2017,23,14
914,252477,Vilamòs,8,2017,23,15
915,172288,Vilanant,0,2017,25,25
916,431671,Vilanova d'Escornalbou,28,2017,54,26
917,252483,Vilanova de Bellpuig,21,2017,82,61
918,252496,Vilanova de l'Aguda,0,2017,6,6
919,252542,Vilanova de la Barca,-19,2017,77,96
920,252509,Vilanova de Meià,-2,2017,19,21
921,431687,Vilanova de Prades,-4,2017,7,11
922,083036,Vilanova de Sau,-2,2017,15,17
923,252516,Vilanova de Segrià,4,2017,62,58
924,083020,Vilanova del Camí,0,2017,537,537
925,089024,Vilanova del Vallès,26,2017,287,261
926,083073,Vilanova i la Geltrú,421,2017,3252,2831
927,431690,Vilaplana,-1,2017,35,36
928,431704,Vila-rodona,2,2017,72,70
929,172305,Vila-sacra,5,2017,49,44
930,252521,Vila-sana,-11,2017,32,43
931,431711,Vila-seca,109,2017,1295,1186
932,082140,Vilassar de Dalt,53,2017,482,429
933,082191,Vilassar de Mar,185,2017,1116,931
934,172229,Vilaür,7,2017,12,5
935,431726,Vilaverd,23,2017,41,18
936,431732,"Vilella Alta, la",3,2017,8,5
937,431747,"Vilella Baixa, la",5,2017,14,9
938,172333,Vilobí d'Onyar,30,2017,197,167
939,083041,Vilobí del Penedès,21,2017,70,49
940,172327,Vilopriu,-1,2017,14,15
941,252537,"Vilosell, el",-3,2017,9,12
942,431763,Vimbodí i Poblet,9,2017,39,30
943,252555,Vinaixa,1,2017,11,10
944,431779,Vinebre,2,2017,17,15
945,431785,Vinyols i els Arcs,49,2017,184,135
946,083089,Viver i Serrateix,-6,2017,4,10
947,430521,Xerta,-6,2017,57,63
0,250019,Abella de la Conca,0,2018,7,7
1,080018,Abrera,140,2018,736,596
2,250024,Àger,-3,2018,27,30
3,250030,Agramunt,-9,2018,221,230
4,080023,Aguilar de Segarra,10,2018,17,7
5,170010,Agullana,3,2018,59,56
6,080142,Aiguafreda,19,2018,161,142
7,430017,Aiguamúrcia,0,2018,64,64
8,170025,Aiguaviva,-10,2018,33,43
9,250387,Aitona,72,2018,209,137
10,250045,"Alamús, els",23,2018,67,44
11,250058,Alàs i Cerc,-10,2018,18,28
12,250061,"Albagés, l'",-2,2018,15,17
13,170031,Albanyà,14,2018,25,11
14,250077,Albatàrrec,-121,2018,159,280
15,250083,Albesa,1,2018,62,61
16,250096,"Albi, l'",10,2018,22,12
17,430022,Albinyana,67,2018,217,150
18,430038,"Albiol, l'",13,2018,51,38
19,170046,Albons,16,2018,60,44
20,430043,Alcanar,73,2018,526,453
21,250100,Alcanó,5,2018,6,1
22,250117,Alcarràs,223,2018,787,564
23,250122,Alcoletge,7,2018,242,235
24,430056,Alcover,-41,2018,202,243
25,439044,"Aldea, l'",51,2018,236,185
26,430069,Aldover,45,2018,69,24
27,430075,"Aleixar, l'",6,2018,42,36
28,080039,Alella,82,2018,685,603
29,430081,Alfara de Carles,9,2018,21,12
30,250138,Alfarràs,-1,2018,110,111
31,250143,Alfés,-3,2018,7,10
32,430094,Alforja,33,2018,128,95
33,250156,Algerri,-9,2018,12,21
34,250169,Alguaire,13,2018,160,147
35,250175,Alins,-4,2018,8,12
36,430108,Alió,18,2018,31,13
37,250194,Almacelles,158,2018,371,213
38,250208,Almatret,3,2018,16,13
39,250215,Almenar,-19,2018,156,175
40,430115,Almoster,3,2018,73,70
41,250220,Alòs de Balaguer,3,2018,11,8
42,170062,Alp,31,2018,145,114
43,080044,Alpens,-5,2018,8,13
44,250236,Alpicat,47,2018,307,260
45,250241,Alt Àneu,2,2018,29,27
46,430120,Altafulla,121,2018,415,294
47,170078,Amer,31,2018,141,110
48,430136,"Ametlla de Mar, l'",95,2018,412,317
49,080057,"Ametlla del Vallès, l'",-38,2018,524,562
50,439060,"Ampolla, l'",-33,2018,255,288
51,430141,Amposta,208,2018,1044,836
52,170084,Anglès,107,2018,387,280
53,250273,Anglesola,43,2018,83,40
54,250292,Arbeca,-29,2018,103,132
55,430167,"Arboç, l'",-9,2018,349,358
56,430154,Arbolí,21,2018,24,3
57,170097,Arbúcies,79,2018,321,242
58,080060,Arenys de Mar,358,2018,1081,723
59,080076,Arenys de Munt,125,2018,558,433
60,170101,Argelaguer,-20,2018,21,41
61,080082,Argençola,-6,2018,11,17
62,430173,"Argentera, l'",-4,2018,0,4
63,080095,Argentona,169,2018,708,539
64,170118,"Armentera, l'",0,2018,40,40
65,430189,Arnes,-1,2018,17,18
66,250313,Arres,2,2018,7,5
67,250328,Arsèguel,-1,2018,3,4
68,080109,Artés,42,2018,266,224
69,250334,Artesa de Lleida,-4,2018,69,73
70,250349,Artesa de Segre,5,2018,156,151
71,430192,Ascó,-17,2018,44,61
72,250365,Aspa,11,2018,15,4
73,250371,"Avellanes i Santa Linya, les",-6,2018,14,20
74,080116,Avià,-9,2018,91,100
75,080121,Avinyó,43,2018,121,78
76,170123,Avinyonet de Puigventós,0,2018,99,99
77,080137,Avinyonet del Penedès,49,2018,145,96
78,080155,Badalona,3044,2018,13090,10046
79,089045,Badia del Vallès,-17,2018,619,636
80,080168,Bagà,11,2018,98,87
81,250390,Baix Pallars,-2,2018,23,25
82,250404,Balaguer,342,2018,1127,785
83,080174,Balenyà,55,2018,234,179
84,080180,Balsareny,3,2018,118,115
85,430206,Banyeres del Penedès,29,2018,246,217
86,170157,Banyoles,256,2018,1067,811
87,250411,Barbens,-69,2018,78,147
88,430213,Barberà de la Conca,-5,2018,28,33
89,082520,Barberà del Vallès,195,2018,1678,1483
90,080193,Barcelona,26044,2018,108616,82572
91,250426,"Baronia de Rialb, la",7,2018,15,8
92,170160,Bàscara,2,2018,60,58
93,250447,Bassella,-7,2018,9,16
94,430228,Batea,5,2018,48,43
95,250450,Bausen,-3,2018,6,9
96,080207,Begues,131,2018,441,310
97,170139,Begur,36,2018,223,187
98,250463,Belianes,3,2018,15,12
99,251706,Bellaguarda,0,2018,11,11
100,170182,Bellcaire d'Empordà,20,2018,65,45
101,250479,Bellcaire d'Urgell,-1,2018,58,59
102,250485,Bell-lloc d'Urgell,41,2018,136,95
103,250498,Bellmunt d'Urgell,-4,2018,6,10
104,430234,Bellmunt del Priorat,-12,2018,4,16
105,080214,Bellprat,-10,2018,0,10
106,250501,Bellpuig,99,2018,337,238
107,430249,Bellvei,30,2018,198,168
108,250518,Bellver de Cerdanya,-25,2018,116,141
109,250523,Bellvís,-2,2018,91,93
110,250539,Benavent de Segrià,24,2018,89,65
111,430252,Benifallet,22,2018,51,29
112,430265,Benissanet,33,2018,78,45
113,080229,Berga,361,2018,1030,669
114,170195,Besalú,37,2018,147,110
115,170209,Bescanó,15,2018,208,193
116,170216,Beuda,6,2018,17,11
117,080235,Bigues i Riells del Fai,100,2018,555,455
118,250557,Biosca,-2,2018,6,8
119,170221,"Bisbal d'Empordà, la",152,2018,692,540
120,430271,"Bisbal de Falset, la",2,2018,9,7
121,430287,"Bisbal del Penedès, la",86,2018,333,247
122,172348,Biure,-10,2018,11,21
123,430290,Blancafort,9,2018,27,18
124,170237,Blanes,387,2018,2362,1975
125,170293,Boadella i les Escaules,-16,2018,7,23
126,170242,Bolvir,-12,2018,33,45
127,430304,Bonastre,1,2018,78,77
128,250576,"Bòrdes, Es",-3,2018,18,21
129,170255,Bordils,67,2018,149,82
130,250582,"Borges Blanques, les",104,2018,376,272
131,430311,"Borges del Camp, les",-13,2018,109,122
132,170268,Borrassà,4,2018,58,54
133,080240,Borredà,-12,2018,15,27
134,250595,Bossòst,-5,2018,63,68
135,430326,Bot,-21,2018,13,34
136,430332,Botarell,-8,2018,76,84
137,250560,Bovera,-7,2018,4,11
138,430347,Bràfim,25,2018,59,34
139,170274,Breda,27,2018,176,149
140,080253,"Bruc, el",17,2018,177,160
141,080266,"Brull, el",5,2018,15,10
142,170280,Brunyola i Sant Martí Sapresa,24,2018,56,32
143,430350,Cabacés,-4,2018,8,12
144,250609,Cabanabona,0,2018,5,5
145,170314,Cabanelles,9,2018,20,11
146,170307,Cabanes,8,2018,81,73
147,080272,"Cabanyes, les",2,2018,40,38
148,250616,Cabó,-4,2018,5,9
149,430363,Cabra del Camp,24,2018,95,71
150,080288,Cabrera d'Anoia,40,2018,140,100
151,080291,Cabrera de Mar,58,2018,358,300
152,080305,Cabrils,110,2018,489,379
153,170329,Cadaqués,-27,2018,116,143
154,080312,Calaf,-6,2018,203,209
155,430379,Calafell,1091,2018,3109,2018
156,080348,Calders,29,2018,81,52
157,080327,Caldes d'Estrac,150,2018,374,224
158,170335,Caldes de Malavella,180,2018,579,399
159,080333,Caldes de Montbui,115,2018,869,754
160,080351,Calella,510,2018,1743,1233
161,080370,Calldetenes,-14,2018,123,137
162,080386,Callús,34,2018,174,140
163,080364,Calonge de Segarra,-4,2018,5,9
164,170340,Calonge i Sant Antoni,211,2018,930,719
165,250621,Camarasa,-20,2018,27,47
166,439039,Camarles,-1,2018,143,144
167,430385,Cambrils,672,2018,2664,1992
168,170353,Camós,7,2018,24,17
169,170366,Campdevànol,48,2018,120,72
170,170372,Campelles,11,2018,18,7
171,080399,Campins,20,2018,48,28
172,170388,Campllong,10,2018,30,20
173,170391,Camprodon,42,2018,147,105
174,250637,Canejan,26,2018,28,2
175,170405,Canet d'Adri,16,2018,44,28
176,080403,Canet de Mar,199,2018,972,773
177,439076,"Canonja, la",42,2018,330,288
178,080410,Canovelles,322,2018,1194,872
179,080425,Cànoves i Samalús,108,2018,287,179
180,170412,Cantallops,1,2018,14,13
181,080431,Canyelles,152,2018,388,236
182,430398,Capafonts,24,2018,25,1
183,430402,Capçanes,3,2018,19,16
184,080446,Capellades,110,2018,320,210
185,170427,Capmany,1,2018,36,35
186,080459,Capolat,-3,2018,1,4
187,080462,Cardedeu,136,2018,930,794
188,080478,Cardona,34,2018,167,133
189,080484,Carme,-11,2018,32,43
190,430419,Caseres,27,2018,34,7
191,170448,Cassà de la Selva,50,2018,495,445
192,080497,Casserres,38,2018,103,65
193,080575,Castell de l'Areny,-3,2018,1,4
194,259046,Castell de Mur,15,2018,22,7
195,250642,Castellar de la Ribera,-2,2018,9,11
196,080522,Castellar de n'Hug,-3,2018,6,9
197,080500,Castellar del Riu,5,2018,12,7
198,080517,Castellar del Vallès,173,2018,1025,852
199,080538,Castellbell i el Vilar,69,2018,283,214
200,080543,Castellbisbal,27,2018,611,584
201,080556,Castellcir,29,2018,77,48
202,250674,Castelldans,29,2018,69,40
203,080569,Castelldefels,604,2018,4954,4350
204,080581,Castellet i la Gornal,68,2018,221,153
205,170464,Castellfollit de la Roca,11,2018,65,54
206,080608,Castellfollit de Riubregós,-5,2018,3,8
207,080594,Castellfollit del Boix,-6,2018,13,19
208,080615,Castellgalí,7,2018,144,137
209,080620,Castellnou de Bages,71,2018,127,56
210,250680,Castellnou de Seana,-2,2018,37,39
211,170470,Castelló d'Empúries,193,2018,1027,834
212,250693,Castelló de Farfanya,2,2018,31,29
213,080636,Castellolí,4,2018,23,19
214,170486,Castell-Platja d'Aro,283,2018,1163,880
215,250707,Castellserà,7,2018,47,40
216,080641,Castellterçol,50,2018,198,148
217,430424,Castellvell del Camp,-10,2018,150,160
218,080654,Castellví de la Marca,12,2018,71,59
219,080667,Castellví de Rosanes,31,2018,148,117
220,430430,"Catllar, el",108,2018,370,262
221,250714,Cava,1,2018,3,2
222,171899,"Cellera de Ter, la",-5,2018,82,87
223,170499,Celrà,59,2018,330,271
224,080673,Centelles,19,2018,326,307
225,082687,Cercs,5,2018,64,59
226,082665,Cerdanyola del Vallès,134,2018,3140,3006
227,080689,Cervelló,104,2018,669,565
228,250729,Cervera,136,2018,508,372
229,250735,Cervià de les Garrigues,-2,2018,23,25
230,170502,Cervià de Ter,19,2018,60,41
231,170519,Cistella,-12,2018,8,20
232,250740,Ciutadilla,4,2018,20,16
233,250753,Clariana de Cardener,11,2018,16,5
234,250766,"Cogul, el",1,2018,8,7
235,170545,Colera,-16,2018,25,41
236,250772,Coll de Nargó,6,2018,30,24
237,080692,Collbató,13,2018,242,229
238,430458,Colldejou,6,2018,19,13
239,080706,Collsuspina,2,2018,12,10
240,170558,Colomers,1,2018,11,10
241,251636,"Coma i la Pedra, la",6,2018,17,11
242,251615,Conca de Dalt,-6,2018,18,24
243,430461,Conesa,2,2018,3,1
244,430477,Constantí,16,2018,433,417
245,080713,Copons,1,2018,14,13
246,430483,Corbera d'Ebre,10,2018,35,25
247,080728,Corbera de Llobregat,179,2018,911,732
248,250788,Corbins,29,2018,78,49
249,170577,Corçà,16,2018,74,58
250,080734,Cornellà de Llobregat,1673,2018,5887,4214
251,170561,Cornellà del Terri,52,2018,184,132
252,430496,Cornudella de Montsant,6,2018,53,47
253,430509,Creixell,118,2018,380,262
254,170583,Crespià,-2,2018,19,21
255,179011,"Cruïlles, Monells i Sant Sadurní de l'Heura",9,2018,81,72
256,080749,Cubelles,329,2018,1357,1028
257,250791,Cubells,-6,2018,15,21
258,430516,Cunit,705,2018,1731,1026
259,170600,Darnius,-28,2018,27,55
260,170617,Das,39,2018,46,7
261,439018,Deltebre,-31,2018,454,485
262,080752,Dosrius,209,2018,573,364
263,430537,Duesaigües,12,2018,26,14
264,170622,"Escala, l'",74,2018,556,482
265,080765,Esparreguera,180,2018,1252,1072
266,170638,Espinelves,10,2018,17,7
267,250812,"Espluga Calba, l'",-3,2018,8,11
268,430542,"Espluga de Francolí, l'",34,2018,191,157
269,080771,Esplugues de Llobregat,499,2018,3159,2660
270,170643,Espolla,-10,2018,11,21
271,170656,Esponellà,17,2018,35,18
272,250827,Espot,5,2018,28,23
273,080787,"Espunyola, l'",-4,2018,7,11
274,082541,"Esquirol, l'",49,2018,125,76
275,250886,Estamariu,2,2018,3,1
276,080790,"Estany, l'",17,2018,36,19
277,250851,Estaràs,2,2018,8,6
278,250864,Esterri d'Àneu,15,2018,84,69
279,250870,Esterri de Cardós,2,2018,6,4
280,430555,Falset,41,2018,127,86
281,170059,"Far d'Empordà, el",8,2018,39,31
282,250899,Farrera,-2,2018,5,7
283,430568,"Fatarella, la",-13,2018,15,28
284,430574,"Febró, la",-2,2018,3,5
285,081347,Figaró-Montmany,25,2018,117,92
286,080804,Fígols,0,2018,2,2
287,259084,Fígols i Alinyà,-2,2018,14,16
288,430580,"Figuera, la",10,2018,15,5
289,170669,Figueres,303,2018,3248,2945
290,430593,Figuerola del Camp,6,2018,16,10
291,170675,Flaçà,18,2018,94,76
292,430607,Flix,-27,2018,129,156
293,250925,"Floresta, la",-7,2018,1,8
294,080826,Fogars de la Selva,-16,2018,89,105
295,080811,Fogars de Montclús,3,2018,51,48
296,170681,Foixà,-3,2018,15,18
297,080832,Folgueroles,-11,2018,62,73
298,250931,Fondarella,-5,2018,30,35
299,080847,Fonollosa,10,2018,90,80
300,170694,Fontanals de Cerdanya,-9,2018,31,40
301,170708,Fontanilles,3,2018,12,9
302,170715,Fontcoberta,-3,2018,69,72
303,080850,Font-rubí,-3,2018,58,61
304,250946,Foradada,6,2018,11,5
305,179026,Forallac,-22,2018,127,149
306,430614,Forès,1,2018,5,4
307,170736,Fornells de la Selva,3,2018,143,140
308,170741,Fortià,42,2018,76,34
309,080863,"Franqueses del Vallès, les",276,2018,1406,1130
310,430629,Freginals,-7,2018,15,22
311,250962,"Fuliola, la",25,2018,68,43
312,250978,Fulleda,3,2018,3,0
313,080902,Gaià,8,2018,13,5
314,430635,"Galera, la",20,2018,35,15
315,080879,Gallifa,5,2018,12,7
316,430640,Gandesa,23,2018,163,140
317,430653,Garcia,10,2018,47,37
318,430666,"Garidells, els",-9,2018,6,15
319,080885,"Garriga, la",294,2018,921,627
320,170754,Garrigàs,2,2018,31,29
321,170767,Garrigoles,-7,2018,7,14
322,170773,Garriguella,23,2018,88,65
323,080898,Gavà,131,2018,2801,2670
324,250984,Gavet de la Conca,-4,2018,8,12
325,080919,Gelida,161,2018,488,327
326,170789,Ger,17,2018,58,41
327,259123,Gimenells i el Pla de la Font,5,2018,58,53
328,430672,Ginestar,4,2018,33,29
329,170792,Girona,1215,2018,7688,6473
330,080924,Gironella,53,2018,214,161
331,080930,Gisclareny,-1,2018,0,1
332,430688,Godall,-14,2018,14,28
333,250997,Golmés,-29,2018,68,97
334,170806,Gombrèn,4,2018,12,8
335,251001,Gósol,0,2018,24,24
336,080945,"Granada, la",27,2018,150,123
337,251018,"Granadella, la",-9,2018,31,40
338,080958,Granera,-9,2018,3,12
339,251023,"Granja d'Escarp, la",-4,2018,58,62
340,080961,Granollers,550,2018,4272,3722
341,251039,Granyanella,8,2018,14,6
342,251057,Granyena de les Garrigues,-6,2018,5,11
343,251044,Granyena de Segarra,1,2018,5,4
344,430691,Gratallops,-1,2018,12,13
345,080977,Gualba,24,2018,114,90
346,170813,Gualta,-3,2018,58,61
347,080996,Guardiola de Berguedà,29,2018,73,44
348,430705,"Guiamets, els",1,2018,12,11
349,170828,Guils de Cerdanya,12,2018,40,28
350,251095,Guimerà,1,2018,16,15
351,259031,"Guingueta d'Àneu, la",1,2018,27,26
352,251109,Guissona,66,2018,473,407
353,251116,Guixers,-2,2018,0,2
354,081000,Gurb,17,2018,123,106
355,430712,Horta de Sant Joan,13,2018,43,30
356,081017,"Hospitalet de Llobregat, l'",4570,2018,22408,17838
357,081629,"Hostalets de Pierola, els",51,2018,274,223
358,170834,Hostalric,61,2018,300,239
359,081022,Igualada,531,2018,2340,1809
360,251155,Isona i Conca Dellà,5,2018,72,67
361,170849,Isòvol,2,2018,20,18
362,251137,Ivars d'Urgell,-16,2018,66,82
363,251121,Ivars de Noguera,-2,2018,15,17
364,251142,Ivorra,1,2018,4,3
365,170852,Jafre,-3,2018,16,19
366,170865,"Jonquera, la",32,2018,338,306
367,081038,Jorba,-1,2018,48,49
368,259101,Josa i Tuixén,-11,2018,2,13
369,170871,Juià,-2,2018,31,33
370,251180,Juncosa,-1,2018,20,21
371,251193,Juneda,101,2018,284,183
372,251214,Les,6,2018,81,75
373,251229,Linyola,38,2018,134,96
374,081043,"Llacuna, la",6,2018,43,37
375,170887,Lladó,27,2018,51,24
376,251235,Lladorre,5,2018,16,11
377,251240,Lladurs,-3,2018,3,6
378,081056,"Llagosta, la",130,2018,762,632
379,170890,Llagostera,135,2018,534,399
380,170904,Llambilles,6,2018,37,31
381,170911,Llanars,-8,2018,32,40
382,170926,Llançà,39,2018,267,228
383,251253,Llardecans,-2,2018,8,10
384,251266,Llavorsí,0,2018,25,25
385,251207,Lleida,1566,2018,7161,5595
386,170932,Llers,3,2018,85,82
387,251272,Lles de Cerdanya,4,2018,19,15
388,081075,Lliçà d'Amunt,164,2018,920,756
389,081081,Lliçà de Vall,60,2018,372,312
390,251288,Llimiana,2,2018,8,6
391,081069,Llinars del Vallès,135,2018,662,527
392,170947,Llívia,6,2018,96,90
393,430727,"Lloar, el",-8,2018,12,20
394,251291,Llobera,-4,2018,3,7
395,430733,Llorac,3,2018,5,2
396,430748,Llorenç del Penedès,70,2018,233,163
397,170950,Lloret de Mar,701,2018,3269,2568
398,170963,"Llosses, les",1,2018,18,17
399,081094,Lluçà,-3,2018,5,8
400,171024,Maçanet de Cabrenys,27,2018,53,26
401,171030,Maçanet de la Selva,106,2018,499,393
402,170979,Madremanya,2,2018,28,26
403,170985,Maià de Montcal,37,2018,52,15
404,251333,Maials,-1,2018,55,56
405,251305,Maldà,2,2018,12,10
406,081108,Malgrat de Mar,234,2018,1236,1002
407,081115,Malla,7,2018,11,4
408,081120,Manlleu,239,2018,1233,994
409,081136,Manresa,1441,2018,4861,3420
410,430764,Marçà,7,2018,41,34
411,430751,Margalef,4,2018,7,3
412,082423,Marganell,4,2018,18,14
413,081141,Martorell,321,2018,1735,1414
414,081154,Martorelles,10,2018,311,301
415,430770,Mas de Barberans,9,2018,23,14
416,171002,Masarac,19,2018,38,19
417,430786,Masdenverge,9,2018,82,73
418,081167,"Masies de Roda, les",1,2018,27,26
419,081173,"Masies de Voltregà, les",24,2018,130,106
420,430799,Masllorenç,9,2018,44,35
421,081189,"Masnou, el",239,2018,1445,1206
422,430803,"Masó, la",2,2018,9,7
423,430810,Maspujols,27,2018,54,27
424,081192,Masquefa,568,2018,957,389
425,430825,"Masroig, el",0,2018,18,18
426,251312,Massalcoreig,30,2018,49,19
427,171019,Massanes,34,2018,79,45
428,251327,Massoteres,-5,2018,18,23
429,081206,Matadepera,64,2018,518,454
430,081213,Mataró,1360,2018,6471,5111
431,081228,Mediona,16,2018,210,194
432,251348,Menàrguens,17,2018,47,30
433,170998,Meranges,5,2018,7,2
434,171058,Mieres,10,2018,29,19
435,430831,"Milà, el",1,2018,12,11
436,251351,Miralcamp,5,2018,59,54
437,430846,Miravet,-7,2018,36,43
438,081385,Moià,99,2018,370,271
439,430859,"Molar, el",20,2018,35,15
440,081234,Molins de Rei,185,2018,1103,918
441,251370,Mollerussa,111,2018,891,780
442,171061,Mollet de Peralada,2,2018,9,7
443,081249,Mollet del Vallès,264,2018,2572,2308
444,171077,Molló,10,2018,23,13
445,251364,"Molsosa, la",-2,2018,0,2
446,081287,Monistrol de Calders,10,2018,35,25
447,081271,Monistrol de Montserrat,72,2018,294,222
448,171096,Montagut i Oix,15,2018,57,42
449,430862,Montblanc,-105,2018,281,386
450,430884,Montbrió del Camp,48,2018,241,193
451,081252,Montcada i Reixac,568,2018,2383,1815
452,081304,Montclar,7,2018,12,5
453,251399,Montellà i Martinet,34,2018,67,33
454,081311,Montesquiu,36,2018,95,59
455,251403,Montferrer i Castellbò,-27,2018,74,101
456,430897,Montferri,9,2018,35,26
457,251386,Montgai,0,2018,19,19
458,081265,Montgat,151,2018,803,652
459,081326,Montmajor,4,2018,23,19
460,081332,Montmaneu,-1,2018,11,12
461,430901,"Montmell, el",72,2018,188,116
462,081350,Montmeló,1,2018,375,374
463,251425,Montoliu de Lleida,24,2018,56,32
464,251410,Montoliu de Segarra,-6,2018,13,19
465,251431,Montornès de Segarra,2,2018,6,4
466,081363,Montornès del Vallès,113,2018,825,712
467,430918,Mont-ral,0,2018,12,12
468,171100,Mont-ras,6,2018,103,97
469,430923,Mont-roig del Camp,270,2018,1278,1008
470,081379,Montseny,20,2018,38,18
471,430939,Móra d'Ebre,109,2018,335,226
472,430944,Móra la Nova,35,2018,168,133
473,430957,"Morell, el",38,2018,302,264
474,430960,"Morera de Montsant, la",3,2018,12,9
475,081290,Muntanyola,8,2018,38,30
476,081398,Mura,4,2018,22,18
477,251459,Nalec,-4,2018,3,7
478,250254,Naut Aran,11,2018,100,89
479,081402,Navarcles,36,2018,257,221
480,081419,Navàs,34,2018,259,225
481,171117,Navata,62,2018,125,63
482,251462,Navès,-7,2018,13,20
483,081424,"Nou de Berguedà, la",0,2018,4,4
484,430976,"Nou de Gaià, la",27,2018,57,30
485,430982,Nulles,8,2018,41,33
486,251484,Odèn,-1,2018,8,9
487,081430,Òdena,45,2018,223,178
488,171122,Ogassa,11,2018,20,9
489,081458,Olèrdola,96,2018,300,204
490,081461,Olesa de Bonesvalls,23,2018,135,112
491,081477,Olesa de Montserrat,127,2018,1069,942
492,251497,Oliana,29,2018,113,84
493,251500,Oliola,-2,2018,4,6
494,251517,Olius,27,2018,57,30
495,081483,Olivella,105,2018,406,301
496,081496,Olost,26,2018,69,43
497,171143,Olot,897,2018,2057,1160
498,251522,"Oluges, les",-4,2018,4,8
499,081445,Olvan,23,2018,58,35
500,251538,"Omellons, els",3,2018,7,4
501,251543,"Omells de na Gaia, els",0,2018,2,2
502,171156,Ordis,-13,2018,16,29
503,251556,Organyà,2,2018,36,34
504,081509,Orís,2,2018,27,25
505,081516,Oristà,9,2018,38,29
506,081521,Orpí,8,2018,15,7
507,081537,Òrrius,8,2018,45,37
508,251569,Os de Balaguer,-6,2018,36,42
509,171169,Osor,10,2018,36,26
510,251575,Ossó de Sió,5,2018,10,5
511,081542,Pacs del Penedès,13,2018,77,64
512,081555,Palafolls,158,2018,647,489
513,171175,Palafrugell,137,2018,1234,1097
514,171181,Palamós,147,2018,1152,1005
515,251581,"Palau d'Anglesola, el",10,2018,113,103
516,171194,Palau de Santa Eulàlia,0,2018,13,13
517,171215,Palau-sator,17,2018,23,6
518,171208,Palau-saverdera,50,2018,133,83
519,081568,Palau-solità i Plegamans,172,2018,795,623
520,431009,"Pallaresos, els",68,2018,276,208
521,081574,Pallejà,39,2018,584,545
522,430995,"Palma d'Ebre, la",-5,2018,13,18
523,089058,"Palma de Cervelló, la",-23,2018,177,200
524,171236,Palol de Revardit,-11,2018,18,29
525,171241,Pals,-19,2018,133,152
526,081580,"Papiol, el",35,2018,223,188
527,171254,Pardines,0,2018,3,3
528,081593,Parets del Vallès,37,2018,859,822
529,171267,Parlavà,-1,2018,18,19
530,431016,Passanant i Belltall,16,2018,24,8
531,171289,Pau,-2,2018,40,42
532,431021,Paüls,-5,2018,11,16
533,171292,Pedret i Marzà,-2,2018,7,9
534,251641,Penelles,-1,2018,16,17
535,171306,"Pera, la",3,2018,24,21
536,081607,Perafita,-12,2018,14,26
537,431037,Perafort,-10,2018,97,107
538,171328,Peralada,-10,2018,104,114
539,251654,Peramola,-3,2018,13,16
540,431042,"Perelló, el",49,2018,190,141
541,081614,Piera,246,2018,1080,834
542,431055,"Piles, les",3,2018,15,12
543,081635,Pineda de Mar,696,2018,2187,1491
544,431068,"Pinell de Brai, el",21,2018,39,18
545,251667,Pinell de Solsonès,-2,2018,9,11
546,251673,Pinós,-8,2018,3,11
547,431074,Pira,-11,2018,10,21
548,431080,"Pla de Santa Maria, el",36,2018,181,145
549,081640,"Pla del Penedès, el",2,2018,91,89
550,171334,"Planes d'Hostoles, les",32,2018,93,61
551,171349,Planoles,-15,2018,9,24
552,259118,"Plans de Sió, els",6,2018,24,18
553,251689,"Poal, el",26,2018,50,24
554,251692,"Pobla de Cérvoles, la",2,2018,15,13
555,081653,"Pobla de Claramunt, la",19,2018,123,104
556,081666,"Pobla de Lillet, la",13,2018,57,44
557,431093,"Pobla de Mafumet, la",-37,2018,305,342
558,431107,"Pobla de Massaluca, la",-9,2018,17,26
559,431114,"Pobla de Montornès, la",32,2018,221,189
560,251713,"Pobla de Segur, la",56,2018,217,161
561,431129,Poboleda,-9,2018,8,17
562,081672,Polinyà,76,2018,461,385
563,431135,"Pont d'Armentera, el",-1,2018,32,33
564,250306,"Pont de Bar, el",-8,2018,7,15
565,171352,Pont de Molins,-4,2018,23,27
566,251734,"Pont de Suert, el",0,2018,110,110
567,081825,"Pont de Vilomara i Rocafort, el",12,2018,198,186
568,431418,Pontils,3,2018,13,10
569,081688,Pontons,80,2018,109,29
570,171365,Pontós,19,2018,32,13
571,251728,Ponts,23,2018,170,147
572,171371,Porqueres,26,2018,247,221
573,431140,Porrera,-1,2018,7,8
574,171404,"Port de la Selva, el",-3,2018,49,52
575,171387,Portbou,5,2018,69,64
576,251749,"Portella, la",19,2018,88,69
577,431153,Pradell de la Teixeta,-6,2018,0,6
578,431166,Prades,-9,2018,27,36
579,431172,Prat de Comte,5,2018,16,11
580,081691,"Prat de Llobregat, el",477,2018,2754,2277
581,431188,Pratdip,33,2018,91,58
582,081712,Prats de Lluçanès,53,2018,138,85
583,081705,"Prats de Rei, els",-7,2018,8,15
584,251752,Prats i Sansor,-11,2018,15,26
585,251765,Preixana,10,2018,25,15
586,251771,Preixens,8,2018,27,19
587,082303,Premià de Dalt,26,2018,585,559
588,081727,Premià de Mar,193,2018,1604,1411
589,171390,"Preses, les",29,2018,80,51
590,251790,Prullans,10,2018,24,14
591,171411,Puigcerdà,334,2018,772,438
592,081748,Puigdàlber,7,2018,36,29
593,251804,Puiggròs,5,2018,13,8
594,431191,Puigpelat,-7,2018,62,69
595,081751,Puig-reig,142,2018,311,169
596,251811,Puigverd d'Agramunt,25,2018,45,20
597,251826,Puigverd de Lleida,-13,2018,56,69
598,081764,Pujalt,1,2018,6,5
599,081770,"Quar, la",-7,2018,0,7
600,171426,Quart,40,2018,221,181
601,170433,Queralbs,6,2018,11,5
602,431205,Querol,-11,2018,48,59
603,171432,Rabós,0,2018,16,16
604,081786,Rajadell,15,2018,36,21
605,431212,Rasquera,7,2018,30,23
606,171447,Regencós,-7,2018,7,14
607,081799,Rellinars,28,2018,72,44
608,431227,Renau,4,2018,22,18
609,431233,Reus,1043,2018,5007,3964
610,251832,Rialp,-7,2018,54,61
611,431248,"Riba, la",16,2018,50,34
612,431251,Riba-roja d'Ebre,17,2018,50,33
613,259059,Ribera d'Ondara,7,2018,28,21
614,251850,Ribera d'Urgellet,22,2018,90,68
615,171450,Ribes de Freser,0,2018,93,93
616,171463,Riells i Viabrea,95,2018,430,335
617,431264,"Riera de Gaià, la",49,2018,137,88
618,251863,Riner,1,2018,9,8
619,171479,Ripoll,105,2018,484,379
620,081803,Ripollet,329,2018,2256,1927
621,259139,Riu de Cerdanya,-1,2018,4,5
622,171485,Riudarenes,15,2018,174,159
623,171498,Riudaura,20,2018,35,15
624,431270,Riudecanyes,9,2018,81,72
625,431286,Riudecols,1,2018,54,53
626,171501,Riudellots de la Selva,17,2018,131,114
627,431299,Riudoms,95,2018,352,257
628,171518,Riumors,3,2018,20,17
629,081810,"Roca del Vallès, la",-28,2018,488,516
630,431303,Rocafort de Queralt,-31,2018,4,35
631,431310,Roda de Berà,165,2018,631,466
632,081831,Roda de Ter,128,2018,384,256
633,431325,Rodonyà,11,2018,43,32
634,431331,Roquetes,41,2018,434,393
635,171523,Roses,219,2018,1376,1157
636,251898,Rosselló,37,2018,220,183
637,431346,"Rourell, el",-11,2018,19,30
638,081846,Rubí,939,2018,3951,3012
639,081859,Rubió,7,2018,10,3
640,171539,Rupià,2,2018,21,19
641,089019,Rupit i Pruit,5,2018,14,9
642,081878,Sabadell,2433,2018,10569,8136
643,081884,Sagàs,-10,2018,2,12
644,251902,Salàs de Pallars,-2,2018,16,18
645,081901,Saldes,8,2018,26,18
646,171544,Sales de Llierca,2,2018,9,7
647,081918,Sallent,90,2018,279,189
648,431359,Salomó,-5,2018,22,27
649,439057,Salou,793,2018,2912,2119
650,171557,Salt,642,2018,2502,1860
651,251919,Sanaüja,1,2018,19,18
652,081944,Sant Adrià de Besòs,483,2018,2751,2268
653,081957,Sant Agustí de Lluçanès,-3,2018,2,5
654,081960,Sant Andreu de la Barca,208,2018,1555,1347
655,081976,Sant Andreu de Llavaneres,155,2018,870,715
656,171576,Sant Andreu Salou,-1,2018,10,11
657,171833,Sant Aniol de Finestres,-3,2018,15,18
658,081982,Sant Antoni de Vilamajor,53,2018,487,434
659,081995,Sant Bartomeu del Grau,9,2018,63,54
660,082009,Sant Boi de Llobregat,835,2018,4055,3220
661,082016,Sant Boi de Lluçanès,26,2018,52,26
662,431362,Sant Carles de la Ràpita,298,2018,860,562
663,082037,Sant Cebrià de Vallalta,55,2018,269,214
664,082021,Sant Celoni,239,2018,1025,786
665,082042,Sant Climent de Llobregat,16,2018,210,194
666,171582,Sant Climent Sescebes,-13,2018,88,101
667,082055,Sant Cugat del Vallès,704,2018,5557,4853
668,082068,Sant Cugat Sesgarrigues,19,2018,55,36
669,251961,Sant Esteve de la Sarga,-2,2018,10,12
670,082074,Sant Esteve de Palautordera,74,2018,219,145
671,082080,Sant Esteve Sesrovires,-179,2018,450,629
672,171595,Sant Feliu de Buixalleu,-18,2018,41,59
673,082107,Sant Feliu de Codines,69,2018,482,413
674,171609,Sant Feliu de Guíxols,182,2018,1363,1181
675,082114,Sant Feliu de Llobregat,397,2018,2186,1789
676,171616,Sant Feliu de Pallerols,36,2018,121,85
677,082129,Sant Feliu Sasserra,5,2018,16,11
678,171621,Sant Ferriol,-6,2018,29,35
679,082093,Sant Fost de Campsentelles,101,2018,531,430
680,082135,Sant Fruitós de Bages,126,2018,481,355
681,171637,Sant Gregori,61,2018,220,159
682,251924,Sant Guim de Freixenet,-16,2018,37,53
683,251977,Sant Guim de la Plana,10,2018,18,8
684,171642,Sant Hilari Sacalm,50,2018,237,187
685,082153,Sant Hipòlit de Voltregà,36,2018,198,162
686,081939,Sant Iscle de Vallalta,16,2018,126,110
687,439023,Sant Jaume d'Enveja,46,2018,184,138
688,082166,Sant Jaume de Frontanyà,0,2018,0,0
689,171655,Sant Jaume de Llierca,26,2018,65,39
690,431378,Sant Jaume dels Domenys,79,2018,281,202
691,171674,Sant Joan de les Abadesses,31,2018,137,106
692,171680,Sant Joan de Mollet,5,2018,34,29
693,082188,Sant Joan de Vilatorrada,102,2018,484,382
694,082172,Sant Joan Despí,159,2018,1813,1654
695,171851,Sant Joan les Fonts,48,2018,207,159
696,171668,Sant Jordi Desvalls,30,2018,68,38
697,089030,Sant Julià de Cerdanyola,-12,2018,6,18
698,171693,Sant Julià de Ramis,41,2018,265,224
699,082205,Sant Julià de Vilatorta,23,2018,136,113
700,179032,Sant Julià del Llor i Bonmatí,17,2018,97,80
701,082212,Sant Just Desvern,402,2018,1346,944
702,082227,Sant Llorenç d'Hortons,-182,2018,204,386
703,171714,Sant Llorenç de la Muga,14,2018,26,12
704,251930,Sant Llorenç de Morunys,32,2018,58,26
705,082233,Sant Llorenç Savall,31,2018,147,116
706,082251,Sant Martí d'Albars,1,2018,5,4
707,082248,Sant Martí de Centelles,37,2018,137,100
708,171729,Sant Martí de Llémena,8,2018,45,37
709,259025,Sant Martí de Riucorb,0,2018,23,23
710,082264,Sant Martí de Tous,28,2018,69,41
711,082270,Sant Martí Sarroca,34,2018,245,211
712,082286,Sant Martí Sesgueioles,0,2018,14,14
713,171735,Sant Martí Vell,1,2018,13,12
714,082299,Sant Mateu de Bages,5,2018,33,28
715,171740,Sant Miquel de Campmajor,9,2018,23,14
716,171753,Sant Miquel de Fluvià,12,2018,66,54
717,171766,Sant Mori,4,2018,14,10
718,171772,Sant Pau de Segúries,-2,2018,36,38
719,082310,Sant Pere de Ribes,-695,2018,2295,2990
720,082325,Sant Pere de Riudebitlles,42,2018,160,118
721,082331,Sant Pere de Torelló,8,2018,102,94
722,082346,Sant Pere de Vilamajor,93,2018,382,289
723,171788,Sant Pere Pescador,-14,2018,136,150
724,081897,Sant Pere Sallavinera,-7,2018,2,9
725,082359,Sant Pol de Mar,13,2018,458,445
726,082362,Sant Quintí de Mediona,82,2018,184,102
727,082378,Sant Quirze de Besora,73,2018,149,76
728,082384,Sant Quirze del Vallès,210,2018,1076,866
729,082397,Sant Quirze Safaja,-10,2018,53,63
730,251945,Sant Ramon,-2,2018,23,25
731,082401,Sant Sadurní d'Anoia,54,2018,528,474
732,082418,Sant Sadurní d'Osormort,0,2018,3,3
733,080983,Sant Salvador de Guardiola,9,2018,281,272
734,082628,Sant Vicenç de Castellet,248,2018,705,457
735,082649,Sant Vicenç de Montalt,119,2018,541,422
736,082652,Sant Vicenç de Torelló,49,2018,122,73
737,082634,Sant Vicenç dels Horts,205,2018,1396,1191
738,431384,Santa Bàrbara,-42,2018,157,199
739,082439,Santa Cecília de Voltregà,-3,2018,4,7
740,082444,Santa Coloma de Cervelló,65,2018,396,331
741,171805,Santa Coloma de Farners,328,2018,774,446
742,082457,Santa Coloma de Gramenet,594,2018,8123,7529
743,431397,Santa Coloma de Queralt,10,2018,137,127
744,171812,Santa Cristina d'Aro,37,2018,374,337
745,082460,Santa Eugènia de Berga,22,2018,135,113
746,082476,Santa Eulàlia de Riuprimer,34,2018,88,54
747,082482,Santa Eulàlia de Ronçana,108,2018,445,337
748,082495,Santa Fe del Penedès,-1,2018,13,14
749,171827,Santa Llogaia d'Àlguema,7,2018,37,30
750,082508,Santa Margarida de Montbui,164,2018,639,475
751,082515,Santa Margarida i els Monjos,99,2018,442,343
752,082589,Santa Maria d'Oló,4,2018,48,44
753,082536,Santa Maria de Besora,8,2018,16,8
754,082567,Santa Maria de Martorelles,14,2018,48,34
755,082554,Santa Maria de Merlès,-1,2018,5,6
756,082573,Santa Maria de Miralles,-1,2018,5,6
757,082592,Santa Maria de Palautordera,90,2018,585,495
758,431401,Santa Oliva,14,2018,256,242
759,171848,Santa Pau,0,2018,63,63
760,082606,Santa Perpètua de Mogoda,98,2018,1387,1289
761,082613,Santa Susanna,65,2018,356,291
762,081923,Santpedor,45,2018,306,261
763,431423,Sarral,12,2018,94,82
764,171864,Sarrià de Ter,62,2018,385,323
765,252017,Sarroca de Bellera,0,2018,7,7
766,252000,Sarroca de Lleida,8,2018,15,7
767,171870,"Saus, Camallera i Llampaies",-5,2018,52,57
768,431439,Savallà del Comtat,0,2018,6,6
769,431444,"Secuita, la",-9,2018,114,123
770,171886,"Selva de Mar, la",11,2018,22,11
771,431457,"Selva del Camp, la",38,2018,277,239
772,431460,Senan,1,2018,1,0
773,430445,"Sénia, la",52,2018,265,213
774,252022,Senterada,0,2018,8,8
775,250352,"Sentiu de Sió, la",-14,2018,22,36
776,082671,Sentmenat,92,2018,499,407
777,171903,Serinyà,34,2018,81,47
778,252043,Seròs,31,2018,132,101
779,171910,Serra de Daró,16,2018,27,11
780,171925,Setcases,6,2018,19,13
781,252038,"Seu d'Urgell, la",86,2018,774,688
782,082690,Seva,68,2018,226,158
783,252056,Sidamon,6,2018,34,28
784,171931,Sils,116,2018,427,311
785,082704,Sitges,679,2018,2598,1919
786,170524,Siurana,6,2018,13,7
787,082711,Sobremunt,1,2018,11,10
788,252069,"Soleràs, el",6,2018,23,17
789,431476,Solivella,14,2018,35,21
790,252075,Solsona,123,2018,515,392
791,082726,Sora,1,2018,22,21
792,252081,Soriguera,12,2018,39,27
793,252094,Sort,22,2018,134,112
794,252108,Soses,3,2018,105,102
795,082732,Subirats,21,2018,170,149
796,252115,Sudanell,15,2018,39,24
797,252120,Sunyer,0,2018,29,29
798,082747,Súria,69,2018,237,168
799,171946,Susqueda,6,2018,12,6
800,082763,Tagamanent,-7,2018,22,29
801,082779,Talamanca,2,2018,28,26
802,252154,Talarn,-58,2018,226,284
803,252167,Talavera,30,2018,35,5
804,171959,"Tallada d'Empordà, la",11,2018,32,21
805,082785,Taradell,72,2018,328,256
806,431482,Tarragona,2319,2018,8347,6028
807,252173,Tàrrega,334,2018,989,655
808,252189,Tarrés,10,2018,13,3
809,252192,Tarroja de Segarra,5,2018,9,4
810,082750,Tavèrnoles,-8,2018,5,13
811,082802,Tavertet,0,2018,7,7
812,082819,Teià,111,2018,421,310
813,252206,Térmens,-42,2018,59,101
814,171962,Terrades,13,2018,29,16
815,082798,Terrassa,2344,2018,10565,8221
816,082824,Tiana,123,2018,511,388
817,252213,Tírvia,-3,2018,9,12
818,252228,Tiurana,-2,2018,6,8
819,431495,Tivenys,28,2018,54,26
820,431508,Tivissa,-9,2018,72,81
821,082830,Tona,128,2018,457,329
822,252234,Torà,35,2018,113,78
823,082845,Tordera,328,2018,1198,870
824,082858,Torelló,171,2018,687,516
825,252249,"Torms, els",-3,2018,0,3
826,252252,Tornabous,4,2018,52,48
827,252271,"Torre de Cabdella, la",20,2018,52,32
828,082861,"Torre de Claramunt, la",18,2018,173,155
829,431515,"Torre de Fontaubella, la",3,2018,15,12
830,431520,"Torre de l'Espanyol, la",-12,2018,18,30
831,252265,Torrebesses,-1,2018,5,6
832,431536,Torredembarra,180,2018,1240,1060
833,252287,Torrefarrera,2,2018,283,281
834,259078,Torrefeta i Florejacs,16,2018,37,21
835,252304,Torregrossa,28,2018,110,82
836,252311,Torrelameu,5,2018,55,50
837,082877,Torrelavit,-4,2018,76,80
838,082883,Torrelles de Foix,94,2018,256,162
839,082896,Torrelles de Llobregat,89,2018,378,289
840,171978,Torrent,14,2018,19,5
841,252326,Torres de Segre,60,2018,346,286
842,252332,Torre-serona,9,2018,35,26
843,171984,Torroella de Fluvià,-11,2018,67,78
844,171997,Torroella de Montgrí,140,2018,757,617
845,431541,Torroja del Priorat,4,2018,7,3
846,172001,Tortellà,18,2018,48,30
847,431554,Tortosa,24,2018,1804,1780
848,172018,Toses,8,2018,15,7
849,172023,Tossa de Mar,135,2018,372,237
850,252347,Tremp,112,2018,442,330
851,172044,Ullà,14,2018,128,114
852,082900,Ullastrell,35,2018,145,110
853,172057,Ullastret,3,2018,21,18
854,431567,Ulldecona,63,2018,397,334
855,431573,Ulldemolins,1,2018,13,12
856,172039,Ultramort,7,2018,18,11
857,172060,Urús,14,2018,24,10
858,082917,Vacarisses,166,2018,519,353
859,170144,"Vajol, la",3,2018,8,5
860,172076,"Vall d'en Bas, la",47,2018,121,74
861,172082,"Vall de Bianya, la",-13,2018,83,96
862,250432,"Vall de Boí, la",2,2018,73,71
863,259010,Vall de Cardós,-4,2018,19,23
864,082922,Vallbona d'Anoia,-7,2018,68,75
865,252385,Vallbona de les Monges,2,2018,15,13
866,082938,Vallcebre,6,2018,16,10
867,431589,Vallclara,2,2018,5,3
868,252402,Vallfogona de Balaguer,0,2018,82,82
869,171707,Vallfogona de Ripollès,-4,2018,12,16
870,431592,Vallfogona de Riucorb,8,2018,9,1
871,082943,Vallgorguina,28,2018,225,197
872,082956,Vallirana,185,2018,935,750
873,172095,Vall-llobrega,-13,2018,47,60
874,431606,Vallmoll,22,2018,127,105
875,082969,Vallromanes,47,2018,164,117
876,431613,Valls,319,2018,1272,953
877,259062,"Valls d'Aguilar, les",2,2018,18,16
878,252398,"Valls de Valira, les",10,2018,77,67
879,431628,Vandellòs i l'Hospitalet de l'Infant,68,2018,469,401
880,259097,"Vansa i Fórnols, la",-4,2018,7,11
881,082975,Veciana,11,2018,18,7
882,431634,"Vendrell, el",576,2018,2816,2240
883,172109,Ventalló,-15,2018,65,80
884,252424,Verdú,29,2018,57,28
885,172116,Verges,-9,2018,75,84
886,431649,Vespella de Gaià,7,2018,34,27
887,082981,Vic,1062,2018,3629,2567
888,172121,Vidrà,-6,2018,8,14
889,172137,Vidreres,109,2018,566,457
890,252430,Vielha e Mijaran,65,2018,425,360
891,431652,Vilabella,-5,2018,17,22
892,172142,Vilabertran,29,2018,85,56
893,172155,Vilablareix,101,2018,227,126
894,082994,Vilada,-8,2018,15,23
895,172174,Viladamat,1,2018,19,18
896,172168,Viladasens,-1,2018,13,14
897,083015,Viladecans,383,2018,3121,2738
898,083008,Viladecavalls,22,2018,383,361
899,172180,Vilademuls,3,2018,56,53
900,172207,Viladrau,23,2018,68,45
901,172214,Vilafant,-33,2018,289,322
902,083054,Vilafranca del Penedès,-74,2018,1984,2058
903,252445,Vilagrassa,32,2018,69,37
904,172235,Vilajuïga,-23,2018,60,83
905,431750,Vilalba dels Arcs,-4,2018,11,15
906,083067,Vilalba Sasserra,30,2018,104,74
907,252458,Vilaller,29,2018,61,32
908,172240,Vilallonga de Ter,0,2018,15,15
909,431665,Vilallonga del Camp,38,2018,183,145
910,172253,Vilamacolum,32,2018,57,25
911,172266,Vilamalla,16,2018,83,67
912,172272,Vilamaniscle,-6,2018,30,36
913,252477,Vilamòs,30,2018,51,21
914,172288,Vilanant,-3,2018,24,27
915,431671,Vilanova d'Escornalbou,-2,2018,28,30
916,252483,Vilanova de Bellpuig,25,2018,73,48
917,252496,Vilanova de l'Aguda,-1,2018,3,4
918,252542,Vilanova de la Barca,-17,2018,70,87
919,252509,Vilanova de Meià,-1,2018,16,17
920,431687,Vilanova de Prades,-1,2018,5,6
921,083036,Vilanova de Sau,-8,2018,9,17
922,252516,Vilanova de Segrià,27,2018,63,36
923,083020,Vilanova del Camí,90,2018,572,482
924,089024,Vilanova del Vallès,51,2018,329,278
925,083073,Vilanova i la Geltrú,510,2018,3712,3202
926,431690,Vilaplana,-3,2018,22,25
927,431704,Vila-rodona,5,2018,76,71
928,172305,Vila-sacra,49,2018,80,31
929,252521,Vila-sana,29,2018,60,31
930,431711,Vila-seca,100,2018,1346,1246
931,082140,Vilassar de Dalt,47,2018,437,390
932,082191,Vilassar de Mar,99,2018,1127,1028
933,172229,Vilaür,8,2018,11,3
934,431726,Vilaverd,-6,2018,36,42
935,431732,"Vilella Alta, la",1,2018,5,4
936,431747,"Vilella Baixa, la",-2,2018,12,14
937,172333,Vilobí d'Onyar,70,2018,209,139
938,083041,Vilobí del Penedès,10,2018,74,64
939,172327,Vilopriu,0,2018,18,18
940,252537,"Vilosell, el",2,2018,14,12
941,431763,Vimbodí i Poblet,-14,2018,40,54
942,252555,Vinaixa,-9,2018,13,22
943,431779,Vinebre,-2,2018,18,20
944,431785,Vinyols i els Arcs,95,2018,240,145
945,083089,Viver i Serrateix,4,2018,7,3
946,430521,Xerta,8,2018,64,56
0,250019,Abella de la Conca,8,2019,14,6
1,080018,Abrera,37,2019,650,613
2,250024,Àger,10,2019,42,32
3,250030,Agramunt,60,2019,244,184
4,080023,Aguilar de Segarra,-4,2019,9,13
5,170010,Agullana,30,2019,84,54
6,080142,Aiguafreda,22,2019,161,139
7,430017,Aiguamúrcia,25,2019,84,59
8,170025,Aiguaviva,11,2019,48,37
9,250387,Aitona,-15,2019,227,242
10,250045,"Alamús, els",2,2019,58,56
11,250058,Alàs i Cerc,-5,2019,11,16
12,250061,"Albagés, l'",2,2019,10,8
13,170031,Albanyà,0,2019,18,18
14,250077,Albatàrrec,12,2019,171,159
15,250083,Albesa,2,2019,81,79
16,250096,"Albi, l'",-12,2019,17,29
17,430022,Albinyana,47,2019,191,144
18,430038,"Albiol, l'",13,2019,35,22
19,170046,Albons,1,2019,51,50
20,430043,Alcanar,117,2019,512,395
21,250100,Alcanó,3,2019,6,3
22,250117,Alcarràs,241,2019,701,460
23,250122,Alcoletge,28,2019,245,217
24,430056,Alcover,72,2019,255,183
25,439044,"Aldea, l'",33,2019,264,231
26,430069,Aldover,29,2019,65,36
27,430075,"Aleixar, l'",17,2019,58,41
28,080039,Alella,166,2019,690,524
29,430081,Alfara de Carles,-5,2019,17,22
30,250138,Alfarràs,-13,2019,112,125
31,250143,Alfés,-4,2019,13,17
32,430094,Alforja,9,2019,96,87
33,250156,Algerri,22,2019,36,14
34,250169,Alguaire,67,2019,211,144
35,250175,Alins,3,2019,9,6
36,430108,Alió,19,2019,42,23
37,250194,Almacelles,153,2019,412,259
38,250208,Almatret,-3,2019,19,22
39,250215,Almenar,-12,2019,169,181
40,430115,Almoster,-6,2019,43,49
41,250220,Alòs de Balaguer,4,2019,13,9
42,170062,Alp,26,2019,137,111
43,080044,Alpens,-5,2019,14,19
44,250236,Alpicat,30,2019,289,259
45,250241,Alt Àneu,10,2019,24,14
46,430120,Altafulla,70,2019,403,333
47,170078,Amer,49,2019,138,89
48,430136,"Ametlla de Mar, l'",163,2019,488,325
49,080057,"Ametlla del Vallès, l'",166,2019,637,471
50,439060,"Ampolla, l'",105,2019,324,219
51,430141,Amposta,442,2019,1232,790
52,170084,Anglès,47,2019,364,317
53,250273,Anglesola,9,2019,80,71
54,250292,Arbeca,30,2019,111,81
55,430167,"Arboç, l'",88,2019,448,360
56,430154,Arbolí,-6,2019,4,10
57,170097,Arbúcies,81,2019,303,222
58,080060,Arenys de Mar,303,2019,1170,867
59,080076,Arenys de Munt,206,2019,598,392
60,170101,Argelaguer,5,2019,33,28
61,080082,Argençola,3,2019,13,10
62,430173,"Argentera, l'",-4,2019,5,9
63,080095,Argentona,115,2019,691,576
64,170118,"Armentera, l'",20,2019,57,37
65,430189,Arnes,-9,2019,17,26
66,250313,Arres,-4,2019,0,4
67,250328,Arsèguel,-3,2019,5,8
68,080109,Artés,68,2019,330,262
69,250334,Artesa de Lleida,56,2019,117,61
70,250349,Artesa de Segre,27,2019,184,157
71,430192,Ascó,1,2019,48,47
72,250365,Aspa,-4,2019,10,14
73,250371,"Avellanes i Santa Linya, les",-6,2019,22,28
74,080116,Avià,4,2019,125,121
75,080121,Avinyó,41,2019,119,78
76,170123,Avinyonet de Puigventós,23,2019,109,86
77,080137,Avinyonet del Penedès,5,2019,107,102
78,080155,Badalona,2891,2019,13884,10993
79,089045,Badia del Vallès,38,2019,649,611
80,080168,Bagà,13,2019,93,80
81,250390,Baix Pallars,4,2019,22,18
82,250404,Balaguer,300,2019,1154,854
83,080174,Balenyà,33,2019,245,212
84,080180,Balsareny,46,2019,153,107
85,430206,Banyeres del Penedès,24,2019,249,225
86,170157,Banyoles,250,2019,1094,844
87,250411,Barbens,48,2019,86,38
88,430213,Barberà de la Conca,3,2019,34,31
89,082520,Barberà del Vallès,257,2019,1713,1456
90,080193,Barcelona,23252,2019,122009,98757
91,250426,"Baronia de Rialb, la",-3,2019,10,13
92,170160,Bàscara,-16,2019,71,87
93,250447,Bassella,-6,2019,11,17
94,430228,Batea,28,2019,64,36
95,250450,Bausen,2,2019,7,5
96,080207,Begues,192,2019,555,363
97,170139,Begur,40,2019,241,201
98,250463,Belianes,-2,2019,18,20
99,251706,Bellaguarda,3,2019,7,4
100,170182,Bellcaire d'Empordà,-11,2019,44,55
101,250479,Bellcaire d'Urgell,-19,2019,50,69
102,250485,Bell-lloc d'Urgell,28,2019,141,113
103,250498,Bellmunt d'Urgell,1,2019,3,2
104,430234,Bellmunt del Priorat,5,2019,14,9
105,080214,Bellprat,2,2019,5,3
106,250501,Bellpuig,156,2019,373,217
107,430249,Bellvei,41,2019,193,152
108,250518,Bellver de Cerdanya,86,2019,179,93
109,250523,Bellvís,17,2019,145,128
110,250539,Benavent de Segrià,24,2019,94,70
111,430252,Benifallet,-1,2019,27,28
112,430265,Benissanet,11,2019,63,52
113,080229,Berga,386,2019,1089,703
114,170195,Besalú,22,2019,120,98
115,170209,Bescanó,27,2019,219,192
116,170216,Beuda,-3,2019,14,17
117,080235,Bigues i Riells del Fai,233,2019,673,440
118,250557,Biosca,2,2019,12,10
119,170221,"Bisbal d'Empordà, la",140,2019,688,548
120,430271,"Bisbal de Falset, la",-1,2019,9,10
121,430287,"Bisbal del Penedès, la",121,2019,340,219
122,172348,Biure,12,2019,25,13
123,430290,Blancafort,3,2019,21,18
124,170237,Blanes,879,2019,2780,1901
125,170293,Boadella i les Escaules,19,2019,27,8
126,170242,Bolvir,8,2019,34,26
127,430304,Bonastre,-4,2019,60,64
128,250576,"Bòrdes, Es",-3,2019,23,26
129,170255,Bordils,-5,2019,107,112
130,250582,"Borges Blanques, les",76,2019,336,260
131,430311,"Borges del Camp, les",26,2019,130,104
132,170268,Borrassà,17,2019,67,50
133,080240,Borredà,10,2019,44,34
134,250595,Bossòst,6,2019,89,83
135,430326,Bot,-16,2019,16,32
136,430332,Botarell,5,2019,61,56
137,250560,Bovera,5,2019,14,9
138,430347,Bràfim,2,2019,29,27
139,170274,Breda,35,2019,209,174
140,080253,"Bruc, el",55,2019,172,117
141,080266,"Brull, el",-5,2019,13,18
142,170280,Brunyola i Sant Martí Sapresa,5,2019,38,33
143,430350,Cabacés,6,2019,18,12
144,250609,Cabanabona,-1,2019,7,8
145,170314,Cabanelles,-11,2019,34,45
146,170307,Cabanes,21,2019,105,84
147,080272,"Cabanyes, les",12,2019,54,42
148,250616,Cabó,2,2019,4,2
149,430363,Cabra del Camp,18,2019,92,74
150,080288,Cabrera d'Anoia,80,2019,177,97
151,080291,Cabrera de Mar,72,2019,364,292
152,080305,Cabrils,33,2019,562,529
153,170329,Cadaqués,-15,2019,131,146
154,080312,Calaf,115,2019,261,146
155,430379,Calafell,900,2019,3283,2383
156,080348,Calders,72,2019,116,44
157,080327,Caldes d'Estrac,76,2019,369,293
158,170335,Caldes de Malavella,181,2019,634,453
159,080333,Caldes de Montbui,296,2019,1046,750
160,080351,Calella,357,2019,1691,1334
161,080370,Calldetenes,19,2019,125,106
162,080386,Callús,-2,2019,140,142
163,080364,Calonge de Segarra,2,2019,6,4
164,170340,Calonge i Sant Antoni,255,2019,1004,749
165,250621,Camarasa,2,2019,33,31
166,439039,Camarles,13,2019,127,114
167,430385,Cambrils,924,2019,2751,1827
168,170353,Camós,-13,2019,24,37
169,170366,Campdevànol,47,2019,156,109
170,170372,Campelles,-1,2019,8,9
171,080399,Campins,15,2019,56,41
172,170388,Campllong,-13,2019,18,31
173,170391,Camprodon,27,2019,197,170
174,250637,Canejan,-14,2019,4,18
175,170405,Canet d'Adri,3,2019,42,39
176,080403,Canet de Mar,390,2019,1046,656
177,439076,"Canonja, la",58,2019,298,240
178,080410,Canovelles,82,2019,1261,1179
179,080425,Cànoves i Samalús,37,2019,231,194
180,170412,Cantallops,-3,2019,11,14
181,080431,Canyelles,54,2019,392,338
182,430398,Capafonts,-10,2019,3,13
183,430402,Capçanes,-1,2019,18,19
184,080446,Capellades,73,2019,328,255
185,170427,Capmany,-13,2019,45,58
186,080459,Capolat,-8,2019,3,11
187,080462,Cardedeu,28,2019,908,880
188,080478,Cardona,12,2019,182,170
189,080484,Carme,23,2019,56,33
190,430419,Caseres,-20,2019,3,23
191,170448,Cassà de la Selva,46,2019,611,565
192,080497,Casserres,-2,2019,75,77
193,080575,Castell de l'Areny,-2,2019,0,2
194,259046,Castell de Mur,-7,2019,2,9
195,250642,Castellar de la Ribera,-4,2019,2,6
196,080522,Castellar de n'Hug,-2,2019,11,13
197,080500,Castellar del Riu,4,2019,13,9
198,080517,Castellar del Vallès,328,2019,1180,852
199,080538,Castellbell i el Vilar,94,2019,293,199
200,080543,Castellbisbal,144,2019,730,586
201,080556,Castellcir,-1,2019,55,56
202,250674,Castelldans,-7,2019,38,45
203,080569,Castelldefels,828,2019,5355,4527
204,080581,Castellet i la Gornal,88,2019,255,167
205,170464,Castellfollit de la Roca,-7,2019,55,62
206,080608,Castellfollit de Riubregós,13,2019,18,5
207,080594,Castellfollit del Boix,6,2019,19,13
208,080615,Castellgalí,62,2019,203,141
209,080620,Castellnou de Bages,45,2019,130,85
210,250680,Castellnou de Seana,-14,2019,32,46
211,170470,Castelló d'Empúries,201,2019,1042,841
212,250693,Castelló de Farfanya,6,2019,40,34
213,080636,Castellolí,3,2019,37,34
214,170486,Castell-Platja d'Aro,208,2019,1233,1025
215,250707,Castellserà,3,2019,49,46
216,080641,Castellterçol,114,2019,256,142
217,430424,Castellvell del Camp,-26,2019,158,184
218,080654,Castellví de la Marca,43,2019,115,72
219,080667,Castellví de Rosanes,44,2019,169,125
220,430430,"Catllar, el",93,2019,333,240
221,250714,Cava,0,2019,1,1
222,171899,"Cellera de Ter, la",29,2019,100,71
223,170499,Celrà,73,2019,328,255
224,080673,Centelles,118,2019,401,283
225,082687,Cercs,19,2019,69,50
226,082665,Cerdanyola del Vallès,417,2019,3347,2930
227,080689,Cervelló,44,2019,598,554
228,250729,Cervera,132,2019,479,347
229,250735,Cervià de les Garrigues,30,2019,55,25
230,170502,Cervià de Ter,1,2019,61,60
231,170519,Cistella,8,2019,31,23
232,250740,Ciutadilla,0,2019,8,8
233,250753,Clariana de Cardener,3,2019,8,5
234,250766,"Cogul, el",-3,2019,5,8
235,170545,Colera,-3,2019,26,29
236,250772,Coll de Nargó,-2,2019,24,26
237,080692,Collbató,62,2019,305,243
238,430458,Colldejou,-9,2019,7,16
239,080706,Collsuspina,17,2019,27,10
240,170558,Colomers,-1,2019,5,6
241,251636,"Coma i la Pedra, la",-9,2019,21,30
242,251615,Conca de Dalt,-2,2019,13,15
243,430461,Conesa,0,2019,11,11
244,430477,Constantí,106,2019,464,358
245,080713,Copons,11,2019,22,11
246,430483,Corbera d'Ebre,-17,2019,36,53
247,080728,Corbera de Llobregat,105,2019,869,764
248,250788,Corbins,27,2019,88,61
249,170577,Corçà,4,2019,70,66
250,080734,Cornellà de Llobregat,1471,2019,6027,4556
251,170561,Cornellà del Terri,47,2019,167,120
252,430496,Cornudella de Montsant,12,2019,61,49
253,430509,Creixell,134,2019,417,283
254,170583,Crespià,6,2019,31,25
255,179011,"Cruïlles, Monells i Sant Sadurní de l'Heura",-7,2019,68,75
256,080749,Cubelles,476,2019,1438,962
257,250791,Cubells,-2,2019,12,14
258,430516,Cunit,681,2019,1770,1089
259,170600,Darnius,-1,2019,33,34
260,170617,Das,-28,2019,13,41
261,439018,Deltebre,125,2019,505,380
262,080752,Dosrius,153,2019,491,338
263,430537,Duesaigües,6,2019,29,23
264,170622,"Escala, l'",15,2019,510,495
265,080765,Esparreguera,58,2019,1096,1038
266,170638,Espinelves,7,2019,16,9
267,250812,"Espluga Calba, l'",-10,2019,7,17
268,430542,"Espluga de Francolí, l'",34,2019,167,133
269,080771,Esplugues de Llobregat,622,2019,3451,2829
270,170643,Espolla,1,2019,11,10
271,170656,Esponellà,31,2019,47,16
272,250827,Espot,-1,2019,22,23
273,080787,"Espunyola, l'",-9,2019,4,13
274,082541,"Esquirol, l'",24,2019,101,77
275,250886,Estamariu,8,2019,15,7
276,080790,"Estany, l'",4,2019,21,17
277,250851,Estaràs,-5,2019,10,15
278,250864,Esterri d'Àneu,34,2019,81,47
279,250870,Esterri de Cardós,-5,2019,1,6
280,430555,Falset,-35,2019,108,143
281,170059,"Far d'Empordà, el",3,2019,34,31
282,250899,Farrera,-7,2019,5,12
283,430568,"Fatarella, la",-8,2019,19,27
284,430574,"Febró, la",0,2019,0,0
285,081347,Figaró-Montmany,40,2019,129,89
286,080804,Fígols,3,2019,6,3
287,259084,Fígols i Alinyà,2,2019,9,7
288,430580,"Figuera, la",-1,2019,7,8
289,170669,Figueres,546,2019,3269,2723
290,430593,Figuerola del Camp,8,2019,20,12
291,170675,Flaçà,40,2019,106,66
292,430607,Flix,31,2019,175,144
293,250925,"Floresta, la",-6,2019,5,11
294,080826,Fogars de la Selva,20,2019,133,113
295,080811,Fogars de Montclús,6,2019,32,26
296,170681,Foixà,10,2019,15,5
297,080832,Folgueroles,-7,2019,78,85
298,250931,Fondarella,-6,2019,43,49
299,080847,Fonollosa,11,2019,88,77
300,170694,Fontanals de Cerdanya,-7,2019,41,48
301,170708,Fontanilles,11,2019,21,10
302,170715,Fontcoberta,-4,2019,62,66
303,080850,Font-rubí,85,2019,150,65
304,250946,Foradada,20,2019,38,18
305,179026,Forallac,16,2019,123,107
306,430614,Forès,1,2019,2,1
307,170736,Fornells de la Selva,19,2019,125,106
308,170741,Fortià,29,2019,83,54
309,080863,"Franqueses del Vallès, les",233,2019,1412,1179
310,430629,Freginals,37,2019,56,19
311,250962,"Fuliola, la",13,2019,53,40
312,250978,Fulleda,17,2019,17,0
313,080902,Gaià,7,2019,16,9
314,430635,"Galera, la",10,2019,53,43
315,080879,Gallifa,-3,2019,10,13
316,430640,Gandesa,53,2019,169,116
317,430653,Garcia,12,2019,44,32
318,430666,"Garidells, els",7,2019,19,12
319,080885,"Garriga, la",157,2019,847,690
320,170754,Garrigàs,15,2019,29,14
321,170767,Garrigoles,9,2019,20,11
322,170773,Garriguella,-53,2019,66,119
323,080898,Gavà,444,2019,2875,2431
324,250984,Gavet de la Conca,1,2019,10,9
325,080919,Gelida,133,2019,504,371
326,170789,Ger,4,2019,30,26
327,259123,Gimenells i el Pla de la Font,23,2019,65,42
328,430672,Ginestar,20,2019,44,24
329,170792,Girona,1447,2019,8448,7001
330,080924,Gironella,147,2019,305,158
331,080930,Gisclareny,0,2019,2,2
332,430688,Godall,17,2019,41,24
333,250997,Golmés,25,2019,113,88
334,170806,Gombrèn,4,2019,10,6
335,251001,Gósol,5,2019,20,15
336,080945,"Granada, la",47,2019,155,108
337,251018,"Granadella, la",20,2019,46,26
338,080958,Granera,9,2019,13,4
339,251023,"Granja d'Escarp, la",-12,2019,57,69
340,080961,Granollers,1126,2019,4663,3537
341,251039,Granyanella,-8,2019,5,13
342,251057,Granyena de les Garrigues,9,2019,13,4
343,251044,Granyena de Segarra,10,2019,13,3
344,430691,Gratallops,12,2019,24,12
345,080977,Gualba,53,2019,159,106
346,170813,Gualta,12,2019,70,58
347,080996,Guardiola de Berguedà,40,2019,91,51
348,430705,"Guiamets, els",16,2019,26,10
349,170828,Guils de Cerdanya,11,2019,44,33
350,251095,Guimerà,10,2019,18,8
351,259031,"Guingueta d'Àneu, la",-6,2019,16,22
352,251109,Guissona,92,2019,466,374
353,251116,Guixers,-2,2019,7,9
354,081000,Gurb,26,2019,131,105
355,430712,Horta de Sant Joan,14,2019,65,51
356,081017,"Hospitalet de Llobregat, l'",6143,2019,24655,18512
357,081629,"Hostalets de Pierola, els",5,2019,205,200
358,170834,Hostalric,70,2019,292,222
359,081022,Igualada,871,2019,2668,1797
360,251155,Isona i Conca Dellà,26,2019,61,35
361,170849,Isòvol,-2,2019,14,16
362,251137,Ivars d'Urgell,16,2019,96,80
363,251121,Ivars de Noguera,-1,2019,11,12
364,251142,Ivorra,5,2019,6,1
365,170852,Jafre,10,2019,24,14
366,170865,"Jonquera, la",62,2019,354,292
367,081038,Jorba,-4,2019,54,58
368,259101,Josa i Tuixén,0,2019,10,10
369,170871,Juià,-3,2019,18,21
370,251180,Juncosa,12,2019,30,18
371,251193,Juneda,75,2019,240,165
372,251214,Les,28,2019,82,54
373,251229,Linyola,40,2019,148,108
374,081043,"Llacuna, la",49,2019,97,48
375,170887,Lladó,25,2019,72,47
376,251235,Lladorre,8,2019,12,4
377,251240,Lladurs,6,2019,13,7
378,081056,"Llagosta, la",58,2019,821,763
379,170890,Llagostera,210,2019,583,373
380,170904,Llambilles,15,2019,42,27
381,170911,Llanars,36,2019,60,24
382,170926,Llançà,69,2019,277,208
383,251253,Llardecans,-5,2019,8,13
384,251266,Llavorsí,-4,2019,19,23
385,251207,Lleida,2203,2019,7641,5438
386,170932,Llers,3,2019,79,76
387,251272,Lles de Cerdanya,18,2019,28,10
388,081075,Lliçà d'Amunt,228,2019,976,748
389,081081,Lliçà de Vall,-12,2019,349,361
390,251288,Llimiana,5,2019,14,9
391,081069,Llinars del Vallès,124,2019,687,563
392,170947,Llívia,7,2019,113,106
393,430727,"Lloar, el",-1,2019,5,6
394,251291,Llobera,3,2019,10,7
395,430733,Llorac,-3,2019,4,7
396,430748,Llorenç del Penedès,35,2019,129,94
397,170950,Lloret de Mar,739,2019,3202,2463
398,170963,"Llosses, les",-2,2019,10,12
399,081094,Lluçà,5,2019,13,8
400,171024,Maçanet de Cabrenys,18,2019,55,37
401,171030,Maçanet de la Selva,97,2019,551,454
402,170979,Madremanya,5,2019,19,14
403,170985,Maià de Montcal,27,2019,65,38
404,251333,Maials,-6,2019,38,44
405,251305,Maldà,10,2019,17,7
406,081108,Malgrat de Mar,273,2019,1283,1010
407,081115,Malla,-8,2019,14,22
408,081120,Manlleu,402,2019,1301,899
409,081136,Manresa,1121,2019,4945,3824
410,430764,Marçà,9,2019,39,30
411,430751,Margalef,6,2019,8,2
412,082423,Marganell,5,2019,22,17
413,081141,Martorell,628,2019,1941,1313
414,081154,Martorelles,25,2019,317,292
415,430770,Mas de Barberans,-3,2019,18,21
416,171002,Masarac,2,2019,33,31
417,430786,Masdenverge,11,2019,75,64
418,081167,"Masies de Roda, les",17,2019,40,23
419,081173,"Masies de Voltregà, les",-8,2019,116,124
420,430799,Masllorenç,1,2019,37,36
421,081189,"Masnou, el",364,2019,1639,1275
422,430803,"Masó, la",6,2019,17,11
423,430810,Maspujols,-5,2019,38,43
424,081192,Masquefa,179,2019,605,426
425,430825,"Masroig, el",-1,2019,29,30
426,251312,Massalcoreig,28,2019,45,17
427,171019,Massanes,33,2019,78,45
428,251327,Massoteres,-5,2019,13,18
429,081206,Matadepera,159,2019,588,429
430,081213,Mataró,1552,2019,7025,5473
431,081228,Mediona,74,2019,202,128
432,251348,Menàrguens,9,2019,44,35
433,170998,Meranges,1,2019,9,8
434,171058,Mieres,29,2019,46,17
435,430831,"Milà, el",16,2019,25,9
436,251351,Miralcamp,46,2019,97,51
437,430846,Miravet,13,2019,42,29
438,081385,Moià,144,2019,455,311
439,430859,"Molar, el",0,2019,16,16
440,081234,Molins de Rei,120,2019,1143,1023
441,251370,Mollerussa,137,2019,905,768
442,171061,Mollet de Peralada,12,2019,14,2
443,081249,Mollet del Vallès,270,2019,2745,2475
444,171077,Molló,1,2019,20,19
445,251364,"Molsosa, la",0,2019,2,2
446,081287,Monistrol de Calders,17,2019,58,41
447,081271,Monistrol de Montserrat,105,2019,325,220
448,171096,Montagut i Oix,12,2019,45,33
449,430862,Montblanc,84,2019,331,247
450,430884,Montbrió del Camp,8,2019,227,219
451,081252,Montcada i Reixac,547,2019,2359,1812
452,081304,Montclar,3,2019,6,3
453,251399,Montellà i Martinet,-2,2019,43,45
454,081311,Montesquiu,29,2019,89,60
455,251403,Montferrer i Castellbò,-1,2019,75,76
456,430897,Montferri,15,2019,44,29
457,251386,Montgai,21,2019,37,16
458,081265,Montgat,132,2019,750,618
459,081326,Montmajor,5,2019,26,21
460,081332,Montmaneu,1,2019,8,7
461,430901,"Montmell, el",69,2019,207,138
462,081350,Montmeló,112,2019,486,374
463,251425,Montoliu de Lleida,0,2019,31,31
464,251410,Montoliu de Segarra,9,2019,19,10
465,251431,Montornès de Segarra,-4,2019,2,6
466,081363,Montornès del Vallès,191,2019,872,681
467,430918,Mont-ral,1,2019,15,14
468,171100,Mont-ras,14,2019,112,98
469,430923,Mont-roig del Camp,298,2019,1263,965
470,081379,Montseny,12,2019,42,30
471,430939,Móra d'Ebre,39,2019,341,302
472,430944,Móra la Nova,36,2019,166,130
473,430957,"Morell, el",13,2019,261,248
474,430960,"Morera de Montsant, la",9,2019,14,5
475,081290,Muntanyola,1,2019,46,45
476,081398,Mura,-5,2019,17,22
477,251459,Nalec,3,2019,5,2
478,250254,Naut Aran,37,2019,117,80
479,081402,Navarcles,99,2019,348,249
480,081419,Navàs,24,2019,256,232
481,171117,Navata,7,2019,135,128
482,251462,Navès,10,2019,22,12
483,081424,"Nou de Berguedà, la",2,2019,10,8
484,430976,"Nou de Gaià, la",3,2019,33,30
485,430982,Nulles,12,2019,30,18
486,251484,Odèn,6,2019,14,8
487,081430,Òdena,54,2019,233,179
488,171122,Ogassa,10,2019,13,3
489,081458,Olèrdola,83,2019,310,227
490,081461,Olesa de Bonesvalls,43,2019,159,116
491,081477,Olesa de Montserrat,254,2019,1240,986
492,251497,Oliana,50,2019,131,81
493,251500,Oliola,12,2019,13,1
494,251517,Olius,-3,2019,56,59
495,081483,Olivella,158,2019,456,298
496,081496,Olost,6,2019,56,50
497,171143,Olot,876,2019,2137,1261
498,251522,"Oluges, les",4,2019,5,1
499,081445,Olvan,6,2019,54,48
500,251538,"Omellons, els",-2,2019,5,7
501,251543,"Omells de na Gaia, els",2,2019,4,2
502,171156,Ordis,-2,2019,12,14
503,251556,Organyà,1,2019,48,47
504,081509,Orís,11,2019,25,14
505,081516,Oristà,14,2019,33,19
506,081521,Orpí,0,2019,7,7
507,081537,Òrrius,15,2019,59,44
508,251569,Os de Balaguer,-5,2019,53,58
509,171169,Osor,-6,2019,27,33
510,251575,Ossó de Sió,0,2019,8,8
511,081542,Pacs del Penedès,2,2019,54,52
512,081555,Palafolls,191,2019,650,459
513,171175,Palafrugell,308,2019,1207,899
514,171181,Palamós,339,2019,1278,939
515,251581,"Palau d'Anglesola, el",6,2019,90,84
516,171194,Palau de Santa Eulàlia,-4,2019,1,5
517,171215,Palau-sator,-1,2019,14,15
518,171208,Palau-saverdera,7,2019,120,113
519,081568,Palau-solità i Plegamans,142,2019,817,675
520,431009,"Pallaresos, els",96,2019,303,207
521,081574,Pallejà,126,2019,663,537
522,430995,"Palma d'Ebre, la",-1,2019,7,8
523,089058,"Palma de Cervelló, la",38,2019,214,176
524,171236,Palol de Revardit,-3,2019,12,15
525,171241,Pals,48,2019,182,134
526,081580,"Papiol, el",29,2019,223,194
527,171254,Pardines,8,2019,11,3
528,081593,Parets del Vallès,-14,2019,960,974
529,171267,Parlavà,-1,2019,16,17
530,431016,Passanant i Belltall,-6,2019,14,20
531,171289,Pau,10,2019,47,37
532,431021,Paüls,-7,2019,6,13
533,171292,Pedret i Marzà,-7,2019,3,10
534,251641,Penelles,-10,2019,11,21
535,171306,"Pera, la",-5,2019,22,27
536,081607,Perafita,7,2019,26,19
537,431037,Perafort,-11,2019,78,89
538,171328,Peralada,50,2019,148,98
539,251654,Peramola,3,2019,13,10
540,431042,"Perelló, el",67,2019,188,121
541,081614,Piera,579,2019,1349,770
542,431055,"Piles, les",-4,2019,14,18
543,081635,Pineda de Mar,891,2019,2276,1385
544,431068,"Pinell de Brai, el",-8,2019,22,30
545,251667,Pinell de Solsonès,-6,2019,4,10
546,251673,Pinós,-3,2019,11,14
547,431074,Pira,9,2019,25,16
548,431080,"Pla de Santa Maria, el",17,2019,168,151
549,081640,"Pla del Penedès, el",18,2019,71,53
550,171334,"Planes d'Hostoles, les",34,2019,105,71
551,171349,Planoles,14,2019,27,13
552,259118,"Plans de Sió, els",-8,2019,23,31
553,251689,"Poal, el",15,2019,31,16
554,251692,"Pobla de Cérvoles, la",4,2019,11,7
555,081653,"Pobla de Claramunt, la",-8,2019,114,122
556,081666,"Pobla de Lillet, la",16,2019,46,30
557,431093,"Pobla de Mafumet, la",41,2019,345,304
558,431107,"Pobla de Massaluca, la",2,2019,14,12
559,431114,"Pobla de Montornès, la",66,2019,246,180
560,251713,"Pobla de Segur, la",71,2019,233,162
561,431129,Poboleda,12,2019,21,9
562,081672,Polinyà,-20,2019,384,404
563,431135,"Pont d'Armentera, el",-14,2019,20,34
564,250306,"Pont de Bar, el",4,2019,19,15
565,171352,Pont de Molins,-7,2019,25,32
566,251734,"Pont de Suert, el",44,2019,151,107
567,081825,"Pont de Vilomara i Rocafort, el",83,2019,226,143
568,431418,Pontils,4,2019,9,5
569,081688,Pontons,-1,2019,60,61
570,171365,Pontós,-2,2019,25,27
571,251728,Ponts,78,2019,185,107
572,171371,Porqueres,64,2019,225,161
573,431140,Porrera,-4,2019,11,15
574,171404,"Port de la Selva, el",-6,2019,54,60
575,171387,Portbou,22,2019,94,72
576,251749,"Portella, la",12,2019,77,65
577,431153,Pradell de la Teixeta,8,2019,9,1
578,431166,Prades,5,2019,32,27
579,431172,Prat de Comte,-1,2019,8,9
580,081691,"Prat de Llobregat, el",817,2019,3133,2316
581,431188,Pratdip,11,2019,50,39
582,081712,Prats de Lluçanès,49,2019,141,92
583,081705,"Prats de Rei, els",4,2019,31,27
584,251752,Prats i Sansor,3,2019,24,21
585,251765,Preixana,9,2019,21,12
586,251771,Preixens,-8,2019,25,33
587,082303,Premià de Dalt,9,2019,653,644
588,081727,Premià de Mar,434,2019,1854,1420
589,171390,"Preses, les",68,2019,120,52
590,251790,Prullans,0,2019,21,21
591,171411,Puigcerdà,299,2019,814,515
592,081748,Puigdàlber,1,2019,27,26
593,251804,Puiggròs,2,2019,9,7
594,431191,Puigpelat,14,2019,73,59
595,081751,Puig-reig,172,2019,359,187
596,251811,Puigverd d'Agramunt,-13,2019,18,31
597,251826,Puigverd de Lleida,12,2019,62,50
598,081764,Pujalt,2,2019,13,11
599,081770,"Quar, la",-2,2019,3,5
600,171426,Quart,57,2019,246,189
601,170433,Queralbs,1,2019,9,8
602,431205,Querol,11,2019,61,50
603,171432,Rabós,6,2019,19,13
604,081786,Rajadell,-15,2019,15,30
605,431212,Rasquera,7,2019,33,26
606,171447,Regencós,9,2019,17,8
607,081799,Rellinars,25,2019,79,54
608,431227,Renau,3,2019,12,9
609,431233,Reus,1690,2019,5379,3689
610,251832,Rialp,-13,2019,54,67
611,431248,"Riba, la",-1,2019,24,25
612,431251,Riba-roja d'Ebre,-1,2019,50,51
613,259059,Ribera d'Ondara,10,2019,17,7
614,251850,Ribera d'Urgellet,-3,2019,63,66
615,171450,Ribes de Freser,27,2019,100,73
616,171463,Riells i Viabrea,33,2019,396,363
617,431264,"Riera de Gaià, la",2,2019,95,93
618,251863,Riner,1,2019,9,8
619,171479,Ripoll,209,2019,558,349
620,081803,Ripollet,487,2019,2354,1867
621,259139,Riu de Cerdanya,0,2019,4,4
622,171485,Riudarenes,-24,2019,202,226
623,171498,Riudaura,3,2019,30,27
624,431270,Riudecanyes,33,2019,88,55
625,431286,Riudecols,18,2019,76,58
626,171501,Riudellots de la Selva,3,2019,154,151
627,431299,Riudoms,-31,2019,352,383
628,171518,Riumors,-17,2019,15,32
629,081810,"Roca del Vallès, la",99,2019,618,519
630,431303,Rocafort de Queralt,-13,2019,9,22
631,431310,Roda de Berà,236,2019,690,454
632,081831,Roda de Ter,212,2019,501,289
633,431325,Rodonyà,11,2019,44,33
634,431331,Roquetes,128,2019,528,400
635,171523,Roses,383,2019,1518,1135
636,251898,Rosselló,88,2019,248,160
637,431346,"Rourell, el",6,2019,21,15
638,081846,Rubí,1090,2019,4317,3227
639,081859,Rubió,1,2019,13,12
640,171539,Rupià,-6,2019,16,22
641,089019,Rupit i Pruit,-3,2019,11,14
642,081878,Sabadell,2961,2019,11450,8489
643,081884,Sagàs,-3,2019,2,5
644,251902,Salàs de Pallars,11,2019,32,21
645,081901,Saldes,6,2019,22,16
646,171544,Sales de Llierca,5,2019,11,6
647,081918,Sallent,107,2019,280,173
648,431359,Salomó,2,2019,35,33
649,439057,Salou,904,2019,3212,2308
650,171557,Salt,718,2019,2584,1866
651,251919,Sanaüja,2,2019,19,17
652,081944,Sant Adrià de Besòs,336,2019,2904,2568
653,081957,Sant Agustí de Lluçanès,5,2019,7,2
654,081960,Sant Andreu de la Barca,69,2019,1421,1352
655,081976,Sant Andreu de Llavaneres,182,2019,887,705
656,171576,Sant Andreu Salou,8,2019,11,3
657,171833,Sant Aniol de Finestres,1,2019,21,20
658,081982,Sant Antoni de Vilamajor,108,2019,473,365
659,081995,Sant Bartomeu del Grau,19,2019,72,53
660,082009,Sant Boi de Llobregat,1004,2019,4438,3434
661,082016,Sant Boi de Lluçanès,56,2019,68,12
662,431362,Sant Carles de la Ràpita,253,2019,958,705
663,082037,Sant Cebrià de Vallalta,47,2019,331,284
664,082021,Sant Celoni,234,2019,1080,846
665,082042,Sant Climent de Llobregat,24,2019,240,216
666,171582,Sant Climent Sescebes,80,2019,178,98
667,082055,Sant Cugat del Vallès,1531,2019,6388,4857
668,082068,Sant Cugat Sesgarrigues,9,2019,47,38
669,251961,Sant Esteve de la Sarga,-7,2019,3,10
670,082074,Sant Esteve de Palautordera,39,2019,193,154
671,082080,Sant Esteve Sesrovires,94,2019,511,417
672,171595,Sant Feliu de Buixalleu,22,2019,80,58
673,082107,Sant Feliu de Codines,92,2019,513,421
674,171609,Sant Feliu de Guíxols,208,2019,1394,1186
675,082114,Sant Feliu de Llobregat,599,2019,2342,1743
676,171616,Sant Feliu de Pallerols,82,2019,188,106
677,082129,Sant Feliu Sasserra,4,2019,28,24
678,171621,Sant Ferriol,0,2019,16,16
679,082093,Sant Fost de Campsentelles,185,2019,646,461
680,082135,Sant Fruitós de Bages,145,2019,557,412
681,171637,Sant Gregori,107,2019,261,154
682,251924,Sant Guim de Freixenet,19,2019,75,56
683,251977,Sant Guim de la Plana,6,2019,11,5
684,171642,Sant Hilari Sacalm,-34,2019,266,300
685,082153,Sant Hipòlit de Voltregà,72,2019,239,167
686,081939,Sant Iscle de Vallalta,18,2019,106,88
687,439023,Sant Jaume d'Enveja,26,2019,200,174
688,082166,Sant Jaume de Frontanyà,0,2019,0,0
689,171655,Sant Jaume de Llierca,14,2019,71,57
690,431378,Sant Jaume dels Domenys,6,2019,195,189
691,171674,Sant Joan de les Abadesses,36,2019,143,107
692,171680,Sant Joan de Mollet,-2,2019,29,31
693,082188,Sant Joan de Vilatorrada,90,2019,497,407
694,082172,Sant Joan Despí,177,2019,1916,1739
695,171851,Sant Joan les Fonts,55,2019,205,150
696,171668,Sant Jordi Desvalls,1,2019,53,52
697,089030,Sant Julià de Cerdanyola,5,2019,7,2
698,171693,Sant Julià de Ramis,48,2019,285,237
699,082205,Sant Julià de Vilatorta,20,2019,132,112
700,179032,Sant Julià del Llor i Bonmatí,15,2019,111,96
701,082212,Sant Just Desvern,866,2019,1878,1012
702,082227,Sant Llorenç d'Hortons,12,2019,187,175
703,171714,Sant Llorenç de la Muga,6,2019,24,18
704,251930,Sant Llorenç de Morunys,27,2019,68,41
705,082233,Sant Llorenç Savall,40,2019,154,114
706,082251,Sant Martí d'Albars,3,2019,5,2
707,082248,Sant Martí de Centelles,8,2019,86,78
708,171729,Sant Martí de Llémena,6,2019,54,48
709,259025,Sant Martí de Riucorb,1,2019,25,24
710,082264,Sant Martí de Tous,-1,2019,37,38
711,082270,Sant Martí Sarroca,10,2019,233,223
712,082286,Sant Martí Sesgueioles,3,2019,11,8
713,171735,Sant Martí Vell,0,2019,15,15
714,082299,Sant Mateu de Bages,14,2019,39,25
715,171740,Sant Miquel de Campmajor,4,2019,37,33
716,171753,Sant Miquel de Fluvià,-4,2019,65,69
717,171766,Sant Mori,-4,2019,14,18
718,171772,Sant Pau de Segúries,-1,2019,42,43
719,082310,Sant Pere de Ribes,281,2019,2339,2058
720,082325,Sant Pere de Riudebitlles,29,2019,129,100
721,082331,Sant Pere de Torelló,69,2019,167,98
722,082346,Sant Pere de Vilamajor,71,2019,336,265
723,171788,Sant Pere Pescador,38,2019,163,125
724,081897,Sant Pere Sallavinera,0,2019,5,5
725,082359,Sant Pol de Mar,136,2019,512,376
726,082362,Sant Quintí de Mediona,69,2019,210,141
727,082378,Sant Quirze de Besora,17,2019,120,103
728,082384,Sant Quirze del Vallès,85,2019,1026,941
729,082397,Sant Quirze Safaja,6,2019,59,53
730,251945,Sant Ramon,3,2019,19,16
731,082401,Sant Sadurní d'Anoia,-11,2019,518,529
732,082418,Sant Sadurní d'Osormort,-2,2019,7,9
733,080983,Sant Salvador de Guardiola,65,2019,285,220
734,082628,Sant Vicenç de Castellet,274,2019,711,437
735,082649,Sant Vicenç de Montalt,106,2019,562,456
736,082652,Sant Vicenç de Torelló,7,2019,118,111
737,082634,Sant Vicenç dels Horts,144,2019,1331,1187
738,431384,Santa Bàrbara,-1,2019,180,181
739,082439,Santa Cecília de Voltregà,-6,2019,9,15
740,082444,Santa Coloma de Cervelló,76,2019,448,372
741,171805,Santa Coloma de Farners,223,2019,753,530
742,082457,Santa Coloma de Gramenet,1436,2019,8848,7412
743,431397,Santa Coloma de Queralt,10,2019,115,105
744,171812,Santa Cristina d'Aro,74,2019,438,364
745,082460,Santa Eugènia de Berga,22,2019,123,101
746,082476,Santa Eulàlia de Riuprimer,32,2019,80,48
747,082482,Santa Eulàlia de Ronçana,135,2019,529,394
748,082495,Santa Fe del Penedès,-8,2019,14,22
749,171827,Santa Llogaia d'Àlguema,2,2019,35,33
750,082508,Santa Margarida de Montbui,241,2019,712,471
751,082515,Santa Margarida i els Monjos,71,2019,446,375
752,082589,Santa Maria d'Oló,13,2019,52,39
753,082536,Santa Maria de Besora,9,2019,21,12
754,082567,Santa Maria de Martorelles,1,2019,51,50
755,082554,Santa Maria de Merlès,-2,2019,5,7
756,082573,Santa Maria de Miralles,-2,2019,1,3
757,082592,Santa Maria de Palautordera,199,2019,721,522
758,431401,Santa Oliva,44,2019,273,229
759,171848,Santa Pau,54,2019,124,70
760,082606,Santa Perpètua de Mogoda,148,2019,1331,1183
761,082613,Santa Susanna,99,2019,415,316
762,081923,Santpedor,46,2019,317,271
763,431423,Sarral,-4,2019,65,69
764,171864,Sarrià de Ter,70,2019,392,322
765,252017,Sarroca de Bellera,-3,2019,5,8
766,252000,Sarroca de Lleida,-1,2019,14,15
767,171870,"Saus, Camallera i Llampaies",22,2019,67,45
768,431439,Savallà del Comtat,-2,2019,2,4
769,431444,"Secuita, la",17,2019,117,100
770,171886,"Selva de Mar, la",4,2019,13,9
771,431457,"Selva del Camp, la",-1,2019,232,233
772,431460,Senan,-4,2019,0,4
773,430445,"Sénia, la",-29,2019,255,284
774,252022,Senterada,5,2019,18,13
775,250352,"Sentiu de Sió, la",11,2019,34,23
776,082671,Sentmenat,126,2019,540,414
777,171903,Serinyà,4,2019,83,79
778,252043,Seròs,44,2019,134,90
779,171910,Serra de Daró,-1,2019,16,17
780,171925,Setcases,-17,2019,7,24
781,252038,"Seu d'Urgell, la",120,2019,806,686
782,082690,Seva,39,2019,242,203
783,252056,Sidamon,17,2019,33,16
784,171931,Sils,121,2019,471,350
785,082704,Sitges,977,2019,2868,1891
786,170524,Siurana,1,2019,12,11
787,082711,Sobremunt,-2,2019,2,4
788,252069,"Soleràs, el",8,2019,28,20
789,431476,Solivella,3,2019,34,31
790,252075,Solsona,108,2019,525,417
791,082726,Sora,2,2019,21,19
792,252081,Soriguera,9,2019,36,27
793,252094,Sort,-12,2019,152,164
794,252108,Soses,8,2019,103,95
795,082732,Subirats,82,2019,216,134
796,252115,Sudanell,-1,2019,39,40
797,252120,Sunyer,-10,2019,26,36
798,082747,Súria,48,2019,236,188
799,171946,Susqueda,-7,2019,8,15
800,082763,Tagamanent,-7,2019,25,32
801,082779,Talamanca,3,2019,21,18
802,252154,Talarn,11,2019,220,209
803,252167,Talavera,0,2019,10,10
804,171959,"Tallada d'Empordà, la",-10,2019,17,27
805,082785,Taradell,183,2019,424,241
806,431482,Tarragona,2652,2019,9471,6819
807,252173,Tàrrega,384,2019,1053,669
808,252189,Tarrés,-5,2019,5,10
809,252192,Tarroja de Segarra,2,2019,16,14
810,082750,Tavèrnoles,3,2019,16,13
811,082802,Tavertet,-3,2019,1,4
812,082819,Teià,50,2019,353,303
813,252206,Térmens,40,2019,101,61
814,171962,Terrades,14,2019,40,26
815,082798,Terrassa,3082,2019,11239,8157
816,082824,Tiana,111,2019,486,375
817,252213,Tírvia,5,2019,11,6
818,252228,Tiurana,5,2019,8,3
819,431495,Tivenys,1,2019,42,41
820,431508,Tivissa,37,2019,83,46
821,082830,Tona,128,2019,469,341
822,252234,Torà,6,2019,119,113
823,082845,Tordera,335,2019,1299,964
824,082858,Torelló,76,2019,674,598
825,252249,"Torms, els",-1,2019,4,5
826,252252,Tornabous,-27,2019,80,107
827,252271,"Torre de Cabdella, la",12,2019,40,28
828,082861,"Torre de Claramunt, la",19,2019,230,211
829,431515,"Torre de Fontaubella, la",-3,2019,5,8
830,431520,"Torre de l'Espanyol, la",0,2019,30,30
831,252265,Torrebesses,-7,2019,8,15
832,431536,Torredembarra,424,2019,1492,1068
833,252287,Torrefarrera,77,2019,282,205
834,259078,Torrefeta i Florejacs,7,2019,36,29
835,252304,Torregrossa,3,2019,82,79
836,252311,Torrelameu,14,2019,60,46
837,082877,Torrelavit,-5,2019,71,76
838,082883,Torrelles de Foix,39,2019,215,176
839,082896,Torrelles de Llobregat,59,2019,367,308
840,171978,Torrent,-5,2019,9,14
841,252326,Torres de Segre,132,2019,346,214
842,252332,Torre-serona,5,2019,33,28
843,171984,Torroella de Fluvià,12,2019,74,62
844,171997,Torroella de Montgrí,190,2019,812,622
845,431541,Torroja del Priorat,4,2019,8,4
846,172001,Tortellà,11,2019,56,45
847,431554,Tortosa,414,2019,1986,1572
848,172018,Toses,-3,2019,12,15
849,172023,Tossa de Mar,161,2019,394,233
850,252347,Tremp,121,2019,464,343
851,172044,Ullà,30,2019,110,80
852,082900,Ullastrell,-3,2019,127,130
853,172057,Ullastret,-15,2019,17,32
854,431567,Ulldecona,251,2019,714,463
855,431573,Ulldemolins,5,2019,11,6
856,172039,Ultramort,3,2019,20,17
857,172060,Urús,7,2019,17,10
858,082917,Vacarisses,152,2019,556,404
859,170144,"Vajol, la",-1,2019,7,8
860,172076,"Vall d'en Bas, la",26,2019,136,110
861,172082,"Vall de Bianya, la",14,2019,80,66
862,250432,"Vall de Boí, la",11,2019,67,56
863,259010,Vall de Cardós,-2,2019,22,24
864,082922,Vallbona d'Anoia,-11,2019,69,80
865,252385,Vallbona de les Monges,14,2019,16,2
866,082938,Vallcebre,1,2019,6,5
867,431589,Vallclara,-8,2019,1,9
868,252402,Vallfogona de Balaguer,37,2019,141,104
869,171707,Vallfogona de Ripollès,-12,2019,8,20
870,431592,Vallfogona de Riucorb,-5,2019,1,6
871,082943,Vallgorguina,105,2019,270,165
872,082956,Vallirana,325,2019,1001,676
873,172095,Vall-llobrega,-12,2019,51,63
874,431606,Vallmoll,23,2019,120,97
875,082969,Vallromanes,-15,2019,133,148
876,431613,Valls,290,2019,1210,920
877,259062,"Valls d'Aguilar, les",-8,2019,5,13
878,252398,"Valls de Valira, les",-190,2019,93,283
879,431628,Vandellòs i l'Hospitalet de l'Infant,116,2019,482,366
880,259097,"Vansa i Fórnols, la",-4,2019,3,7
881,082975,Veciana,-7,2019,10,17
882,431634,"Vendrell, el",809,2019,2925,2116
883,172109,Ventalló,-1,2019,58,59
884,252424,Verdú,5,2019,54,49
885,172116,Verges,6,2019,69,63
886,431649,Vespella de Gaià,10,2019,44,34
887,082981,Vic,1323,2019,3991,2668
888,172121,Vidrà,5,2019,14,9
889,172137,Vidreres,233,2019,690,457
890,252430,Vielha e Mijaran,32,2019,474,442
891,431652,Vilabella,2,2019,27,25
892,172142,Vilabertran,14,2019,58,44
893,172155,Vilablareix,155,2019,263,108
894,082994,Vilada,8,2019,27,19
895,172174,Viladamat,-9,2019,14,23
896,172168,Viladasens,7,2019,19,12
897,083015,Viladecans,588,2019,3366,2778
898,083008,Viladecavalls,21,2019,386,365
899,172180,Vilademuls,24,2019,86,62
900,172207,Viladrau,4,2019,63,59
901,172214,Vilafant,32,2019,361,329
902,083054,Vilafranca del Penedès,545,2019,2214,1669
903,252445,Vilagrassa,23,2019,52,29
904,172235,Vilajuïga,22,2019,98,76
905,431750,Vilalba dels Arcs,7,2019,13,6
906,083067,Vilalba Sasserra,47,2019,102,55
907,252458,Vilaller,-7,2019,31,38
908,172240,Vilallonga de Ter,0,2019,24,24
909,431665,Vilallonga del Camp,2,2019,154,152
910,172253,Vilamacolum,33,2019,65,32
911,172266,Vilamalla,-12,2019,69,81
912,172272,Vilamaniscle,-6,2019,22,28
913,252477,Vilamòs,-8,2019,16,24
914,172288,Vilanant,-7,2019,22,29
915,431671,Vilanova d'Escornalbou,23,2019,43,20
916,252483,Vilanova de Bellpuig,36,2019,64,28
917,252496,Vilanova de l'Aguda,1,2019,4,3
918,252542,Vilanova de la Barca,72,2019,137,65
919,252509,Vilanova de Meià,29,2019,52,23
920,431687,Vilanova de Prades,0,2019,15,15
921,083036,Vilanova de Sau,11,2019,18,7
922,252516,Vilanova de Segrià,13,2019,63,50
923,083020,Vilanova del Camí,104,2019,654,550
924,089024,Vilanova del Vallès,54,2019,346,292
925,083073,Vilanova i la Geltrú,812,2019,3754,2942
926,431690,Vilaplana,-5,2019,13,18
927,431704,Vila-rodona,33,2019,115,82
928,172305,Vila-sacra,-3,2019,57,60
929,252521,Vila-sana,-20,2019,35,55
930,431711,Vila-seca,365,2019,1636,1271
931,082140,Vilassar de Dalt,27,2019,523,496
932,082191,Vilassar de Mar,239,2019,1192,953
933,172229,Vilaür,-1,2019,5,6
934,431726,Vilaverd,-4,2019,25,29
935,431732,"Vilella Alta, la",0,2019,5,5
936,431747,"Vilella Baixa, la",5,2019,13,8
937,172333,Vilobí d'Onyar,47,2019,217,170
938,083041,Vilobí del Penedès,-9,2019,59,68
939,172327,Vilopriu,6,2019,18,12
940,252537,"Vilosell, el",1,2019,10,9
941,431763,Vimbodí i Poblet,7,2019,34,27
942,252555,Vinaixa,-12,2019,16,28
943,431779,Vinebre,2,2019,27,25
944,431785,Vinyols i els Arcs,76,2019,255,179
945,083089,Viver i Serrateix,4,2019,13,9
946,430521,Xerta,-13,2019,56,69
0,250019,Abella de la Conca,-9,2020,8,17
1,080018,Abrera,71,2020,557,486
2,250024,Àger,19,2020,40,21
3,250030,Agramunt,64,2020,246,182
4,080023,Aguilar de Segarra,3,2020,13,10
5,170010,Agullana,35,2020,73,38
6,080142,Aiguafreda,72,2020,210,138
7,430017,Aiguamúrcia,35,2020,69,34
8,170025,Aiguaviva,22,2020,53,31
9,250387,Aitona,-24,2020,134,158
10,250045,"Alamús, els",-14,2020,51,65
11,250058,Alàs i Cerc,7,2020,19,12
12,250061,"Albagés, l'",2,2020,6,4
13,170031,Albanyà,20,2020,22,2
14,250077,Albatàrrec,-33,2020,132,165
15,250083,Albesa,30,2020,69,39
16,250096,"Albi, l'",8,2020,20,12
17,430022,Albinyana,58,2020,174,116
18,430038,"Albiol, l'",18,2020,44,26
19,170046,Albons,44,2020,77,33
20,430043,Alcanar,166,2020,587,421
21,250100,Alcanó,0,2020,3,3
22,250117,Alcarràs,115,2020,567,452
23,250122,Alcoletge,48,2020,238,190
24,430056,Alcover,57,2020,219,162
25,439044,"Aldea, l'",33,2020,193,160
26,430069,Aldover,14,2020,45,31
27,430075,"Aleixar, l'",19,2020,49,30
28,080039,Alella,195,2020,712,517
29,430081,Alfara de Carles,2,2020,23,21
30,250138,Alfarràs,4,2020,112,108
31,250143,Alfés,6,2020,16,10
32,430094,Alforja,77,2020,147,70
33,250156,Algerri,25,2020,34,9
34,250169,Alguaire,44,2020,165,121
35,250175,Alins,9,2020,16,7
36,430108,Alió,19,2020,31,12
37,250194,Almacelles,176,2020,412,236
38,250208,Almatret,8,2020,19,11
39,250215,Almenar,13,2020,153,140
40,430115,Almoster,-15,2020,53,68
41,250220,Alòs de Balaguer,-7,2020,6,13
42,170062,Alp,37,2020,150,113
43,080044,Alpens,10,2020,21,11
44,250236,Alpicat,40,2020,249,209
45,250241,Alt Àneu,18,2020,28,10
46,430120,Altafulla,204,2020,500,296
47,170078,Amer,67,2020,147,80
48,430136,"Ametlla de Mar, l'",266,2020,549,283
49,080057,"Ametlla del Vallès, l'",181,2020,621,440
50,439060,"Ampolla, l'",220,2020,387,167
51,430141,Amposta,180,2020,884,704
52,170084,Anglès,42,2020,393,351
53,250273,Anglesola,17,2020,68,51
54,250292,Arbeca,49,2020,106,57
55,430167,"Arboç, l'",25,2020,317,292
56,430154,Arbolí,2,2020,5,3
57,170097,Arbúcies,-31,2020,246,277
58,080060,Arenys de Mar,221,2020,961,740
59,080076,Arenys de Munt,106,2020,499,393
60,170101,Argelaguer,22,2020,36,14
61,080082,Argençola,4,2020,19,15
62,430173,"Argentera, l'",9,2020,14,5
63,080095,Argentona,141,2020,637,496
64,170118,"Armentera, l'",45,2020,81,36
65,430189,Arnes,6,2020,15,9
66,250313,Arres,9,2020,10,1
67,250328,Arsèguel,5,2020,14,9
68,080109,Artés,42,2020,242,200
69,250334,Artesa de Lleida,-9,2020,61,70
70,250349,Artesa de Segre,94,2020,186,92
71,430192,Ascó,-2,2020,41,43
72,250365,Aspa,-10,2020,8,18
73,250371,"Avellanes i Santa Linya, les",23,2020,34,11
74,080116,Avià,10,2020,113,103
75,080121,Avinyó,32,2020,122,90
76,170123,Avinyonet de Puigventós,17,2020,79,62
77,080137,Avinyonet del Penedès,17,2020,106,89
78,080155,Badalona,597,2020,10015,9418
79,089045,Badia del Vallès,-107,2020,495,602
80,080168,Bagà,38,2020,107,69
81,250390,Baix Pallars,14,2020,27,13
82,250404,Balaguer,-11,2020,811,822
83,080174,Balenyà,87,2020,250,163
84,080180,Balsareny,63,2020,135,72
85,430206,Banyeres del Penedès,77,2020,250,173
86,170157,Banyoles,222,2020,880,658
87,250411,Barbens,36,2020,96,60
88,430213,Barberà de la Conca,12,2020,40,28
89,082520,Barberà del Vallès,-149,2020,1233,1382
90,080193,Barcelona,204,2020,81833,81629
91,250426,"Baronia de Rialb, la",2,2020,9,7
92,170160,Bàscara,17,2020,61,44
93,250447,Bassella,8,2020,17,9
94,430228,Batea,14,2020,40,26
95,250450,Bausen,8,2020,9,1
96,080207,Begues,71,2020,421,350
97,170139,Begur,169,2020,356,187
98,250463,Belianes,7,2020,17,10
99,251706,Bellaguarda,10,2020,19,9
100,170182,Bellcaire d'Empordà,30,2020,73,43
101,250479,Bellcaire d'Urgell,25,2020,75,50
102,250485,Bell-lloc d'Urgell,12,2020,74,62
103,250498,Bellmunt d'Urgell,0,2020,6,6
104,430234,Bellmunt del Priorat,6,2020,17,11
105,080214,Bellprat,10,2020,17,7
106,250501,Bellpuig,46,2020,240,194
107,430249,Bellvei,76,2020,228,152
108,250518,Bellver de Cerdanya,136,2020,232,96
109,250523,Bellvís,17,2020,110,93
110,250539,Benavent de Segrià,21,2020,73,52
111,430252,Benifallet,19,2020,38,19
112,430265,Benissanet,9,2020,59,50
113,080229,Berga,158,2020,818,660
114,170195,Besalú,29,2020,132,103
115,170209,Bescanó,100,2020,252,152
116,170216,Beuda,7,2020,17,10
117,080235,Bigues i Riells del Fai,198,2020,611,413
118,250557,Biosca,4,2020,11,7
119,170221,"Bisbal d'Empordà, la",71,2020,546,475
120,430271,"Bisbal de Falset, la",10,2020,14,4
121,430287,"Bisbal del Penedès, la",230,2020,417,187
122,172348,Biure,10,2020,22,12
123,430290,Blancafort,18,2020,25,7
124,170237,Blanes,495,2020,2293,1798
125,170293,Boadella i les Escaules,-1,2020,11,12
126,170242,Bolvir,112,2020,124,12
127,430304,Bonastre,46,2020,105,59
128,250576,"Bòrdes, Es",28,2020,40,12
129,170255,Bordils,33,2020,120,87
130,250582,"Borges Blanques, les",70,2020,312,242
131,430311,"Borges del Camp, les",57,2020,138,81
132,170268,Borrassà,-3,2020,46,49
133,080240,Borredà,-2,2020,23,25
134,250595,Bossòst,21,2020,85,64
135,430326,Bot,18,2020,36,18
136,430332,Botarell,23,2020,63,40
137,250560,Bovera,20,2020,26,6
138,430347,Bràfim,18,2020,41,23
139,170274,Breda,84,2020,225,141
140,080253,"Bruc, el",68,2020,176,108
141,080266,"Brull, el",19,2020,23,4
142,170280,Brunyola i Sant Martí Sapresa,9,2020,38,29
143,430350,Cabacés,15,2020,20,5
144,250609,Cabanabona,-5,2020,2,7
145,170314,Cabanelles,3,2020,20,17
146,170307,Cabanes,-13,2020,54,67
147,080272,"Cabanyes, les",25,2020,58,33
148,250616,Cabó,5,2020,6,1
149,430363,Cabra del Camp,65,2020,124,59
150,080288,Cabrera d'Anoia,35,2020,138,103
151,080291,Cabrera de Mar,62,2020,315,253
152,080305,Cabrils,145,2020,553,408
153,170329,Cadaqués,136,2020,218,82
154,080312,Calaf,-28,2020,142,170
155,430379,Calafell,1029,2020,3023,1994
156,080348,Calders,23,2020,63,40
157,080327,Caldes d'Estrac,138,2020,384,246
158,170335,Caldes de Malavella,206,2020,603,397
159,080333,Caldes de Montbui,140,2020,789,649
160,080351,Calella,241,2020,1337,1096
161,080370,Calldetenes,8,2020,100,92
162,080386,Callús,-14,2020,102,116
163,080364,Calonge de Segarra,7,2020,10,3
164,170340,Calonge i Sant Antoni,332,2020,939,607
165,250621,Camarasa,12,2020,46,34
166,439039,Camarles,70,2020,161,91
167,430385,Cambrils,573,2020,2098,1525
168,170353,Camós,43,2020,51,8
169,170366,Campdevànol,44,2020,120,76
170,170372,Campelles,8,2020,22,14
171,080399,Campins,-5,2020,48,53
172,170388,Campllong,-5,2020,24,29
173,170391,Camprodon,165,2020,256,91
174,250637,Canejan,0,2020,9,9
175,170405,Canet d'Adri,24,2020,47,23
176,080403,Canet de Mar,182,2020,796,614
177,439076,"Canonja, la",3,2020,245,242
178,080410,Canovelles,163,2020,1050,887
179,080425,Cànoves i Samalús,56,2020,220,164
180,170412,Cantallops,2,2020,16,14
181,080431,Canyelles,205,2020,451,246
182,430398,Capafonts,15,2020,17,2
183,430402,Capçanes,5,2020,14,9
184,080446,Capellades,16,2020,274,258
185,170427,Capmany,11,2020,57,46
186,080459,Capolat,1,2020,6,5
187,080462,Cardedeu,275,2020,952,677
188,080478,Cardona,40,2020,170,130
189,080484,Carme,-13,2020,38,51
190,430419,Caseres,-4,2020,8,12
191,170448,Cassà de la Selva,167,2020,486,319
192,080497,Casserres,59,2020,122,63
193,080575,Castell de l'Areny,5,2020,6,1
194,259046,Castell de Mur,-3,2020,7,10
195,250642,Castellar de la Ribera,7,2020,10,3
196,080522,Castellar de n'Hug,13,2020,15,2
197,080500,Castellar del Riu,-1,2020,6,7
198,080517,Castellar del Vallès,260,2020,1035,775
199,080538,Castellbell i el Vilar,162,2020,304,142
200,080543,Castellbisbal,76,2020,524,448
201,080556,Castellcir,17,2020,75,58
202,250674,Castelldans,-17,2020,39,56
203,080569,Castelldefels,-134,2020,3849,3983
204,080581,Castellet i la Gornal,66,2020,252,186
205,170464,Castellfollit de la Roca,4,2020,49,45
206,080608,Castellfollit de Riubregós,5,2020,7,2
207,080594,Castellfollit del Boix,3,2020,20,17
208,080615,Castellgalí,79,2020,185,106
209,080620,Castellnou de Bages,22,2020,89,67
210,250680,Castellnou de Seana,34,2020,56,22
211,170470,Castelló d'Empúries,65,2020,1053,988
212,250693,Castelló de Farfanya,3,2020,28,25
213,080636,Castellolí,23,2020,51,28
214,170486,Castell-Platja d'Aro,488,2020,1262,774
215,250707,Castellserà,-1,2020,23,24
216,080641,Castellterçol,115,2020,226,111
217,430424,Castellvell del Camp,48,2020,160,112
218,080654,Castellví de la Marca,28,2020,84,56
219,080667,Castellví de Rosanes,71,2020,151,80
220,430430,"Catllar, el",188,2020,405,217
221,250714,Cava,1,2020,6,5
222,171899,"Cellera de Ter, la",25,2020,91,66
223,170499,Celrà,11,2020,307,296
224,080673,Centelles,123,2020,392,269
225,082687,Cercs,51,2020,95,44
226,082665,Cerdanyola del Vallès,-184,2020,2526,2710
227,080689,Cervelló,209,2020,602,393
228,250729,Cervera,103,2020,367,264
229,250735,Cervià de les Garrigues,12,2020,41,29
230,170502,Cervià de Ter,7,2020,49,42
231,170519,Cistella,1,2020,16,15
232,250740,Ciutadilla,1,2020,9,8
233,250753,Clariana de Cardener,-5,2020,9,14
234,250766,"Cogul, el",-2,2020,6,8
235,170545,Colera,24,2020,54,30
236,250772,Coll de Nargó,16,2020,37,21
237,080692,Collbató,115,2020,299,184
238,430458,Colldejou,2,2020,9,7
239,080706,Collsuspina,22,2020,30,8
240,170558,Colomers,12,2020,25,13
241,251636,"Coma i la Pedra, la",24,2020,36,12
242,251615,Conca de Dalt,20,2020,30,10
243,430461,Conesa,6,2020,10,4
244,430477,Constantí,48,2020,375,327
245,080713,Copons,1,2020,17,16
246,430483,Corbera d'Ebre,-2,2020,33,35
247,080728,Corbera de Llobregat,207,2020,877,670
248,250788,Corbins,39,2020,81,42
249,170577,Corçà,17,2020,75,58
250,080734,Cornellà de Llobregat,211,2020,4231,4020
251,170561,Cornellà del Terri,32,2020,150,118
252,430496,Cornudella de Montsant,40,2020,74,34
253,430509,Creixell,164,2020,430,266
254,170583,Crespià,16,2020,36,20
255,179011,"Cruïlles, Monells i Sant Sadurní de l'Heura",64,2020,127,63
256,080749,Cubelles,359,2020,1192,833
257,250791,Cubells,29,2020,37,8
258,430516,Cunit,620,2020,1566,946
259,170600,Darnius,13,2020,41,28
260,170617,Das,9,2020,21,12
261,439018,Deltebre,26,2020,462,436
262,080752,Dosrius,96,2020,409,313
263,430537,Duesaigües,-10,2020,17,27
264,170622,"Escala, l'",363,2020,744,381
265,080765,Esparreguera,102,2020,1001,899
266,170638,Espinelves,18,2020,30,12
267,250812,"Espluga Calba, l'",8,2020,20,12
268,430542,"Espluga de Francolí, l'",22,2020,148,126
269,080771,Esplugues de Llobregat,-65,2020,2628,2693
270,170643,Espolla,5,2020,15,10
271,170656,Esponellà,14,2020,25,11
272,250827,Espot,7,2020,19,12
273,080787,"Espunyola, l'",16,2020,17,1
274,082541,"Esquirol, l'",32,2020,108,76
275,250886,Estamariu,4,2020,7,3
276,080790,"Estany, l'",14,2020,36,22
277,250851,Estaràs,19,2020,23,4
278,250864,Esterri d'Àneu,29,2020,69,40
279,250870,Esterri de Cardós,0,2020,5,5
280,430555,Falset,28,2020,119,91
281,170059,"Far d'Empordà, el",15,2020,31,16
282,250899,Farrera,9,2020,12,3
283,430568,"Fatarella, la",0,2020,11,11
284,430574,"Febró, la",2,2020,4,2
285,081347,Figaró-Montmany,4,2020,95,91
286,080804,Fígols,3,2020,5,2
287,259084,Fígols i Alinyà,15,2020,27,12
288,430580,"Figuera, la",4,2020,8,4
289,170669,Figueres,-246,2020,2310,2556
290,430593,Figuerola del Camp,12,2020,25,13
291,170675,Flaçà,33,2020,87,54
292,430607,Flix,92,2020,193,101
293,250925,"Floresta, la",9,2020,12,3
294,080826,Fogars de la Selva,74,2020,146,72
295,080811,Fogars de Montclús,-1,2020,25,26
296,170681,Foixà,-1,2020,20,21
297,080832,Folgueroles,19,2020,80,61
298,250931,Fondarella,17,2020,54,37
299,080847,Fonollosa,37,2020,89,52
300,170694,Fontanals de Cerdanya,72,2020,101,29
301,170708,Fontanilles,13,2020,16,3
302,170715,Fontcoberta,2,2020,61,59
303,080850,Font-rubí,33,2020,114,81
304,250946,Foradada,-1,2020,19,20
305,179026,Forallac,27,2020,133,106
306,430614,Forès,6,2020,7,1
307,170736,Fornells de la Selva,37,2020,133,96
308,170741,Fortià,-1,2020,65,66
309,080863,"Franqueses del Vallès, les",62,2020,1110,1048
310,430629,Freginals,4,2020,31,27
311,250962,"Fuliola, la",11,2020,63,52
312,250978,Fulleda,-1,2020,3,4
313,080902,Gaià,8,2020,20,12
314,430635,"Galera, la",3,2020,40,37
315,080879,Gallifa,17,2020,25,8
316,430640,Gandesa,45,2020,154,109
317,430653,Garcia,7,2020,35,28
318,430666,"Garidells, els",11,2020,19,8
319,080885,"Garriga, la",144,2020,874,730
320,170754,Garrigàs,16,2020,36,20
321,170767,Garrigoles,2,2020,15,13
322,170773,Garriguella,71,2020,107,36
323,080898,Gavà,37,2020,2221,2184
324,250984,Gavet de la Conca,9,2020,22,13
325,080919,Gelida,67,2020,457,390
326,170789,Ger,54,2020,70,16
327,259123,Gimenells i el Pla de la Font,23,2020,64,41
328,430672,Ginestar,32,2020,52,20
329,170792,Girona,-990,2020,5247,6237
330,080924,Gironella,19,2020,212,193
331,080930,Gisclareny,1,2020,2,1
332,430688,Godall,-1,2020,38,39
333,250997,Golmés,3,2020,80,77
334,170806,Gombrèn,7,2020,12,5
335,251001,Gósol,28,2020,36,8
336,080945,"Granada, la",6,2020,93,87
337,251018,"Granadella, la",9,2020,30,21
338,080958,Granera,8,2020,12,4
339,251023,"Granja d'Escarp, la",10,2020,64,54
340,080961,Granollers,290,2020,3476,3186
341,251039,Granyanella,4,2020,8,4
342,251057,Granyena de les Garrigues,22,2020,24,2
343,251044,Granyena de Segarra,11,2020,16,5
344,430691,Gratallops,5,2020,12,7
345,080977,Gualba,45,2020,136,91
346,170813,Gualta,28,2020,51,23
347,080996,Guardiola de Berguedà,-3,2020,57,60
348,430705,"Guiamets, els",10,2020,27,17
349,170828,Guils de Cerdanya,47,2020,72,25
350,251095,Guimerà,3,2020,17,14
351,259031,"Guingueta d'Àneu, la",12,2020,27,15
352,251109,Guissona,15,2020,337,322
353,251116,Guixers,-5,2020,1,6
354,081000,Gurb,-4,2020,87,91
355,430712,Horta de Sant Joan,12,2020,42,30
356,081017,"Hospitalet de Llobregat, l'",895,2020,15824,14929
357,081629,"Hostalets de Pierola, els",121,2020,258,137
358,170834,Hostalric,39,2020,244,205
359,081022,Igualada,462,2020,2173,1711
360,251155,Isona i Conca Dellà,28,2020,78,50
361,170849,Isòvol,36,2020,56,20
362,251137,Ivars d'Urgell,28,2020,87,59
363,251121,Ivars de Noguera,5,2020,12,7
364,251142,Ivorra,4,2020,6,2
365,170852,Jafre,1,2020,12,11
366,170865,"Jonquera, la",28,2020,258,230
367,081038,Jorba,-1,2020,62,63
368,259101,Josa i Tuixén,0,2020,7,7
369,170871,Juià,-6,2020,34,40
370,251180,Juncosa,9,2020,15,6
371,251193,Juneda,5,2020,164,159
372,251214,Les,25,2020,80,55
373,251229,Linyola,42,2020,104,62
374,081043,"Llacuna, la",28,2020,70,42
375,170887,Lladó,5,2020,42,37
376,251235,Lladorre,8,2020,18,10
377,251240,Lladurs,9,2020,9,0
378,081056,"Llagosta, la",-231,2020,499,730
379,170890,Llagostera,215,2020,548,333
380,170904,Llambilles,16,2020,37,21
381,170911,Llanars,0,2020,39,39
382,170926,Llançà,123,2020,337,214
383,251253,Llardecans,-5,2020,12,17
384,251266,Llavorsí,6,2020,33,27
385,251207,Lleida,-383,2020,5325,5708
386,170932,Llers,5,2020,86,81
387,251272,Lles de Cerdanya,22,2020,39,17
388,081075,Lliçà d'Amunt,248,2020,900,652
389,081081,Lliçà de Vall,78,2020,347,269
390,251288,Llimiana,6,2020,13,7
391,081069,Llinars del Vallès,127,2020,640,513
392,170947,Llívia,86,2020,190,104
393,430727,"Lloar, el",9,2020,11,2
394,251291,Llobera,0,2020,4,4
395,430733,Llorac,2,2020,5,3
396,430748,Llorenç del Penedès,10,2020,114,104
397,170950,Lloret de Mar,-917,2020,2376,3293
398,170963,"Llosses, les",-2,2020,17,19
399,081094,Lluçà,-3,2020,10,13
400,171024,Maçanet de Cabrenys,36,2020,57,21
401,171030,Maçanet de la Selva,312,2020,676,364
402,170979,Madremanya,8,2020,24,16
403,170985,Maià de Montcal,18,2020,53,35
404,251333,Maials,27,2020,42,15
405,251305,Maldà,12,2020,17,5
406,081108,Malgrat de Mar,357,2020,1126,769
407,081115,Malla,2,2020,4,2
408,081120,Manlleu,76,2020,859,783
409,081136,Manresa,476,2020,3884,3408
410,430764,Marçà,21,2020,59,38
411,430751,Margalef,-1,2020,6,7
412,082423,Marganell,6,2020,21,15
413,081141,Martorell,80,2020,1500,1420
414,081154,Martorelles,40,2020,256,216
415,430770,Mas de Barberans,18,2020,36,18
416,171002,Masarac,3,2020,17,14
417,430786,Masdenverge,44,2020,103,59
418,081167,"Masies de Roda, les",-11,2020,33,44
419,081173,"Masies de Voltregà, les",55,2020,155,100
420,430799,Masllorenç,7,2020,38,31
421,081189,"Masnou, el",128,2020,1319,1191
422,430803,"Masó, la",4,2020,10,6
423,430810,Maspujols,10,2020,41,31
424,081192,Masquefa,235,2020,630,395
425,430825,"Masroig, el",20,2020,43,23
426,251312,Massalcoreig,13,2020,37,24
427,171019,Massanes,10,2020,61,51
428,251327,Massoteres,10,2020,22,12
429,081206,Matadepera,166,2020,510,344
430,081213,Mataró,-354,2020,5104,5458
431,081228,Mediona,85,2020,247,162
432,251348,Menàrguens,-16,2020,24,40
433,170998,Meranges,-2,2020,3,5
434,171058,Mieres,4,2020,24,20
435,430831,"Milà, el",-1,2020,6,7
436,251351,Miralcamp,-3,2020,35,38
437,430846,Miravet,-13,2020,21,34
438,081385,Moià,133,2020,407,274
439,430859,"Molar, el",4,2020,19,15
440,081234,Molins de Rei,245,2020,1165,920
441,251370,Mollerussa,119,2020,742,623
442,171061,Mollet de Peralada,2,2020,17,15
443,081249,Mollet del Vallès,-106,2020,2065,2171
444,171077,Molló,13,2020,25,12
445,251364,"Molsosa, la",0,2020,0,0
446,081287,Monistrol de Calders,21,2020,39,18
447,081271,Monistrol de Montserrat,51,2020,250,199
448,171096,Montagut i Oix,25,2020,57,32
449,430862,Montblanc,87,2020,294,207
450,430884,Montbrió del Camp,64,2020,215,151
451,081252,Montcada i Reixac,13,2020,1784,1771
452,081304,Montclar,-1,2020,0,1
453,251399,Montellà i Martinet,20,2020,66,46
454,081311,Montesquiu,27,2020,81,54
455,251403,Montferrer i Castellbò,49,2020,145,96
456,430897,Montferri,-5,2020,33,38
457,251386,Montgai,21,2020,33,12
458,081265,Montgat,120,2020,779,659
459,081326,Montmajor,10,2020,36,26
460,081332,Montmaneu,11,2020,14,3
461,430901,"Montmell, el",156,2020,262,106
462,081350,Montmeló,-9,2020,315,324
463,251425,Montoliu de Lleida,8,2020,24,16
464,251410,Montoliu de Segarra,9,2020,25,16
465,251431,Montornès de Segarra,-2,2020,2,4
466,081363,Montornès del Vallès,150,2020,727,577
467,430918,Mont-ral,2,2020,15,13
468,171100,Mont-ras,0,2020,101,101
469,430923,Mont-roig del Camp,139,2020,1260,1121
470,081379,Montseny,13,2020,39,26
471,430939,Móra d'Ebre,-40,2020,272,312
472,430944,Móra la Nova,34,2020,159,125
473,430957,"Morell, el",-1,2020,228,229
474,430960,"Morera de Montsant, la",7,2020,17,10
475,081290,Muntanyola,22,2020,63,41
476,081398,Mura,13,2020,20,7
477,251459,Nalec,2,2020,7,5
478,250254,Naut Aran,105,2020,179,74
479,081402,Navarcles,69,2020,264,195
480,081419,Navàs,-6,2020,205,211
481,171117,Navata,15,2020,99,84
482,251462,Navès,12,2020,28,16
483,081424,"Nou de Berguedà, la",14,2020,22,8
484,430976,"Nou de Gaià, la",15,2020,33,18
485,430982,Nulles,11,2020,34,23
486,251484,Odèn,1,2020,6,5
487,081430,Òdena,26,2020,219,193
488,171122,Ogassa,-1,2020,11,12
489,081458,Olèrdola,93,2020,283,190
490,081461,Olesa de Bonesvalls,85,2020,170,85
491,081477,Olesa de Montserrat,147,2020,971,824
492,251497,Oliana,38,2020,111,73
493,251500,Oliola,-2,2020,5,7
494,251517,Olius,-17,2020,45,62
495,081483,Olivella,180,2020,436,256
496,081496,Olost,-1,2020,42,43
497,171143,Olot,776,2020,1756,980
498,251522,"Oluges, les",1,2020,7,6
499,081445,Olvan,23,2020,61,38
500,251538,"Omellons, els",-3,2020,6,9
501,251543,"Omells de na Gaia, els",0,2020,2,2
502,171156,Ordis,12,2020,20,8
503,251556,Organyà,5,2020,37,32
504,081509,Orís,16,2020,26,10
505,081516,Oristà,-1,2020,24,25
506,081521,Orpí,4,2020,9,5
507,081537,Òrrius,20,2020,54,34
508,251569,Os de Balaguer,34,2020,68,34
509,171169,Osor,5,2020,38,33
510,251575,Ossó de Sió,-2,2020,2,4
511,081542,Pacs del Penedès,0,2020,52,52
512,081555,Palafolls,45,2020,461,416
513,171175,Palafrugell,137,2020,1137,1000
514,171181,Palamós,219,2020,1086,867
515,251581,"Palau d'Anglesola, el",44,2020,114,70
516,171194,Palau de Santa Eulàlia,21,2020,21,0
517,171215,Palau-sator,18,2020,33,15
518,171208,Palau-saverdera,50,2020,131,81
519,081568,Palau-solità i Plegamans,144,2020,749,605
520,431009,"Pallaresos, els",95,2020,272,177
521,081574,Pallejà,83,2020,544,461
522,430995,"Palma d'Ebre, la",1,2020,17,16
523,089058,"Palma de Cervelló, la",31,2020,196,165
524,171236,Palol de Revardit,1,2020,22,21
525,171241,Pals,122,2020,232,110
526,081580,"Papiol, el",59,2020,214,155
527,171254,Pardines,-3,2020,4,7
528,081593,Parets del Vallès,-94,2020,806,900
529,171267,Parlavà,24,2020,38,14
530,431016,Passanant i Belltall,8,2020,15,7
531,171289,Pau,23,2020,47,24
532,431021,Paüls,19,2020,26,7
533,171292,Pedret i Marzà,-4,2020,7,11
534,251641,Penelles,5,2020,22,17
535,171306,"Pera, la",19,2020,37,18
536,081607,Perafita,8,2020,23,15
537,431037,Perafort,24,2020,88,64
538,171328,Peralada,57,2020,135,78
539,251654,Peramola,15,2020,34,19
540,431042,"Perelló, el",75,2020,179,104
541,081614,Piera,366,2020,1120,754
542,431055,"Piles, les",8,2020,15,7
543,081635,Pineda de Mar,422,2020,1760,1338
544,431068,"Pinell de Brai, el",7,2020,33,26
545,251667,Pinell de Solsonès,-5,2020,1,6
546,251673,Pinós,9,2020,15,6
547,431074,Pira,1,2020,20,19
548,431080,"Pla de Santa Maria, el",-7,2020,148,155
549,081640,"Pla del Penedès, el",23,2020,107,84
550,171334,"Planes d'Hostoles, les",13,2020,100,87
551,171349,Planoles,2,2020,25,23
552,259118,"Plans de Sió, els",16,2020,33,17
553,251689,"Poal, el",2,2020,30,28
554,251692,"Pobla de Cérvoles, la",13,2020,29,16
555,081653,"Pobla de Claramunt, la",33,2020,131,98
556,081666,"Pobla de Lillet, la",3,2020,41,38
557,431093,"Pobla de Mafumet, la",48,2020,263,215
558,431107,"Pobla de Massaluca, la",27,2020,33,6
559,431114,"Pobla de Montornès, la",127,2020,301,174
560,251713,"Pobla de Segur, la",72,2020,230,158
561,431129,Poboleda,11,2020,31,20
562,081672,Polinyà,-3,2020,363,366
563,431135,"Pont d'Armentera, el",9,2020,34,25
564,250306,"Pont de Bar, el",24,2020,29,5
565,171352,Pont de Molins,16,2020,37,21
566,251734,"Pont de Suert, el",90,2020,167,77
567,081825,"Pont de Vilomara i Rocafort, el",116,2020,229,113
568,431418,Pontils,17,2020,26,9
569,081688,Pontons,0,2020,57,57
570,171365,Pontós,-1,2020,19,20
571,251728,Ponts,14,2020,145,131
572,171371,Porqueres,48,2020,238,190
573,431140,Porrera,4,2020,22,18
574,171404,"Port de la Selva, el",54,2020,119,65
575,171387,Portbou,44,2020,99,55
576,251749,"Portella, la",18,2020,49,31
577,431153,Pradell de la Teixeta,8,2020,9,1
578,431166,Prades,26,2020,68,42
579,431172,Prat de Comte,7,2020,11,4
580,081691,"Prat de Llobregat, el",346,2020,2546,2200
581,431188,Pratdip,0,2020,61,61
582,081712,Prats de Lluçanès,49,2020,139,90
583,081705,"Prats de Rei, els",11,2020,26,15
584,251752,Prats i Sansor,33,2020,44,11
585,251765,Preixana,3,2020,25,22
586,251771,Preixens,8,2020,33,25
587,082303,Premià de Dalt,10,2020,553,543
588,081727,Premià de Mar,202,2020,1435,1233
589,171390,"Preses, les",18,2020,91,73
590,251790,Prullans,21,2020,35,14
591,171411,Puigcerdà,135,2020,605,470
592,081748,Puigdàlber,23,2020,44,21
593,251804,Puiggròs,-10,2020,4,14
594,431191,Puigpelat,27,2020,73,46
595,081751,Puig-reig,68,2020,263,195
596,251811,Puigverd d'Agramunt,8,2020,31,23
597,251826,Puigverd de Lleida,30,2020,85,55
598,081764,Pujalt,-1,2020,14,15
599,081770,"Quar, la",1,2020,4,3
600,171426,Quart,17,2020,217,200
601,170433,Queralbs,6,2020,15,9
602,431205,Querol,34,2020,66,32
603,171432,Rabós,19,2020,30,11
604,081786,Rajadell,19,2020,39,20
605,431212,Rasquera,31,2020,47,16
606,171447,Regencós,13,2020,27,14
607,081799,Rellinars,68,2020,109,41
608,431227,Renau,-7,2020,4,11
609,431233,Reus,459,2020,4102,3643
610,251832,Rialp,23,2020,59,36
611,431248,"Riba, la",-7,2020,28,35
612,431251,Riba-roja d'Ebre,31,2020,56,25
613,259059,Ribera d'Ondara,-1,2020,19,20
614,251850,Ribera d'Urgellet,24,2020,81,57
615,171450,Ribes de Freser,43,2020,108,65
616,171463,Riells i Viabrea,131,2020,399,268
617,431264,"Riera de Gaià, la",2,2020,69,67
618,251863,Riner,13,2020,22,9
619,171479,Ripoll,62,2020,385,323
620,081803,Ripollet,-50,2020,1711,1761
621,259139,Riu de Cerdanya,1,2020,7,6
622,171485,Riudarenes,85,2020,180,95
623,171498,Riudaura,32,2020,51,19
624,431270,Riudecanyes,36,2020,82,46
625,431286,Riudecols,37,2020,102,65
626,171501,Riudellots de la Selva,12,2020,90,78
627,431299,Riudoms,141,2020,348,207
628,171518,Riumors,-4,2020,19,23
629,081810,"Roca del Vallès, la",-55,2020,416,471
630,431303,Rocafort de Queralt,21,2020,30,9
631,431310,Roda de Berà,406,2020,805,399
632,081831,Roda de Ter,24,2020,335,311
633,431325,Rodonyà,12,2020,44,32
634,431331,Roquetes,78,2020,422,344
635,171523,Roses,23,2020,1331,1308
636,251898,Rosselló,-78,2020,181,259
637,431346,"Rourell, el",31,2020,59,28
638,081846,Rubí,209,2020,3194,2985
639,081859,Rubió,-6,2020,9,15
640,171539,Rupià,30,2020,42,12
641,089019,Rupit i Pruit,22,2020,23,1
642,081878,Sabadell,705,2020,8789,8084
643,081884,Sagàs,5,2020,5,0
644,251902,Salàs de Pallars,22,2020,34,12
645,081901,Saldes,7,2020,29,22
646,171544,Sales de Llierca,5,2020,15,10
647,081918,Sallent,37,2020,217,180
648,431359,Salomó,9,2020,34,25
649,439057,Salou,287,2020,2313,2026
650,171557,Salt,251,2020,1967,1716
651,251919,Sanaüja,19,2020,27,8
652,081944,Sant Adrià de Besòs,-9,2020,2140,2149
653,081957,Sant Agustí de Lluçanès,3,2020,6,3
654,081960,Sant Andreu de la Barca,-192,2020,1051,1243
655,081976,Sant Andreu de Llavaneres,112,2020,767,655
656,171576,Sant Andreu Salou,-2,2020,2,4
657,171833,Sant Aniol de Finestres,6,2020,26,20
658,081982,Sant Antoni de Vilamajor,214,2020,543,329
659,081995,Sant Bartomeu del Grau,26,2020,50,24
660,082009,Sant Boi de Llobregat,-263,2020,3068,3331
661,082016,Sant Boi de Lluçanès,4,2020,43,39
662,431362,Sant Carles de la Ràpita,287,2020,824,537
663,082037,Sant Cebrià de Vallalta,113,2020,329,216
664,082021,Sant Celoni,63,2020,964,901
665,082042,Sant Climent de Llobregat,36,2020,207,171
666,171582,Sant Climent Sescebes,7,2020,72,65
667,082055,Sant Cugat del Vallès,1789,2020,5414,3625
668,082068,Sant Cugat Sesgarrigues,5,2020,46,41
669,251961,Sant Esteve de la Sarga,3,2020,6,3
670,082074,Sant Esteve de Palautordera,126,2020,240,114
671,082080,Sant Esteve Sesrovires,135,2020,472,337
672,171595,Sant Feliu de Buixalleu,14,2020,57,43
673,082107,Sant Feliu de Codines,102,2020,478,376
674,171609,Sant Feliu de Guíxols,182,2020,1313,1131
675,082114,Sant Feliu de Llobregat,205,2020,1949,1744
676,171616,Sant Feliu de Pallerols,39,2020,138,99
677,082129,Sant Feliu Sasserra,13,2020,37,24
678,171621,Sant Ferriol,11,2020,27,16
679,082093,Sant Fost de Campsentelles,278,2020,619,341
680,082135,Sant Fruitós de Bages,110,2020,466,356
681,171637,Sant Gregori,85,2020,232,147
682,251924,Sant Guim de Freixenet,34,2020,78,44
683,251977,Sant Guim de la Plana,12,2020,14,2
684,171642,Sant Hilari Sacalm,87,2020,261,174
685,082153,Sant Hipòlit de Voltregà,24,2020,189,165
686,081939,Sant Iscle de Vallalta,93,2020,175,82
687,439023,Sant Jaume d'Enveja,77,2020,223,146
688,082166,Sant Jaume de Frontanyà,-1,2020,0,1
689,171655,Sant Jaume de Llierca,-10,2020,27,37
690,431378,Sant Jaume dels Domenys,53,2020,217,164
691,171674,Sant Joan de les Abadesses,68,2020,157,89
692,171680,Sant Joan de Mollet,4,2020,27,23
693,082188,Sant Joan de Vilatorrada,-45,2020,356,401
694,082172,Sant Joan Despí,-96,2020,1533,1629
695,171851,Sant Joan les Fonts,21,2020,143,122
696,171668,Sant Jordi Desvalls,42,2020,74,32
697,089030,Sant Julià de Cerdanyola,8,2020,12,4
698,171693,Sant Julià de Ramis,30,2020,233,203
699,082205,Sant Julià de Vilatorta,30,2020,118,88
700,179032,Sant Julià del Llor i Bonmatí,12,2020,99,87
701,082212,Sant Just Desvern,834,2020,1752,918
702,082227,Sant Llorenç d'Hortons,38,2020,165,127
703,171714,Sant Llorenç de la Muga,11,2020,30,19
704,251930,Sant Llorenç de Morunys,49,2020,80,31
705,082233,Sant Llorenç Savall,125,2020,216,91
706,082251,Sant Martí d'Albars,-8,2020,12,20
707,082248,Sant Martí de Centelles,7,2020,77,70
708,171729,Sant Martí de Llémena,22,2020,52,30
709,259025,Sant Martí de Riucorb,11,2020,20,9
710,082264,Sant Martí de Tous,13,2020,53,40
711,082270,Sant Martí Sarroca,34,2020,190,156
712,082286,Sant Martí Sesgueioles,6,2020,17,11
713,171735,Sant Martí Vell,-4,2020,9,13
714,082299,Sant Mateu de Bages,14,2020,45,31
715,171740,Sant Miquel de Campmajor,11,2020,20,9
716,171753,Sant Miquel de Fluvià,3,2020,42,39
717,171766,Sant Mori,-5,2020,13,18
718,171772,Sant Pau de Segúries,43,2020,69,26
719,082310,Sant Pere de Ribes,499,2020,2108,1609
720,082325,Sant Pere de Riudebitlles,47,2020,134,87
721,082331,Sant Pere de Torelló,29,2020,113,84
722,082346,Sant Pere de Vilamajor,142,2020,360,218
723,171788,Sant Pere Pescador,3,2020,147,144
724,081897,Sant Pere Sallavinera,11,2020,18,7
725,082359,Sant Pol de Mar,177,2020,482,305
726,082362,Sant Quintí de Mediona,80,2020,190,110
727,082378,Sant Quirze de Besora,8,2020,75,67
728,082384,Sant Quirze del Vallès,-6,2020,836,842
729,082397,Sant Quirze Safaja,30,2020,84,54
730,251945,Sant Ramon,22,2020,39,17
731,082401,Sant Sadurní d'Anoia,72,2020,479,407
732,082418,Sant Sadurní d'Osormort,-1,2020,6,7
733,080983,Sant Salvador de Guardiola,69,2020,240,171
734,082628,Sant Vicenç de Castellet,207,2020,623,416
735,082649,Sant Vicenç de Montalt,153,2020,552,399
736,082652,Sant Vicenç de Torelló,26,2020,124,98
737,082634,Sant Vicenç dels Horts,21,2020,1028,1007
738,431384,Santa Bàrbara,66,2020,235,169
739,082439,Santa Cecília de Voltregà,1,2020,7,6
740,082444,Santa Coloma de Cervelló,75,2020,398,323
741,171805,Santa Coloma de Farners,164,2020,650,486
742,082457,Santa Coloma de Gramenet,-376,2020,5897,6273
743,431397,Santa Coloma de Queralt,46,2020,159,113
744,171812,Santa Cristina d'Aro,173,2020,467,294
745,082460,Santa Eugènia de Berga,-6,2020,106,112
746,082476,Santa Eulàlia de Riuprimer,39,2020,97,58
747,082482,Santa Eulàlia de Ronçana,144,2020,468,324
748,082495,Santa Fe del Penedès,9,2020,21,12
749,171827,Santa Llogaia d'Àlguema,6,2020,28,22
750,082508,Santa Margarida de Montbui,33,2020,580,547
751,082515,Santa Margarida i els Monjos,-49,2020,382,431
752,082589,Santa Maria d'Oló,35,2020,65,30
753,082536,Santa Maria de Besora,5,2020,11,6
754,082567,Santa Maria de Martorelles,4,2020,35,31
755,082554,Santa Maria de Merlès,-2,2020,13,15
756,082573,Santa Maria de Miralles,7,2020,12,5
757,082592,Santa Maria de Palautordera,78,2020,566,488
758,431401,Santa Oliva,106,2020,260,154
759,171848,Santa Pau,-18,2020,65,83
760,082606,Santa Perpètua de Mogoda,1,2020,1046,1045
761,082613,Santa Susanna,84,2020,351,267
762,081923,Santpedor,10,2020,219,209
763,431423,Sarral,21,2020,82,61
764,171864,Sarrià de Ter,10,2020,261,251
765,252017,Sarroca de Bellera,6,2020,9,3
766,252000,Sarroca de Lleida,7,2020,14,7
767,171870,"Saus, Camallera i Llampaies",22,2020,77,55
768,431439,Savallà del Comtat,1,2020,1,0
769,431444,"Secuita, la",18,2020,97,79
770,171886,"Selva de Mar, la",11,2020,20,9
771,431457,"Selva del Camp, la",3,2020,222,219
772,431460,Senan,-1,2020,0,1
773,430445,"Sénia, la",-10,2020,199,209
774,252022,Senterada,11,2020,21,10
775,250352,"Sentiu de Sió, la",14,2020,25,11
776,082671,Sentmenat,95,2020,484,389
777,171903,Serinyà,18,2020,61,43
778,252043,Seròs,1,2020,89,88
779,171910,Serra de Daró,14,2020,24,10
780,171925,Setcases,19,2020,24,5
781,252038,"Seu d'Urgell, la",187,2020,785,598
782,082690,Seva,168,2020,289,121
783,252056,Sidamon,13,2020,38,25
784,171931,Sils,172,2020,490,318
785,082704,Sitges,1000,2020,2635,1635
786,170524,Siurana,5,2020,9,4
787,082711,Sobremunt,1,2020,5,4
788,252069,"Soleràs, el",10,2020,21,11
789,431476,Solivella,12,2020,45,33
790,252075,Solsona,134,2020,432,298
791,082726,Sora,-1,2020,8,9
792,252081,Soriguera,13,2020,29,16
793,252094,Sort,69,2020,144,75
794,252108,Soses,29,2020,107,78
795,082732,Subirats,72,2020,205,133
796,252115,Sudanell,22,2020,41,19
797,252120,Sunyer,-12,2020,12,24
798,082747,Súria,32,2020,194,162
799,171946,Susqueda,8,2020,15,7
800,082763,Tagamanent,12,2020,29,17
801,082779,Talamanca,13,2020,23,10
802,252154,Talarn,-105,2020,110,215
803,252167,Talavera,8,2020,17,9
804,171959,"Tallada d'Empordà, la",11,2020,36,25
805,082785,Taradell,100,2020,302,202
806,431482,Tarragona,-229,2020,6258,6487
807,252173,Tàrrega,286,2020,902,616
808,252189,Tarrés,5,2020,10,5
809,252192,Tarroja de Segarra,0,2020,4,4
810,082750,Tavèrnoles,5,2020,30,25
811,082802,Tavertet,10,2020,13,3
812,082819,Teià,125,2020,431,306
813,252206,Térmens,-11,2020,54,65
814,171962,Terrades,6,2020,31,25
815,082798,Terrassa,424,2020,7969,7545
816,082824,Tiana,105,2020,468,363
817,252213,Tírvia,0,2020,6,6
818,252228,Tiurana,-4,2020,2,6
819,431495,Tivenys,16,2020,41,25
820,431508,Tivissa,-1,2020,68,69
821,082830,Tona,54,2020,383,329
822,252234,Torà,-10,2020,75,85
823,082845,Tordera,359,2020,1154,795
824,082858,Torelló,251,2020,672,421
825,252249,"Torms, els",10,2020,11,1
826,252252,Tornabous,7,2020,42,35
827,252271,"Torre de Cabdella, la",3,2020,29,26
828,082861,"Torre de Claramunt, la",135,2020,333,198
829,431515,"Torre de Fontaubella, la",0,2020,9,9
830,431520,"Torre de l'Espanyol, la",7,2020,30,23
831,252265,Torrebesses,33,2020,51,18
832,431536,Torredembarra,532,2020,1362,830
833,252287,Torrefarrera,-1,2020,204,205
834,259078,Torrefeta i Florejacs,8,2020,37,29
835,252304,Torregrossa,2,2020,73,71
836,252311,Torrelameu,34,2020,62,28
837,082877,Torrelavit,14,2020,68,54
838,082883,Torrelles de Foix,111,2020,270,159
839,082896,Torrelles de Llobregat,78,2020,345,267
840,171978,Torrent,4,2020,11,7
841,252326,Torres de Segre,41,2020,235,194
842,252332,Torre-serona,-3,2020,22,25
843,171984,Torroella de Fluvià,20,2020,89,69
844,171997,Torroella de Montgrí,253,2020,776,523
845,431541,Torroja del Priorat,-3,2020,8,11
846,172001,Tortellà,-5,2020,37,42
847,431554,Tortosa,711,2020,1768,1057
848,172018,Toses,13,2020,20,7
849,172023,Tossa de Mar,202,2020,402,200
850,252347,Tremp,52,2020,329,277
851,172044,Ullà,0,2020,103,103
852,082900,Ullastrell,16,2020,111,95
853,172057,Ullastret,-12,2020,16,28
854,431567,Ulldecona,-101,2020,359,460
855,431573,Ulldemolins,9,2020,20,11
856,172039,Ultramort,4,2020,14,10
857,172060,Urús,16,2020,21,5
858,082917,Vacarisses,253,2020,601,348
859,170144,"Vajol, la",1,2020,15,14
860,172076,"Vall d'en Bas, la",47,2020,160,113
861,172082,"Vall de Bianya, la",45,2020,95,50
862,250432,"Vall de Boí, la",41,2020,89,48
863,259010,Vall de Cardós,27,2020,37,10
864,082922,Vallbona d'Anoia,29,2020,84,55
865,252385,Vallbona de les Monges,-1,2020,8,9
866,082938,Vallcebre,10,2020,25,15
867,431589,Vallclara,4,2020,6,2
868,252402,Vallfogona de Balaguer,13,2020,77,64
869,171707,Vallfogona de Ripollès,18,2020,27,9
870,431592,Vallfogona de Riucorb,2,2020,4,2
871,082943,Vallgorguina,77,2020,269,192
872,082956,Vallirana,211,2020,869,658
873,172095,Vall-llobrega,31,2020,79,48
874,431606,Vallmoll,48,2020,134,86
875,082969,Vallromanes,26,2020,169,143
876,431613,Valls,107,2020,1044,937
877,259062,"Valls d'Aguilar, les",27,2020,36,9
878,252398,"Valls de Valira, les",30,2020,80,50
879,431628,Vandellòs i l'Hospitalet de l'Infant,65,2020,384,319
880,259097,"Vansa i Fórnols, la",8,2020,17,9
881,082975,Veciana,4,2020,7,3
882,431634,"Vendrell, el",772,2020,2550,1778
883,172109,Ventalló,65,2020,124,59
884,252424,Verdú,-8,2020,40,48
885,172116,Verges,16,2020,70,54
886,431649,Vespella de Gaià,40,2020,50,10
887,082981,Vic,-106,2020,2673,2779
888,172121,Vidrà,9,2020,15,6
889,172137,Vidreres,172,2020,657,485
890,252430,Vielha e Mijaran,62,2020,397,335
891,431652,Vilabella,-18,2020,29,47
892,172142,Vilabertran,-17,2020,40,57
893,172155,Vilablareix,148,2020,231,83
894,082994,Vilada,12,2020,27,15
895,172174,Viladamat,16,2020,42,26
896,172168,Viladasens,4,2020,13,9
897,083015,Viladecans,-183,2020,2430,2613
898,083008,Viladecavalls,83,2020,390,307
899,172180,Vilademuls,5,2020,72,67
900,172207,Viladrau,66,2020,96,30
901,172214,Vilafant,62,2020,324,262
902,083054,Vilafranca del Penedès,10,2020,1635,1625
903,252445,Vilagrassa,15,2020,33,18
904,172235,Vilajuïga,17,2020,66,49
905,431750,Vilalba dels Arcs,16,2020,22,6
906,083067,Vilalba Sasserra,24,2020,63,39
907,252458,Vilaller,14,2020,40,26
908,172240,Vilallonga de Ter,-10,2020,19,29
909,431665,Vilallonga del Camp,-6,2020,124,130
910,172253,Vilamacolum,-5,2020,43,48
911,172266,Vilamalla,-4,2020,58,62
912,172272,Vilamaniscle,-3,2020,17,20
913,252477,Vilamòs,-6,2020,25,31
914,172288,Vilanant,14,2020,36,22
915,431671,Vilanova d'Escornalbou,14,2020,42,28
916,252483,Vilanova de Bellpuig,31,2020,62,31
917,252496,Vilanova de l'Aguda,2,2020,7,5
918,252542,Vilanova de la Barca,55,2020,195,140
919,252509,Vilanova de Meià,18,2020,73,55
920,431687,Vilanova de Prades,5,2020,12,7
921,083036,Vilanova de Sau,5,2020,13,8
922,252516,Vilanova de Segrià,7,2020,53,46
923,083020,Vilanova del Camí,189,2020,660,471
924,089024,Vilanova del Vallès,77,2020,315,238
925,083073,Vilanova i la Geltrú,283,2020,2955,2672
926,431690,Vilaplana,-7,2020,16,23
927,431704,Vila-rodona,32,2020,90,58
928,172305,Vila-sacra,18,2020,78,60
929,252521,Vila-sana,39,2020,60,21
930,431711,Vila-seca,207,2020,1166,959
931,082140,Vilassar de Dalt,47,2020,451,404
932,082191,Vilassar de Mar,65,2020,956,891
933,172229,Vilaür,5,2020,8,3
934,431726,Vilaverd,6,2020,29,23
935,431732,"Vilella Alta, la",5,2020,9,4
936,431747,"Vilella Baixa, la",7,2020,14,7
937,172333,Vilobí d'Onyar,-12,2020,133,145
938,083041,Vilobí del Penedès,26,2020,73,47
939,172327,Vilopriu,25,2020,45,20
940,252537,"Vilosell, el",20,2020,35,15
941,431763,Vimbodí i Poblet,2,2020,36,34
942,252555,Vinaixa,19,2020,34,15
943,431779,Vinebre,7,2020,23,16
944,431785,Vinyols i els Arcs,66,2020,190,124
945,083089,Viver i Serrateix,6,2020,8,2
946,430521,Xerta,17,2020,49,32
