Codi,Literal,1,2,3,4,5,6 i més,Total llars
250019,Abella de la Conca,19,11,10,11,5,6,62
80018,Abrera,534,920,773,667,170,59,3123
250024,Àger,67,49,38,24,10,12,200
250030,Agramunt,264,384,302,297,131,137,1515
80023,Aguilar de Segarra,17,19,13,11,8,6,74
170010,Agullana,63,81,59,40,12,7,262
80142,Aiguafreda,159,254,153,158,52,15,791
430017,Aiguamúrcia,87,79,25,41,18,12,262
170025,Aiguaviva,17,27,35,39,11,16,145
250387,Aitona,119,150,141,142,62,56,670
250045,"Alamús, els",31,61,52,45,21,13,223
250058,Alàs i Cerc,38,30,29,18,17,9,141
250061,"Albagés, l'",46,53,24,36,18,9,186
170031,Albanyà,14,12,4,7,1,2,40
250077,Albatàrrec,86,95,90,88,39,21,419
250083,Albesa,84,125,112,99,55,24,499
250096,"Albi, l'",69,66,69,56,20,11,291
430022,Albinyana,144,160,122,109,45,22,602
430038,"Albiol, l'",26,16,13,17,4,1,77
170046,Albons,59,54,35,36,13,8,205
430043,Alcanar,544,785,613,571,225,102,2840
250100,Alcanó,13,23,17,11,10,8,82
250117,Alcarràs,232,401,395,370,124,70,1592
250122,Alcoletge,99,159,128,134,55,22,597
430056,Alcover,235,366,306,305,105,48,1365
439044,"Aldea, l'",244,373,260,255,79,40,1251
430069,Aldover,49,68,52,50,24,18,261
430075,"Aleixar, l'",63,74,46,49,19,13,264
80039,Alella,354,568,642,701,258,120,2643
430081,Alfara de Carles,27,28,24,15,15,9,118
250138,Alfarràs,168,280,258,199,74,45,1024
250143,Alfés,19,31,27,16,9,8,110
430094,Alforja,109,147,95,106,31,9,497
250156,Algerri,35,44,40,22,18,12,171
250169,Alguaire,183,244,221,217,69,28,962
250175,Alins,35,19,20,20,8,3,105
430108,Alió,31,40,28,19,5,12,135
250194,Almacelles,317,517,426,408,145,72,1885
250208,Almatret,53,57,27,26,11,9,183
250215,Almenar,194,300,273,268,88,48,1171
430115,Almoster,47,73,64,101,17,11,313
250220,Alòs de Balaguer,24,15,12,9,3,4,67
170062,Alp,185,101,92,78,29,15,500
80044,Alpens,23,26,20,23,4,5,101
250236,Alpicat,171,312,317,385,138,52,1375
250241,Alt Àneu,60,39,25,27,8,7,166
430120,Altafulla,296,305,241,257,80,36,1215
170078,Amer,160,201,173,166,53,25,778
430136,"Ametlla de Mar, l'",440,639,392,351,93,35,1950
80057,"Ametlla del Vallès, l'",273,506,474,509,163,72,1997
439060,"Ampolla, l'",209,263,156,126,37,16,807
430141,Amposta,1011,1666,1392,1254,384,204,5911
170084,Anglès,320,458,396,340,117,53,1684
250273,Anglesola,83,115,93,77,43,16,427
250292,Arbeca,137,226,177,139,70,46,795
430167,"Arboç, l'",220,341,307,296,80,42,1286
430154,Arbolí,12,9,9,7,3,3,43
170097,Arbúcies,356,499,396,398,100,55,1804
80060,Arenys de Mar,980,1263,991,950,291,116,4591
80076,Arenys de Munt,452,639,511,519,169,66,2356
170101,Argelaguer,32,32,27,30,9,8,138
80082,Argençola,15,10,9,16,3,8,61
430173,"Argentera, l'",27,14,9,9,4,1,64
80095,Argentona,509,797,746,814,289,125,3280
170118,"Armentera, l'",81,80,57,52,17,6,293
430189,Arnes,42,50,33,25,12,15,177
250313,Arres,9,2,5,2,2,2,22
250328,Arsèguel,6,11,5,4,4,3,33
80109,Artés,227,415,378,347,110,56,1533
250334,Artesa de Lleida,63,116,119,96,39,13,446
250349,Artesa de Segre,270,286,261,195,89,57,1158
430192,Ascó,153,155,111,129,45,13,606
250365,Aspa,25,38,17,20,2,4,106
250371,"Avellanes i Santa Linya, les",44,43,38,29,9,10,173
80116,Avià,107,204,158,129,49,22,669
80121,Avinyó,103,183,170,151,54,27,688
170123,Avinyonet de Puigventós,50,77,70,75,20,9,301
80137,Avinyonet del Penedès,73,115,81,96,36,23,424
80155,Badalona,11549,19465,17579,16668,4677,1806,71744
89045,Badia del Vallès,740,1316,1326,1160,365,138,5045
80168,Bagà,165,239,143,170,44,15,776
250390,Baix Pallars,51,34,26,22,11,3,147
250404,Balaguer,945,1274,1027,985,333,153,4717
80174,Balenyà,136,250,258,251,78,59,1032
80180,Balsareny,180,348,292,243,63,20,1146
430206,Banyeres del Penedès,106,153,149,130,55,13,606
170157,Banyoles,5051,1107,728,599,217,136,7838
250411,Barbens,51,61,55,38,23,23,251
430213,Barberà de la Conca,57,48,23,33,10,2,173
82520,Barberà del Vallès,1130,2222,2324,2397,596,199,8868
80193,Barcelona,155463,177426,125780,96668,27345,11770,594452
250426,"Baronia de Rialb, la",25,20,19,15,7,9,95
170160,Bàscara,46,82,51,52,30,14,275
250447,Bassella,21,11,12,12,12,12,80
430228,Batea,114,180,128,118,52,65,657
250450,Bausen,11,7,5,2,1,0,26
80207,Begues,211,355,363,450,120,42,1541
170139,Begur,368,340,242,254,75,43,1322
250463,Belianes,58,63,41,45,15,4,226
251706,Bellaguarda,27,29,22,24,9,11,122
170182,Bellcaire d'Empordà,49,50,45,38,10,11,203
250479,Bellcaire d'Urgell,88,115,100,94,33,20,450
250485,Bell-lloc d'Urgell,123,217,146,151,58,27,722
250498,Bellmunt d'Urgell,16,19,18,12,6,8,79
430234,Bellmunt del Priorat,43,43,22,18,5,3,134
80214,Bellprat,9,4,5,3,5,3,29
250501,Bellpuig,250,373,309,291,118,51,1392
430249,Bellvei,96,128,105,100,43,18,490
250518,Bellver de Cerdanya,226,143,131,96,31,22,649
250523,Bellvís,187,212,151,150,50,30,780
250539,Benavent de Segrià,60,74,73,83,34,18,342
430252,Benifallet,47,68,47,56,36,19,273
430265,Benissanet,72,111,87,65,29,15,379
80229,Berga,1321,1663,1281,974,265,114,5618
170195,Besalú,156,229,182,131,46,18,762
170209,Bescanó,185,297,292,255,80,36,1145
170216,Beuda,8,15,11,7,4,2,47
80235,Bigues i Riells del Fai,271,535,474,482,133,85,1980
250557,Biosca,22,14,11,18,13,3,81
170221,"Bisbal d'Empordà, la",535,811,643,585,201,105,2880
430271,"Bisbal de Falset, la",13,22,14,18,7,7,81
430287,"Bisbal del Penedès, la",196,246,157,141,42,33,815
172348,Biure,34,26,20,12,5,2,99
430290,Blancafort,42,35,37,18,12,6,150
170237,Blanes,2384,3069,2400,2341,660,332,11186
170293,Boadella i les Escaules,18,26,15,13,6,3,81
170242,Bolvir,45,18,19,17,6,5,110
430304,Bonastre,49,44,31,21,6,3,154
250576,"Bòrdes, Es",22,21,12,11,7,4,77
170255,Bordils,83,113,107,110,34,16,463
250582,"Borges Blanques, les",344,520,385,389,136,57,1831
430311,"Borges del Camp, les",134,164,119,105,40,25,587
170268,Borrassà,30,47,32,36,21,12,178
80240,Borredà,47,47,33,37,8,9,181
250595,Bossòst,86,76,82,66,26,12,348
430326,Bot,44,84,57,48,26,16,275
430332,Botarell,54,63,56,45,27,11,256
250560,Bovera,35,35,25,21,10,11,137
430347,Bràfim,68,56,38,40,16,7,225
170274,Breda,213,331,294,249,76,37,1200
80253,"Bruc, el",115,129,95,75,32,15,461
80266,"Brull, el",11,11,14,8,7,6,57
170280,Brunyola i Sant Martí Sapresa,13,29,30,14,7,16,109
430350,Cabacés,28,24,24,21,15,6,118
250609,Cabanabona,12,8,4,6,2,3,35
170314,Cabanelles,26,26,8,18,7,2,87
170307,Cabanes,57,84,49,47,25,11,273
80272,"Cabanyes, les",20,56,42,42,13,10,183
250616,Cabó,13,9,7,5,5,3,42
430363,Cabra del Camp,63,79,41,50,20,6,259
80288,Cabrera d'Anoia,62,79,47,41,13,11,253
80291,Cabrera de Mar,219,270,276,295,125,58,1243
80305,Cabrils,242,382,348,429,169,83,1653
170329,Cadaqués,263,224,140,151,30,18,826
80312,Calaf,195,280,242,220,86,27,1050
430379,Calafell,1463,1710,972,867,282,124,5418
80348,Calders,62,70,70,61,19,6,288
80327,Caldes d'Estrac,212,225,155,117,32,24,765
170335,Caldes de Malavella,288,393,339,298,96,59,1473
80333,Caldes de Montbui,795,1273,1164,1094,311,141,4778
80351,Calella,1335,1440,1108,857,272,175,5187
80370,Calldetenes,84,129,141,190,48,28,620
80386,Callús,76,145,108,94,30,18,471
80364,Calonge de Segarra,10,12,12,9,4,11,58
170340,Calonge i Sant Antoni,2722,613,290,255,97,48,4025
250621,Camarasa,78,83,60,49,23,21,314
439039,Camarles,133,316,218,211,84,35,997
430385,Cambrils,1733,2030,1684,1508,492,224,7671
170353,Camós,20,41,43,47,23,16,190
170366,Campdevànol,246,383,309,240,55,22,1255
170372,Campelles,17,11,8,4,3,4,47
80399,Campins,38,29,21,19,7,4,118
170388,Campllong,18,32,17,23,11,5,106
170391,Camprodon,281,226,196,140,35,21,899
250637,Canejan,20,10,5,7,0,4,46
170405,Canet d'Adri,49,47,32,34,15,12,189
80403,Canet de Mar,816,1131,836,797,236,92,3908
80410,Canovelles,548,1051,1019,1077,359,160,4214
80425,Cànoves i Samalús,99,182,130,150,64,26,651
170412,Cantallops,31,25,27,9,8,3,103
80431,Canyelles,176,235,165,155,44,28,803
430398,Capafonts,18,21,12,2,1,1,55
430402,Capçanes,51,28,24,31,13,7,154
80446,Capellades,246,437,365,396,140,55,1639
170427,Capmany,32,59,40,30,13,5,179
80459,Capolat,6,4,7,4,3,0,24
80462,Cardedeu,674,1230,1041,1033,314,121,4413
80478,Cardona,416,552,407,377,115,79,1946
80484,Carme,53,60,32,52,17,17,231
430419,Caseres,29,31,23,18,7,8,116
170448,Cassà de la Selva,543,760,552,607,200,77,2739
80497,Casserres,118,163,125,104,38,16,564
80575,Castell de l'Areny,8,10,4,2,2,0,26
259046,Castell de Mur,27,18,9,8,3,2,67
250642,Castellar de la Ribera,9,6,5,4,3,12,39
80522,Castellar de n'Hug,18,14,14,9,2,4,61
80500,Castellar del Riu,15,14,5,12,1,1,48
80517,Castellar del Vallès,823,1698,1511,1549,417,173,6171
80538,Castellbell i el Vilar,226,293,235,198,78,31,1061
80543,Castellbisbal,386,874,767,746,206,101,3080
80556,Castellcir,29,39,27,32,13,4,144
250674,Castelldans,76,115,70,63,21,10,355
80569,Castelldefels,3210,4470,3892,3521,1021,471,16585
80581,Castellet i la Gornal,143,164,107,111,31,15,571
170464,Castellfollit de la Roca,100,114,77,65,17,9,382
80608,Castellfollit de Riubregós,17,13,13,11,13,5,72
80594,Castellfollit del Boix,34,28,24,24,11,11,132
80615,Castellgalí,66,84,89,62,22,17,340
80620,Castellnou de Bages,36,53,50,50,14,6,209
250680,Castellnou de Seana,67,58,55,43,15,15,253
170470,Castelló d'Empúries,706,696,389,401,109,70,2371
250693,Castelló de Farfanya,54,54,28,35,25,10,206
80636,Castellolí,32,29,31,29,16,8,145
170486,Castell-Platja d'Aro,962,750,511,428,134,64,2849
250707,Castellserà,80,95,78,78,36,17,384
80641,Castellterçol,174,205,148,140,47,22,736
430424,Castellvell del Camp,67,102,102,140,52,21,484
80654,Castellví de la Marca,82,111,114,93,44,30,474
80667,Castellví de Rosanes,59,102,99,115,26,6,407
430430,"Catllar, el",145,239,210,211,63,27,895
250714,Cava,10,6,4,2,1,1,24
171899,"Cellera de Ter, la",131,162,152,145,59,28,677
170499,Celrà,161,249,234,202,75,28,949
80673,Centelles,380,571,454,458,131,62,2056
82687,Cercs,163,160,113,94,24,7,561
82665,Cerdanyola del Vallès,2776,4850,4466,4567,1186,433,18278
80689,Cervelló,293,509,521,494,158,75,2050
250729,Cervera,507,719,618,558,202,106,2710
250735,Cervià de les Garrigues,86,90,69,44,30,9,328
170502,Cervià de Ter,52,59,53,54,18,4,240
170519,Cistella,16,18,18,19,7,4,82
250740,Ciutadilla,17,27,10,13,7,5,79
250753,Clariana de Cardener,7,8,5,8,9,6,43
250766,"Cogul, el",30,19,14,8,6,10,87
170545,Colera,78,70,30,31,6,6,221
250772,Coll de Nargó,60,56,46,39,12,9,222
80692,Collbató,219,254,210,165,56,21,925
430458,Colldejou,14,12,6,12,6,8,58
80706,Collsuspina,19,21,20,24,9,1,94
170558,Colomers,18,17,23,9,5,3,75
251636,"Coma i la Pedra, la",45,17,16,10,4,7,99
251615,Conca de Dalt,55,39,25,18,11,14,162
430461,Conesa,21,17,11,7,2,1,59
430477,Constantí,277,400,403,390,152,70,1692
80713,Copons,39,35,17,20,5,2,118
430483,Corbera d'Ebre,64,71,66,81,34,24,340
80728,Corbera de Llobregat,531,886,824,702,245,97,3285
250788,Corbins,73,99,91,75,33,16,387
170577,Corçà,86,72,73,97,47,11,386
80734,Cornellà de Llobregat,5054,8389,7232,6017,1532,667,28891
170561,Cornellà del Terri,97,138,150,125,55,42,607
430496,Cornudella de Montsant,117,98,58,46,21,13,353
430509,Creixell,232,277,136,107,41,35,828
170583,Crespià,19,26,12,14,4,4,79
179011,"Cruïlles, Monells i Sant Sadurní de l'Heura",95,62,80,70,31,29,367
80749,Cubelles,739,930,577,432,149,70,2897
250791,Cubells,27,34,23,19,11,9,123
430516,Cunit,790,863,451,375,123,56,2658
170600,Darnius,61,76,50,23,7,4,221
170617,Das,22,8,8,10,4,4,56
439018,Deltebre,417,776,829,744,332,216,3314
80752,Dosrius,178,261,236,245,83,40,1043
430537,Duesaigües,29,22,19,11,3,2,86
170622,"Escala, l'",701,649,443,369,115,70,2347
80765,Esparreguera,1091,1806,1593,1411,406,163,6470
170638,Espinelves,24,20,9,8,4,4,69
250812,"Espluga Calba, l'",35,40,28,26,17,7,153
430542,"Espluga de Francolí, l'",224,313,276,279,93,40,1225
80771,Esplugues de Llobregat,2389,4113,3873,3828,1046,326,15575
170643,Espolla,36,34,20,24,12,7,133
170656,Esponellà,13,20,32,28,9,9,111
250827,Espot,39,20,22,14,12,7,114
80787,"Espunyola, l'",8,16,15,11,13,11,74
82541,"Esquirol, l'",141,190,144,149,53,39,716
250886,Estamariu,11,7,10,7,4,4,43
80790,"Estany, l'",42,37,33,24,6,6,148
250851,Estaràs,14,14,15,11,4,5,63
250864,Esterri d'Àneu,71,55,57,43,15,6,247
250870,Esterri de Cardós,6,7,2,5,4,1,25
430555,Falset,202,245,177,184,61,26,895
170059,"Far d'Empordà, el",38,34,28,24,9,8,141
250899,Farrera,17,14,6,6,0,2,45
430568,"Fatarella, la",79,112,87,85,32,21,416
430574,"Febró, la",9,6,6,2,1,1,25
81347,Figaró-Montmany,69,88,60,56,22,7,302
80804,Fígols,8,7,2,4,1,0,22
259084,Fígols i Alinyà,33,31,16,16,2,8,106
430580,"Figuera, la",20,12,8,8,2,2,52
170669,Figueres,2821,3479,2756,2239,693,369,12357
430593,Figuerola del Camp,21,35,25,26,2,1,110
170675,Flaçà,77,84,79,58,16,11,325
430607,Flix,267,375,341,313,89,34,1419
250925,"Floresta, la",21,24,14,8,4,3,74
80826,Fogars de la Selva,57,92,47,63,23,9,291
80811,Fogars de Montclús,24,32,23,15,11,12,117
170681,Foixà,24,31,32,16,5,6,114
80832,Folgueroles,81,171,137,132,51,12,584
250931,Fondarella,27,45,46,54,27,11,210
80847,Fonollosa,58,75,85,79,32,21,350
170694,Fontanals de Cerdanya,51,37,17,27,12,10,154
170708,Fontanilles,14,8,9,6,4,5,46
170715,Fontcoberta,23,68,98,93,40,22,344
80850,Font-rubí,80,105,94,81,38,27,425
250946,Foradada,21,12,10,14,5,7,69
179026,Forallac,123,133,120,113,48,24,561
430614,Forès,7,9,6,3,0,1,26
170736,Fornells de la Selva,86,103,109,140,48,29,515
170741,Fortià,43,53,48,35,11,4,194
80863,"Franqueses del Vallès, les",668,1187,1071,1061,298,135,4420
430629,Freginals,25,40,28,33,5,5,136
250962,"Fuliola, la",80,101,96,82,33,25,417
250978,Fulleda,6,10,9,8,6,0,39
80902,Gaià,12,10,5,9,4,7,47
430635,"Galera, la",74,83,53,46,20,10,286
80879,Gallifa,19,13,12,14,6,3,67
430640,Gandesa,175,208,190,201,76,47,897
430653,Garcia,57,58,36,25,15,10,201
430666,"Garidells, els",7,17,12,11,7,3,57
80885,"Garriga, la",720,1126,984,965,262,123,4180
170754,Garrigàs,27,35,13,24,9,5,113
170767,Garrigoles,17,12,12,10,3,4,58
170773,Garriguella,73,77,56,30,18,16,270
80898,Gavà,2176,3667,3505,3177,871,394,13790
250984,Gavet de la Conca,33,31,23,12,8,9,116
80919,Gelida,313,504,376,317,100,51,1661
170789,Ger,58,32,22,23,9,7,151
259123,Gimenells i el Pla de la Font,65,83,80,66,38,22,354
430672,Ginestar,56,84,61,50,23,18,292
170792,Girona,6671,7258,5772,5503,1648,837,27689
80924,Gironella,367,541,413,324,113,40,1798
80930,Gisclareny,7,2,3,2,0,0,14
430688,Godall,72,78,69,35,14,11,279
250997,Golmés,68,125,91,93,38,32,447
170806,Gombrèn,28,25,17,14,6,2,92
251001,Gósol,35,23,13,13,5,6,95
80945,"Granada, la",70,124,97,113,46,21,471
251018,"Granadella, la",66,81,60,46,21,13,287
80958,Granera,15,6,6,4,0,1,32
251023,"Granja d'Escarp, la",96,85,82,78,33,12,386
80961,Granollers,3222,5130,4432,4101,1213,541,18639
251039,Granyanella,14,13,15,6,4,2,54
251057,Granyena de les Garrigues,29,15,13,10,2,1,70
251044,Granyena de Segarra,19,14,7,10,7,1,58
430691,Gratallops,23,19,10,19,6,4,81
80977,Gualba,72,93,60,52,21,10,308
170813,Gualta,23,26,20,17,10,8,104
80996,Guardiola de Berguedà,96,106,89,60,18,5,374
430705,"Guiamets, els",19,27,27,25,5,4,107
170828,Guils de Cerdanya,44,38,24,19,4,7,136
251095,Guimerà,43,53,23,18,11,3,151
259031,"Guingueta d'Àneu, la",58,39,23,14,2,7,143
251109,Guissona,231,287,271,294,103,42,1228
251116,Guixers,18,11,11,7,7,3,57
81000,Gurb,93,118,113,165,64,47,600
430712,Horta de Sant Joan,109,133,84,99,23,13,461
81017,"Hospitalet de Llobregat, l'",16736,25851,21394,17227,4598,2066,87872
81629,"Hostalets de Pierola, els",125,160,113,96,30,21,545
170834,Hostalric,191,284,255,211,68,32,1041
81022,Igualada,2438,3278,2551,2535,783,315,11900
251155,Isona i Conca Dellà,121,109,87,64,33,24,438
170849,Isòvol,29,16,12,9,10,1,77
251137,Ivars d'Urgell,103,161,113,109,50,40,576
251121,Ivars de Noguera,24,26,22,25,5,10,112
251142,Ivorra,11,12,4,8,9,6,50
170852,Jafre,39,32,25,20,7,7,130
170865,"Jonquera, la",206,210,207,211,51,41,926
81038,Jorba,52,57,33,46,19,7,214
259101,Josa i Tuixén,18,17,10,8,4,2,59
170871,Juià,18,25,29,15,8,2,97
251180,Juncosa,44,59,36,30,18,10,197
251193,Juneda,171,267,199,199,95,49,980
251214,Les,66,56,57,46,16,12,253
251229,Linyola,146,202,167,178,75,35,803
81043,"Llacuna, la",88,76,56,68,22,7,317
170887,Lladó,42,52,47,31,12,6,190
251235,Lladorre,37,24,13,12,5,6,97
251240,Lladurs,15,11,11,13,7,10,67
81056,"Llagosta, la",587,1206,1100,981,237,93,4204
170890,Llagostera,2657,399,200,161,51,31,3499
170904,Llambilles,24,17,16,21,8,21,107
170911,Llanars,63,41,47,29,14,6,200
170926,Llançà,451,487,338,240,61,30,1607
251253,Llardecans,62,54,36,42,20,10,224
251266,Llavorsí,39,38,25,19,1,2,124
251207,Lleida,8277,10751,9351,8319,2586,1164,40448
170932,Llers,58,104,76,76,28,11,353
251272,Lles de Cerdanya,31,25,19,20,7,4,106
81075,Lliçà d'Amunt,395,849,794,888,328,144,3398
81081,Lliçà de Vall,171,376,446,496,139,63,1691
251288,Llimiana,31,12,9,4,6,2,64
81069,Llinars del Vallès,404,635,598,575,187,81,2480
170947,Llívia,152,104,74,62,21,10,423
430727,"Lloar, el",12,17,12,5,1,1,48
251291,Llobera,8,8,8,9,9,13,55
430733,Llorac,11,13,8,6,5,2,45
430748,Llorenç del Penedès,105,147,109,131,47,27,566
170950,Lloret de Mar,1790,1907,1543,1469,467,252,7428
170963,"Llosses, les",32,17,20,20,6,3,98
81094,Lluçà,21,17,16,16,9,8,87
171024,Maçanet de Cabrenys,88,69,50,35,19,8,269
171030,Maçanet de la Selva,282,371,297,339,86,46,1421
170979,Madremanya,18,19,10,13,8,3,71
170985,Maià de Montcal,25,39,22,17,11,6,120
251333,Maials,87,78,84,50,25,21,345
251305,Maldà,39,32,18,14,9,2,114
81108,Malgrat de Mar,903,1525,1147,1078,293,157,5103
81115,Malla,5,7,15,11,9,12,59
81120,Manlleu,860,1592,1387,1352,414,264,5869
81136,Manresa,5284,7348,5514,4377,1176,529,24228
430764,Marçà,72,76,49,51,7,1,256
430751,Margalef,20,11,6,10,3,3,53
82423,Marganell,28,29,11,12,3,3,86
81141,Martorell,1282,2471,1947,1694,457,247,8098
81154,Martorelles,290,416,407,423,120,42,1698
430770,Mas de Barberans,52,58,46,54,16,13,239
171002,Masarac,15,19,15,16,9,5,79
430786,Masdenverge,43,96,67,84,18,14,322
81167,"Masies de Roda, les",23,67,39,63,21,12,225
81173,"Masies de Voltregà, les",118,249,255,234,62,37,955
430799,Masllorenç,43,60,28,21,8,9,169
81189,"Masnou, el",1374,1994,1777,1599,453,178,7375
430803,"Masó, la",14,25,24,17,9,5,94
430810,Maspujols,40,45,39,39,12,5,180
81192,Masquefa,329,618,459,410,117,49,1982
430825,"Masroig, el",59,64,41,23,13,8,208
251312,Massalcoreig,27,47,38,34,24,17,187
171019,Massanes,59,51,35,36,15,12,208
251327,Massoteres,18,19,9,10,6,5,67
81206,Matadepera,201,385,463,613,267,147,2076
81213,Mataró,7046,10534,8623,8203,2362,1082,37850
81228,Mediona,174,182,94,89,36,20,595
251348,Menàrguens,65,79,54,49,33,12,292
170998,Meranges,17,7,5,1,1,4,35
171058,Mieres,21,32,17,18,13,7,108
430831,"Milà, el",11,11,9,11,8,3,53
251351,Miralcamp,72,94,82,76,37,31,392
430846,Miravet,68,76,52,50,26,10,282
81385,Moià,316,393,346,342,88,49,1534
430859,"Molar, el",28,32,24,14,10,4,112
81234,Molins de Rei,1342,2117,1719,1520,429,243,7370
251370,Mollerussa,601,860,802,743,268,138,3412
171061,Mollet de Peralada,18,23,14,7,1,7,70
81249,Mollet del Vallès,2720,4804,4251,3672,922,411,16780
171077,Molló,34,35,19,22,13,3,126
251364,"Molsosa, la",2,6,6,2,4,11,31
81287,Monistrol de Calders,37,56,42,54,18,5,212
81271,Monistrol de Montserrat,222,252,210,154,53,28,919
171096,Montagut i Oix,63,85,66,50,24,12,300
430862,Montblanc,430,525,532,440,156,66,2149
430884,Montbrió del Camp,125,153,93,110,41,22,544
81252,Montcada i Reixac,1567,2877,2314,2350,642,217,9967
81304,Montclar,5,7,3,7,3,7,32
251399,Montellà i Martinet,78,56,41,25,12,8,220
81311,Montesquiu,84,92,67,56,13,8,320
251403,Montferrer i Castellbò,73,72,43,40,20,19,267
430897,Montferri,16,18,10,8,9,0,61
251386,Montgai,74,60,52,46,25,22,279
81265,Montgat,590,852,712,653,172,65,3044
81326,Montmajor,19,39,15,28,17,19,137
81332,Montmaneu,13,13,10,16,5,3,60
430901,"Montmell, el",87,90,40,46,14,12,289
81350,Montmeló,419,772,682,745,225,71,2914
251425,Montoliu de Lleida,26,38,28,28,14,15,149
251410,Montoliu de Segarra,26,22,8,6,6,3,71
251431,Montornès de Segarra,13,7,7,6,2,3,38
81363,Montornès del Vallès,705,1209,1048,1027,289,161,4439
430918,Mont-ral,28,17,11,7,1,3,67
171100,Mont-ras,66,100,120,157,55,22,520
430923,Mont-roig del Camp,697,749,534,411,166,72,2629
81379,Montseny,24,18,13,22,10,8,95
430939,Móra d'Ebre,292,393,367,351,125,51,1579
430944,Móra la Nova,210,258,207,217,82,32,1006
430957,"Morell, el",129,194,178,181,69,33,784
430960,"Morera de Montsant, la",20,16,12,6,6,1,61
81290,Muntanyola,28,29,30,30,5,3,125
81398,Mura,29,24,13,13,8,0,87
251459,Nalec,11,7,3,7,3,4,35
250254,Naut Aran,173,107,79,97,39,34,529
81402,Navarcles,244,479,448,442,128,57,1798
81419,Navàs,345,523,501,374,130,59,1932
171117,Navata,61,91,59,47,14,10,282
251462,Navès,15,18,18,12,5,14,82
81424,"Nou de Berguedà, la",10,10,9,10,2,6,47
430976,"Nou de Gaià, la",29,42,27,33,9,5,145
430982,Nulles,43,36,17,23,9,9,137
251484,Odèn,16,12,9,8,10,18,73
81430,Òdena,140,215,229,189,70,52,895
171122,Ogassa,41,30,17,9,5,7,109
81458,Olèrdola,125,222,206,193,53,30,829
81461,Olesa de Bonesvalls,75,133,69,73,25,13,388
81477,Olesa de Montserrat,956,1759,1428,1353,442,218,6156
251497,Oliana,119,177,142,143,37,26,644
251500,Oliola,22,15,13,9,13,6,78
251517,Olius,38,33,42,34,20,14,181
81483,Olivella,126,175,115,100,30,12,558
81496,Olost,76,106,81,85,26,25,399
171143,Olot,2222,3009,2504,1830,528,306,10399
251522,"Oluges, les",20,17,8,12,4,5,66
81445,Olvan,69,106,56,55,29,9,324
251538,"Omellons, els",20,25,22,18,3,4,92
251543,"Omells de na Gaia, els",18,13,13,11,5,0,60
171156,Ordis,20,31,25,25,7,8,116
251556,Organyà,107,100,82,57,20,13,379
81509,Orís,9,14,17,18,8,7,73
81516,Oristà,27,44,32,42,20,23,188
81521,Orpí,13,12,9,9,6,2,51
81537,Òrrius,30,44,39,37,8,6,164
251569,Os de Balaguer,74,70,54,61,21,6,286
171169,Osor,12,29,18,14,4,1,78
251575,Ossó de Sió,16,17,14,9,12,8,76
81542,Pacs del Penedès,32,49,59,62,21,7,230
81555,Palafolls,309,517,494,465,141,70,1996
171175,Palafrugell,1432,1780,1408,1262,410,276,6568
171181,Palamós,1443,1378,1096,986,326,244,5473
251581,"Palau d'Anglesola, el",108,131,131,125,51,26,572
171194,Palau de Santa Eulàlia,10,9,7,5,1,1,33
171215,Palau-sator,32,22,15,20,10,5,104
171208,Palau-saverdera,88,116,51,41,22,13,331
81568,Palau-solità i Plegamans,446,870,900,1041,290,134,3681
431009,"Pallaresos, els",122,212,223,247,62,29,895
81574,Pallejà,441,799,653,675,207,81,2856
430995,"Palma d'Ebre, la",37,47,28,28,6,8,154
89058,"Palma de Cervelló, la",182,235,212,229,59,29,946
171236,Palol de Revardit,7,32,16,28,13,12,108
171241,Pals,248,241,149,97,51,35,821
81580,"Papiol, el",190,327,235,283,85,32,1152
171254,Pardines,17,9,14,9,3,3,55
81593,Parets del Vallès,723,1348,1287,1283,351,116,5108
171267,Parlavà,23,26,25,21,14,8,117
431016,Passanant i Belltall,34,24,16,2,6,4,86
171289,Pau,47,44,20,29,15,6,161
431021,Paüls,32,50,39,40,20,19,200
171292,Pedret i Marzà,11,11,13,7,4,3,49
251641,Penelles,30,36,40,28,13,12,159
171306,"Pera, la",31,36,26,17,15,11,136
81607,Perafita,33,39,30,15,11,6,134
431037,Perafort,39,66,47,41,16,9,218
171328,Peralada,122,127,101,101,33,19,503
251654,Peramola,29,26,21,21,11,12,120
431042,"Perelló, el",177,253,145,145,62,35,817
81614,Piera,587,1018,775,711,259,119,3469
431055,"Piles, les",22,8,10,18,5,4,67
81635,Pineda de Mar,1598,2073,1628,1562,480,262,7603
431068,"Pinell de Brai, el",46,91,69,78,41,23,348
251667,Pinell de Solsonès,10,10,10,12,5,14,61
251673,Pinós,17,15,12,20,10,14,88
431074,Pira,37,55,31,32,7,5,167
431080,"Pla de Santa Maria, el",119,148,112,157,33,18,587
81640,"Pla del Penedès, el",67,69,71,67,25,14,313
171334,"Planes d'Hostoles, les",93,174,148,116,45,23,599
171349,Planoles,38,34,23,17,4,2,118
259118,"Plans de Sió, els",40,35,43,36,13,15,182
251689,"Poal, el",36,65,43,46,18,9,217
251692,"Pobla de Cérvoles, la",34,31,11,13,6,2,97
81653,"Pobla de Claramunt, la",142,171,124,143,53,15,648
81666,"Pobla de Lillet, la",156,161,136,74,19,6,552
431093,"Pobla de Mafumet, la",66,89,78,103,37,17,390
431107,"Pobla de Massaluca, la",26,35,32,22,9,17,141
431114,"Pobla de Montornès, la",150,202,108,93,23,23,599
251713,"Pobla de Segur, la",353,305,223,165,61,16,1123
431129,Poboleda,36,45,28,13,11,5,138
81672,Polinyà,231,504,387,437,126,55,1740
431135,"Pont d'Armentera, el",48,63,47,30,12,5,205
250306,"Pont de Bar, el",21,18,13,8,5,1,66
171352,Pont de Molins,39,42,29,33,12,6,161
251734,"Pont de Suert, el",215,206,162,147,44,19,793
81825,"Pont de Vilomara i Rocafort, el",169,264,226,195,67,31,952
431418,Pontils,13,14,9,2,5,5,48
81688,Pontons,47,39,33,28,9,5,161
171365,Pontós,22,21,17,17,8,0,85
251728,Ponts,196,205,160,177,70,38,846
171371,Porqueres,138,255,268,284,138,62,1145
431140,Porrera,57,43,35,31,14,3,183
171404,"Port de la Selva, el",121,84,52,52,12,7,328
171387,Portbou,188,173,118,85,24,8,596
251749,"Portella, la",54,61,44,44,17,9,229
431153,Pradell de la Teixeta,29,15,8,11,10,2,75
431166,Prades,73,69,41,33,13,5,234
431172,Prat de Comte,20,21,16,13,4,1,75
81691,"Prat de Llobregat, el",3311,5728,5325,4937,1376,638,21315
431188,Pratdip,66,66,42,30,12,4,220
81712,Prats de Lluçanès,143,227,228,204,64,34,900
81705,"Prats de Rei, els",53,50,40,40,12,4,199
251752,Prats i Sansor,29,12,22,9,7,2,81
251765,Preixana,24,48,23,26,14,10,145
251771,Preixens,45,38,34,26,16,15,174
82303,Premià de Dalt,395,672,711,775,253,124,2930
81727,Premià de Mar,1515,2532,2183,2017,613,295,9155
171390,"Preses, les",81,136,125,102,35,27,506
251790,Prullans,28,16,16,12,4,5,81
171411,Puigcerdà,713,632,585,492,158,81,2661
81748,Puigdàlber,25,28,27,21,10,7,118
251804,Puiggròs,32,27,17,25,4,2,107
431191,Puigpelat,39,50,49,54,14,10,216
81751,Puig-reig,318,450,319,305,97,35,1524
251811,Puigverd d'Agramunt,35,19,12,12,10,7,95
251826,Puigverd de Lleida,84,101,76,76,27,17,381
81764,Pujalt,12,15,11,11,4,7,60
81770,"Quar, la",2,8,2,5,1,3,21
171426,Quart,101,181,175,219,74,19,769
170433,Queralbs,29,16,14,15,3,2,79
431205,Querol,51,41,20,10,9,2,133
171432,Rabós,23,23,9,6,5,3,69
81786,Rajadell,37,32,28,27,8,9,141
431212,Rasquera,62,66,46,47,31,21,273
171447,Regencós,29,23,16,26,8,2,104
81799,Rellinars,31,44,34,26,8,5,148
431227,Renau,9,9,3,3,2,0,26
431233,Reus,6086,8321,6865,6871,2172,929,31244
251832,Rialp,64,46,39,33,12,11,205
431248,"Riba, la",72,80,49,49,15,4,269
431251,Riba-roja d'Ebre,118,146,94,82,38,16,494
259059,Ribera d'Ondara,33,37,14,19,20,25,148
251850,Ribera d'Urgellet,69,73,60,51,26,13,292
171450,Ribes de Freser,202,246,158,124,32,28,790
171463,Riells i Viabrea,156,239,167,177,54,23,816
431264,"Riera de Gaià, la",78,115,74,67,24,19,377
251863,Riner,14,19,12,11,5,17,78
171479,Ripoll,847,1208,936,739,195,77,4002
81803,Ripollet,1651,2989,2563,2519,666,225,10613
259139,Riu de Cerdanya,16,3,6,3,3,1,32
171485,Riudarenes,130,150,95,93,19,15,502
171498,Riudaura,28,33,44,17,7,11,140
431270,Riudecanyes,88,92,55,50,14,4,303
431286,Riudecols,84,88,85,84,17,8,366
171501,Riudellots de la Selva,79,100,124,128,49,25,505
431299,Riudoms,316,469,408,413,133,71,1810
171518,Riumors,24,20,16,13,1,4,78
81810,"Roca del Vallès, la",394,695,650,615,202,74,2630
431303,Rocafort de Queralt,40,38,17,11,7,3,116
431310,Roda de Berà,473,459,272,205,64,40,1513
81831,Roda de Ter,250,463,429,422,120,63,1747
431325,Rodonyà,36,45,34,32,11,4,162
431331,Roquetes,416,627,532,484,159,94,2312
171523,Roses,1236,1313,954,900,282,146,4831
251898,Rosselló,79,165,147,137,53,33,614
431346,"Rourell, el",28,28,27,11,7,2,103
81846,Rubí,3231,5784,5092,4894,1372,671,21044
81859,Rubió,5,8,6,4,7,5,35
171539,Rupià,15,22,17,6,6,3,69
89019,Rupit i Pruit,38,26,16,24,10,9,123
81878,Sabadell,11567,19022,15150,14498,3920,1551,65708
81884,Sagàs,7,10,6,10,3,6,42
251902,Salàs de Pallars,42,39,27,13,11,2,134
81901,Saldes,27,22,13,26,11,7,106
171544,Sales de Llierca,8,9,6,6,4,1,34
81918,Sallent,504,699,657,488,146,58,2552
431359,Salomó,39,51,28,24,5,5,152
439057,Salou,1636,1498,1081,940,303,143,5601
171557,Salt,1806,1995,1579,1463,520,288,7651
251919,Sanaüja,59,45,32,25,8,11,180
81944,Sant Adrià de Besòs,2008,3023,2559,2331,750,448,11119
81957,Sant Agustí de Lluçanès,2,6,4,4,6,5,27
81960,Sant Andreu de la Barca,1132,2361,1967,1649,420,189,7718
81976,Sant Andreu de Llavaneres,454,695,607,621,205,84,2666
171576,Sant Andreu Salou,10,11,7,14,3,2,47
171833,Sant Aniol de Finestres,34,24,15,21,6,7,107
81982,Sant Antoni de Vilamajor,234,356,271,305,97,54,1317
81995,Sant Bartomeu del Grau,45,62,62,78,34,37,318
82009,Sant Boi de Llobregat,3829,7304,6816,6500,1699,661,26809
82016,Sant Boi de Lluçanès,35,38,29,35,21,11,169
431362,Sant Carles de la Ràpita,799,1179,960,870,263,113,4184
82037,Sant Cebrià de Vallalta,174,252,151,138,30,18,763
82021,Sant Celoni,748,1081,1001,1028,310,170,4338
82042,Sant Climent de Llobregat,151,298,250,272,72,28,1071
171582,Sant Climent Sescebes,32,57,35,20,8,6,158
82055,Sant Cugat del Vallès,3069,4823,4494,4885,1705,830,19806
82068,Sant Cugat Sesgarrigues,35,54,51,56,23,17,236
251961,Sant Esteve de la Sarga,20,14,5,2,5,2,48
82074,Sant Esteve de Palautordera,107,139,98,119,44,16,523
82080,Sant Esteve Sesrovires,244,466,395,450,118,61,1734
171595,Sant Feliu de Buixalleu,67,69,61,49,14,7,267
82107,Sant Feliu de Codines,363,466,337,320,101,57,1644
171609,Sant Feliu de Guíxols,1515,1786,1389,1299,417,203,6609
82114,Sant Feliu de Llobregat,1974,4124,3449,3329,831,272,13979
171616,Sant Feliu de Pallerols,98,132,96,77,25,11,439
82129,Sant Feliu Sasserra,45,50,39,51,15,18,218
171621,Sant Ferriol,15,11,16,13,6,5,66
82093,Sant Fost de Campsentelles,261,535,536,595,162,83,2172
82135,Sant Fruitós de Bages,275,532,536,481,134,59,2017
171637,Sant Gregori,127,178,181,198,78,36,798
251924,Sant Guim de Freixenet,77,83,69,66,34,19,348
251977,Sant Guim de la Plana,10,15,9,7,5,9,55
171642,Sant Hilari Sacalm,332,471,419,398,115,43,1778
82153,Sant Hipòlit de Voltregà,193,297,246,220,76,35,1067
81939,Sant Iscle de Vallalta,73,108,87,53,20,12,353
439023,Sant Jaume d'Enveja,134,309,256,243,98,51,1091
82166,Sant Jaume de Frontanyà,2,3,3,2,0,0,10
171655,Sant Jaume de Llierca,40,88,71,41,18,10,268
431378,Sant Jaume dels Domenys,135,157,112,106,38,16,564
171674,Sant Joan de les Abadesses,300,379,319,248,65,30,1341
171680,Sant Joan de Mollet,25,44,27,32,10,4,142
82188,Sant Joan de Vilatorrada,383,929,812,756,210,88,3178
82172,Sant Joan Despí,1439,2786,2546,2449,594,198,10012
171851,Sant Joan les Fonts,185,289,236,192,60,27,989
171668,Sant Jordi Desvalls,41,69,39,41,16,14,220
89030,Sant Julià de Cerdanyola,33,20,19,19,6,0,97
171693,Sant Julià de Ramis,100,155,153,167,65,37,677
82205,Sant Julià de Vilatorta,127,204,175,198,77,27,808
179032,Sant Julià del Llor i Bonmatí,94,108,82,68,18,9,379
82212,Sant Just Desvern,840,1139,990,1134,378,179,4660
82227,Sant Llorenç d'Hortons,109,167,141,126,42,25,610
171714,Sant Llorenç de la Muga,25,32,15,10,1,1,84
251930,Sant Llorenç de Morunys,90,75,62,67,17,13,324
82233,Sant Llorenç Savall,144,188,148,143,46,21,690
82251,Sant Martí d'Albars,3,7,4,7,4,8,33
82248,Sant Martí de Centelles,58,77,62,57,20,7,281
171729,Sant Martí de Llémena,50,45,36,23,12,9,175
259025,Sant Martí de Riucorb,72,75,46,35,17,17,262
82264,Sant Martí de Tous,71,96,78,70,30,11,356
82270,Sant Martí Sarroca,145,194,173,160,70,61,803
82286,Sant Martí Sesgueioles,25,31,23,22,11,8,120
171735,Sant Martí Vell,21,18,15,15,6,2,77
82299,Sant Mateu de Bages,39,68,51,36,13,24,231
171740,Sant Miquel de Campmajor,18,12,9,12,8,7,66
171753,Sant Miquel de Fluvià,33,61,42,50,20,6,212
171766,Sant Mori,15,11,6,13,3,3,51
171772,Sant Pau de Segúries,54,73,48,50,11,7,243
82310,Sant Pere de Ribes,1392,2229,1871,1820,515,246,8073
82325,Sant Pere de Riudebitlles,118,218,159,159,50,27,731
82331,Sant Pere de Torelló,127,193,195,171,54,21,761
82346,Sant Pere de Vilamajor,192,289,235,184,64,42,1006
171788,Sant Pere Pescador,127,142,97,99,36,21,522
81897,Sant Pere Sallavinera,10,9,9,6,7,5,46
82359,Sant Pol de Mar,386,442,284,262,88,44,1506
82362,Sant Quintí de Mediona,134,175,154,108,45,29,645
82378,Sant Quirze de Besora,175,223,161,145,38,11,753
82384,Sant Quirze del Vallès,453,993,1065,1301,343,159,4314
82397,Sant Quirze Safaja,55,30,25,24,15,7,156
251945,Sant Ramon,30,36,39,42,18,13,178
82401,Sant Sadurní d'Anoia,482,846,759,784,269,134,3274
82418,Sant Sadurní d'Osormort,10,2,6,4,5,1,28
80983,Sant Salvador de Guardiola,152,234,165,150,53,19,773
82628,Sant Vicenç de Castellet,507,706,579,514,160,66,2532
82649,Sant Vicenç de Montalt,278,379,310,299,88,38,1392
82652,Sant Vicenç de Torelló,124,183,137,149,42,16,651
82634,Sant Vicenç dels Horts,1073,2198,1995,2008,592,308,8174
431384,Santa Bàrbara,253,381,260,237,73,44,1248
82439,Santa Cecília de Voltregà,6,14,9,13,9,7,58
82444,Santa Coloma de Cervelló,275,654,472,407,115,43,1966
171805,Santa Coloma de Farners,611,870,795,708,195,90,3269
82457,Santa Coloma de Gramenet,6178,10998,9977,8761,2456,1059,39429
431397,Santa Coloma de Queralt,211,238,199,196,78,41,963
171812,Santa Cristina d'Aro,1395,238,120,95,35,11,1894
82460,Santa Eugènia de Berga,59,150,152,185,48,28,622
82476,Santa Eulàlia de Riuprimer,46,74,58,71,29,9,287
82482,Santa Eulàlia de Ronçana,243,454,382,426,110,63,1678
82495,Santa Fe del Penedès,12,22,22,27,8,7,98
171827,Santa Llogaia d'Àlguema,17,18,23,23,13,5,99
82508,Santa Margarida de Montbui,411,807,713,795,244,77,3047
82515,Santa Margarida i els Monjos,247,436,403,384,155,62,1687
82589,Santa Maria d'Oló,64,70,76,70,22,27,329
82536,Santa Maria de Besora,16,10,12,14,3,5,60
82567,Santa Maria de Martorelles,57,64,50,55,14,9,249
82554,Santa Maria de Merlès,5,12,4,9,4,9,43
82573,Santa Maria de Miralles,13,13,5,7,2,1,41
82592,Santa Maria de Palautordera,442,670,530,496,139,59,2336
431401,Santa Oliva,151,232,159,161,64,25,792
171848,Santa Pau,64,112,113,122,39,29,479
82606,Santa Perpètua de Mogoda,844,1919,1793,1734,467,171,6928
82613,Santa Susanna,131,200,164,150,59,25,729
81923,Santpedor,213,469,462,464,130,64,1802
431423,Sarral,126,124,90,107,41,22,510
171864,Sarrià de Ter,221,371,305,278,92,40,1307
252017,Sarroca de Bellera,23,24,5,8,2,4,66
252000,Sarroca de Lleida,34,36,35,35,9,10,159
171870,"Saus, Camallera i Llampaies",77,64,45,48,17,11,262
431439,Savallà del Comtat,11,8,3,1,2,2,27
431444,"Secuita, la",79,103,85,97,26,15,405
171886,"Selva de Mar, la",27,20,16,14,4,1,82
431457,"Selva del Camp, la",230,367,310,379,101,56,1443
431460,Senan,11,3,1,0,0,2,17
430445,"Sénia, la",331,463,414,390,156,78,1832
252022,Senterada,16,12,10,2,4,0,44
250352,"Sentiu de Sió, la",27,41,30,29,13,14,154
82671,Sentmenat,322,538,464,484,145,63,2016
171903,Serinyà,68,72,65,60,23,14,302
252043,Seròs,140,158,121,101,53,44,617
171910,Serra de Daró,18,15,15,13,2,4,67
171925,Setcases,21,19,14,10,5,2,71
252038,"Seu d'Urgell, la",976,1102,836,745,264,122,4045
82690,Seva,184,228,204,193,71,29,909
252056,Sidamon,34,68,36,41,17,8,204
171931,Sils,198,290,238,276,92,29,1123
82704,Sitges,2443,2285,1551,1314,358,149,8100
170524,Siurana,10,14,14,9,1,7,55
82711,Sobremunt,4,4,4,7,3,3,25
252069,"Soleràs, el",27,33,30,24,15,9,138
431476,Solivella,69,75,46,25,22,10,247
252075,Solsona,520,637,561,543,184,103,2548
82726,Sora,18,9,15,12,7,3,64
252081,Soriguera,44,30,18,17,5,12,126
252094,Sort,246,200,126,117,42,20,751
252108,Soses,71,116,83,109,55,31,465
82732,Subirats,180,255,187,184,68,33,907
252115,Sudanell,49,69,57,42,19,7,243
252120,Sunyer,17,16,21,21,13,6,94
82747,Súria,331,607,517,465,129,56,2105
171946,Susqueda,16,8,7,7,1,2,41
82763,Tagamanent,17,20,22,17,1,3,80
82779,Talamanca,9,13,7,8,0,2,39
252154,Talarn,45,34,21,17,11,6,134
252167,Talavera,24,18,20,12,7,15,96
171959,"Tallada d'Empordà, la",27,33,14,25,7,8,114
82785,Taradell,248,404,391,452,160,63,1718
431482,Tarragona,8419,11155,9106,8870,2591,975,41116
252173,Tàrrega,954,1252,994,891,323,180,4594
252189,Tarrés,16,16,4,4,4,3,47
252192,Tarroja de Segarra,20,13,8,11,4,6,62
82750,Tavèrnoles,9,11,12,23,8,11,74
82802,Tavertet,14,20,8,8,6,1,57
82819,Teià,214,440,405,523,131,60,1773
252206,Térmens,88,101,94,91,46,37,457
171962,Terrades,27,19,12,19,0,5,82
82798,Terrassa,11573,18807,14686,12856,3588,1549,63059
82824,Tiana,221,471,487,565,145,66,1955
252213,Tírvia,20,10,10,8,2,1,51
252228,Tiurana,2,0,3,1,0,1,7
431495,Tivenys,70,102,57,56,27,15,327
431508,Tivissa,166,157,113,115,43,42,636
82830,Tona,340,544,416,503,172,75,2050
252234,Torà,93,114,78,86,28,17,416
82845,Tordera,828,1156,876,640,205,108,3813
82858,Torelló,695,1196,1032,996,269,111,4299
252249,"Torms, els",18,17,17,12,3,4,71
252252,Tornabous,72,68,49,53,19,21,282
252271,"Torre de Cabdella, la",93,75,43,36,13,14,274
82861,"Torre de Claramunt, la",123,193,204,187,73,41,821
431515,"Torre de Fontaubella, la",19,16,7,9,5,0,56
431520,"Torre de l'Espanyol, la",48,66,42,40,20,21,237
252265,Torrebesses,34,31,23,19,9,6,122
431536,Torredembarra,990,1169,849,792,258,120,4178
252287,Torrefarrera,96,172,164,139,50,31,652
259078,Torrefeta i Florejacs,57,57,37,48,20,9,228
252304,Torregrossa,138,208,143,140,61,49,739
252311,Torrelameu,40,34,41,33,23,16,187
82877,Torrelavit,65,93,88,76,34,21,377
82883,Torrelles de Foix,170,205,120,110,37,23,665
82896,Torrelles de Llobregat,183,346,311,325,86,33,1284
171978,Torrent,14,14,13,9,5,5,60
252326,Torres de Segre,121,160,150,126,52,29,638
252332,Torre-serona,24,26,25,23,10,7,115
171984,Torroella de Fluvià,51,38,16,19,9,15,148
171997,Torroella de Montgrí,698,741,616,596,168,144,2963
431541,Torroja del Priorat,23,16,8,8,2,3,60
172001,Tortellà,80,76,56,45,17,6,280
431554,Tortosa,2133,2749,2223,2001,742,379,10227
172018,Toses,24,16,8,9,0,5,62
172023,Tossa de Mar,559,451,338,297,88,40,1773
252347,Tremp,561,581,367,356,111,47,2023
172044,Ullà,52,66,54,48,15,30,265
82900,Ullastrell,47,103,89,120,31,15,405
172057,Ullastret,20,21,12,15,8,4,80
431567,Ulldecona,470,564,391,392,135,75,2027
431573,Ulldemolins,67,50,38,25,14,7,201
172039,Ultramort,22,14,9,12,6,7,70
172060,Urús,18,21,9,12,6,5,71
82917,Vacarisses,236,340,268,241,58,25,1168
170144,"Vajol, la",14,13,5,3,4,1,40
172076,"Vall d'en Bas, la",171,217,235,158,56,47,884
172082,"Vall de Bianya, la",104,107,88,78,29,14,420
250432,"Vall de Boí, la",137,75,56,41,21,20,350
259010,Vall de Cardós,50,36,27,18,8,5,144
82922,Vallbona d'Anoia,68,84,92,81,24,11,360
252385,Vallbona de les Monges,37,29,12,9,11,3,101
82938,Vallcebre,18,32,24,13,3,5,95
431589,Vallclara,12,14,12,8,3,0,49
252402,Vallfogona de Balaguer,68,109,105,114,53,29,478
171707,Vallfogona de Ripollès,26,22,9,11,5,7,80
431592,Vallfogona de Riucorb,19,12,11,5,2,0,49
82943,Vallgorguina,129,150,115,102,29,15,540
82956,Vallirana,437,901,801,778,226,125,3268
172095,Vall-llobrega,49,49,44,27,9,1,179
431606,Vallmoll,83,118,86,108,37,15,447
82969,Vallromanes,111,173,125,111,43,9,572
431613,Valls,1300,1838,1602,1620,484,200,7044
259062,"Valls d'Aguilar, les",43,31,18,18,5,9,124
252398,"Valls de Valira, les",57,72,42,42,29,15,257
431628,Vandellòs i l'Hospitalet de l'Infant,273,362,302,345,127,69,1478
259097,"Vansa i Fórnols, la",32,19,7,8,2,6,74
82975,Veciana,5,15,9,10,6,4,49
431634,"Vendrell, el",2008,2554,1789,1725,525,246,8847
172109,Ventalló,76,70,44,37,8,13,248
252424,Verdú,81,85,65,55,25,18,329
172116,Verges,100,96,74,75,28,22,395
431649,Vespella de Gaià,36,33,12,9,6,1,97
82981,Vic,2352,3155,2415,2281,797,456,11456
172121,Vidrà,8,12,16,9,4,4,53
172137,Vidreres,392,479,384,364,113,67,1799
252430,Vielha e Mijaran,406,340,330,278,97,50,1501
431652,Vilabella,37,79,49,65,23,11,264
172142,Vilabertran,66,73,55,48,24,15,281
172155,Vilablareix,56,103,131,211,62,35,598
82994,Vilada,42,58,35,37,13,8,193
172174,Viladamat,34,37,33,24,8,7,143
172168,Viladasens,10,16,14,9,9,2,60
83015,Viladecans,2470,5392,5124,4636,1234,510,19366
83008,Viladecavalls,151,406,542,628,169,50,1946
172180,Vilademuls,42,56,41,34,25,28,226
172207,Viladrau,79,85,50,58,26,13,311
172214,Vilafant,126,310,373,375,118,53,1355
83054,Vilafranca del Penedès,2081,3119,2492,2346,682,333,11053
252445,Vilagrassa,30,40,37,17,10,10,144
172235,Vilajuïga,80,110,66,74,23,11,364
431750,Vilalba dels Arcs,59,45,52,43,17,30,246
83067,Vilalba Sasserra,40,48,47,36,9,4,184
252458,Vilaller,69,56,44,34,19,2,224
172240,Vilallonga de Ter,55,45,33,18,16,4,171
431665,Vilallonga del Camp,87,95,91,109,31,16,429
172253,Vilamacolum,19,26,16,16,9,5,91
172266,Vilamalla,44,51,76,77,15,18,281
172272,Vilamaniscle,21,10,5,10,4,4,54
252477,Vilamòs,15,12,5,8,4,3,47
172288,Vilanant,25,30,19,15,9,11,109
431671,Vilanova d'Escornalbou,42,32,30,37,12,6,159
252483,Vilanova de Bellpuig,71,110,70,73,32,22,378
252496,Vilanova de l'Aguda,6,24,14,11,4,16,75
252542,Vilanova de la Barca,65,87,75,48,26,14,315
252509,Vilanova de Meià,61,30,27,22,14,10,164
431687,Vilanova de Prades,13,14,7,9,4,4,51
83036,Vilanova de Sau,35,31,26,18,5,9,124
252516,Vilanova de Segrià,57,77,49,47,25,14,269
83020,Vilanova del Camí,456,838,838,897,265,99,3393
89024,Vilanova del Vallès,152,253,201,179,69,31,885
83073,Vilanova i la Geltrú,4279,5778,4565,3936,1109,487,20154
431690,Vilaplana,44,50,40,38,15,9,196
431704,Vila-rodona,122,107,78,60,20,13,400
172305,Vila-sacra,28,40,21,28,17,6,140
252521,Vila-sana,29,53,32,42,15,7,178
431711,Vila-seca,797,1146,998,1053,393,168,4555
82140,Vilassar de Dalt,407,691,580,646,216,83,2623
82191,Vilassar de Mar,1111,1691,1421,1360,429,148,6160
172229,Vilaür,13,16,5,8,2,2,46
431726,Vilaverd,43,48,31,17,12,3,154
431732,"Vilella Alta, la",16,11,13,5,2,4,51
431747,"Vilella Baixa, la",35,20,8,9,7,1,80
172333,Vilobí d'Onyar,131,176,161,172,67,38,745
83041,Vilobí del Penedès,47,73,53,61,32,24,290
172327,Vilopriu,23,22,9,9,2,2,67
252537,"Vilosell, el",35,26,14,5,6,3,89
431763,Vimbodí i Poblet,93,125,59,68,26,11,382
252555,Vinaixa,61,61,41,37,18,11,229
431779,Vinebre,45,41,34,26,10,8,164
431785,Vinyols i els Arcs,124,120,77,96,37,9,463
83089,Viver i Serrateix,5,11,7,8,7,11,49
430521,Xerta,97,117,96,78,31,19,438
